"ROC_observed_outcome","ROC_observed_corrected","sum_low_risk","sum_high_risk","sum_outcome_observed","sum_outcome_true","sum_high_risk_observed","sum_high_risk_true","sum_low_risk_observed","sum_low_risk_true","mean_age_low_risk_true","mean_age_high_risk_true"
0.687478791991856,0.721356694314574,1068,223,28,28,9,8,19,20,41.9202832822525,43.5635025489192
0.69734578520521,0.731919542732808,1054,237,39,65,15,18,24,47,41.9202832822525,43.5635025489192
0.648009756097561,0.681286617754721,1086,205,41,28,13,4,28,24,41.9202832822525,43.5635025489192
0.719591581951133,0.76244439308482,1054,237,45,29,19,9,26,20,41.9202832822525,43.5635025489192
0.719420174741859,0.752546395646527,1073,218,32,45,13,10,19,35,41.9202832822525,43.5635025489192
0.810037273695421,0.850965441483739,1065,226,39,37,27,17,12,20,41.9202832822525,43.5635025489192
0.745773791425965,0.808764083322426,1059,232,26,59,12,17,14,42,41.9202832822525,43.5635025489192
0.769617568584525,0.803462636885289,1059,232,47,44,27,18,20,26,41.9202832822525,43.5635025489192
0.775759392486011,0.806212532393364,1069,222,40,25,22,9,18,16,41.9202832822525,43.5635025489192
0.70216951745997,0.755325127116547,1087,204,29,42,10,10,19,32,41.9202832822525,43.5635025489192
0.772771782573941,0.82361181315104,1093,198,40,59,22,19,18,40,41.9202832822525,43.5635025489192
0.807872503840246,0.843983720796076,1046,245,31,55,20,19,11,36,41.9202832822525,43.5635025489192
0.710935859201075,0.742632936674205,1059,232,38,65,15,20,23,45,41.9202832822525,43.5635025489192
0.718687946783161,0.748778701903261,1084,207,32,21,12,4,20,17,41.9202832822525,43.5635025489192
0.738237916889602,0.7844393940456,1045,246,45,37,24,10,21,27,41.9202832822525,43.5635025489192
0.712258999453942,0.761191844142712,1065,226,38,67,15,16,23,51,41.9202832822525,43.5635025489192
0.752435449803871,0.805156293074477,1068,223,37,46,19,13,18,33,41.9202832822525,43.5635025489192
0.750893052416709,0.786799241083579,1032,259,44,15,23,5,21,10,41.9202832822525,43.5635025489192
0.766368457951047,0.801536082922564,1069,222,53,73,25,23,28,50,41.9202832822525,43.5635025489192
0.763874837404249,0.808686434293493,1070,221,33,68,18,18,15,50,41.9202832822525,43.5635025489192
0.735646303674192,0.764230352617694,1060,231,36,23,18,12,18,11,41.9202832822525,43.5635025489192
0.739277204130262,0.770202088112544,1049,242,32,118,14,23,18,95,41.9202832822525,43.5635025489192
0.733545766249255,0.779004487836219,1065,226,43,88,18,22,25,66,41.9202832822525,43.5635025489192
0.651363044482715,0.688627903180245,1080,211,38,52,14,13,24,39,41.9202832822525,43.5635025489192
0.7373763593639,0.783403720459531,1035,256,29,45,15,13,14,32,41.9202832822525,43.5635025489192
0.739200884517138,0.78757528107595,1064,227,42,43,21,13,21,30,41.9202832822525,43.5635025489192
0.780106691309279,0.819394150942115,1059,232,38,35,21,12,17,23,41.9202832822525,43.5635025489192
0.766215077916608,0.804064086235484,1070,221,34,38,20,13,14,25,41.9202832822525,43.5635025489192
0.706923875621619,0.76046582529763,1033,258,29,59,12,18,17,41,41.9202832822525,43.5635025489192
0.693040146402836,0.720223452991689,1063,228,42,28,13,3,29,25,41.9202832822525,43.5635025489192
0.727486751305807,0.774961294737553,1059,232,42,64,17,16,25,48,41.9202832822525,43.5635025489192
0.791066818903892,0.835612772559621,1073,218,32,20,18,5,14,15,41.9202832822525,43.5635025489192
0.772772657450077,0.784812110478814,1070,221,31,37,16,11,15,26,41.9202832822525,43.5635025489192
0.775358422939068,0.795230639477152,1066,225,31,32,16,6,15,26,41.9202832822525,43.5635025489192
0.75646579593948,0.794352489808191,1072,219,37,126,16,28,21,98,41.9202832822525,43.5635025489192
0.725589528377298,0.773810839028881,1061,230,40,32,18,10,22,22,41.9202832822525,43.5635025489192
0.785292164674635,0.815892712258852,1052,239,36,43,19,14,17,29,41.9202832822525,43.5635025489192
0.800729874259286,0.825977679483572,1073,218,33,65,20,16,13,49,41.9202832822525,43.5635025489192
0.750365205843293,0.802465019962188,1071,220,36,23,18,8,18,15,41.9202832822525,43.5635025489192
0.740050907481186,0.801825783918267,1058,233,36,85,20,28,16,57,41.9202832822525,43.5635025489192
0.771958925750395,0.804870509534247,1058,233,25,27,11,9,14,18,41.9202832822525,43.5635025489192
0.770294160530728,0.808116216561378,1076,215,44,57,24,15,20,42,41.9202832822525,43.5635025489192
0.724429539986878,0.770660251274688,1050,241,44,44,20,15,24,29,41.9202832822525,43.5635025489192
0.702636968766001,0.76141298189142,1081,210,31,44,14,12,17,32,41.9202832822525,43.5635025489192
0.75156764139815,0.814996451035521,1063,228,52,101,26,32,26,69,41.9202832822525,43.5635025489192
0.725285534728674,0.76815787147418,1095,196,29,39,11,9,18,30,41.9202832822525,43.5635025489192
0.681075697211155,0.726670173749222,1082,209,36,52,14,12,22,40,41.9202832822525,43.5635025489192
0.721135211687537,0.750499489585074,1060,231,43,53,16,16,27,37,41.9202832822525,43.5635025489192
0.753628653794583,0.79553085537448,1052,239,48,48,27,20,21,28,41.9202832822525,43.5635025489192
0.69781735638205,0.737108607518527,1060,231,46,45,21,15,25,30,41.9202832822525,43.5635025489192
0.608086555454976,0.644156253574024,1077,214,37,33,12,6,25,27,41.9202832822525,43.5635025489192
0.735333419543946,0.805366882532797,1066,225,37,108,20,31,17,77,41.9202832822525,43.5635025489192
0.745928062436376,0.764347285417464,1061,230,28,32,12,14,16,18,41.9202832822525,43.5635025489192
0.759053658536585,0.804817848379318,1069,222,41,62,23,14,18,48,41.9202832822525,43.5635025489192
0.770173304955914,0.843194223459867,1073,218,26,22,15,5,11,17,41.9202832822525,43.5635025489192
0.713619512195122,0.769411326184568,1065,226,41,48,18,12,23,36,41.9202832822525,43.5635025489192
0.781206340029869,0.825661125447495,1074,217,33,51,19,13,14,38,41.9202832822525,43.5635025489192
0.750939442115913,0.800238183200184,1074,217,33,67,13,18,20,49,41.9202832822525,43.5635025489192
0.779591792749688,0.842354527609729,1052,239,37,127,20,33,17,94,41.9202832822525,43.5635025489192
0.755324813631523,0.797972935066108,1058,233,39,67,20,18,19,49,41.9202832822525,43.5635025489192
0.709586716992642,0.749065148207256,1058,233,42,46,19,15,23,31,41.9202832822525,43.5635025489192
0.74713788741303,0.814357785749265,1056,235,51,102,27,30,24,72,41.9202832822525,43.5635025489192
0.785785953177258,0.811542289318046,1063,228,26,34,12,6,14,28,41.9202832822525,43.5635025489192
0.684993359893758,0.743397530453805,1074,217,36,34,14,10,22,24,41.9202832822525,43.5635025489192
0.799247812405707,0.842990234619175,1050,241,37,69,22,18,15,51,41.9202832822525,43.5635025489192
0.804216467463479,0.855951368051749,1076,215,36,58,22,12,14,46,41.9202832822525,43.5635025489192
0.712316907669989,0.779880273695354,1093,198,34,116,15,30,19,86,41.9202832822525,43.5635025489192
0.687788266735635,0.729927169275121,1046,245,37,60,18,18,19,42,41.9202832822525,43.5635025489192
0.749253263959146,0.804355774344048,1053,238,33,56,15,14,18,42,41.9202832822525,43.5635025489192
0.755834914611005,0.778130328726409,1033,258,51,28,26,13,25,15,41.9202832822525,43.5635025489192
0.681844819503047,0.734430521466702,1072,219,27,70,12,12,15,58,41.9202832822525,43.5635025489192
0.760293448589627,0.799969995399813,1057,234,35,53,19,16,16,37,41.9202832822525,43.5635025489192
0.749408553230209,0.798557831381541,1067,224,35,68,16,14,19,54,41.9202832822525,43.5635025489192
0.768235294117647,0.809447748657683,1065,226,50,46,27,20,23,26,41.9202832822525,43.5635025489192
0.7508,0.759003577814437,1068,223,41,17,20,5,21,12,41.9202832822525,43.5635025489192
0.747658251774688,0.769090612673463,1052,239,38,63,18,13,20,50,41.9202832822525,43.5635025489192
0.725431606905711,0.774038860584187,1070,221,36,54,15,13,21,41,41.9202832822525,43.5635025489192
0.659222616188189,0.70731273205742,1066,225,42,60,15,19,27,41,41.9202832822525,43.5635025489192
0.726610743756489,0.75571979754644,1061,230,29,38,15,11,14,27,41.9202832822525,43.5635025489192
0.664888089528377,0.705541086524818,1047,244,40,36,19,10,21,26,41.9202832822525,43.5635025489192
0.642020805666224,0.700603855259796,1077,214,36,42,10,5,26,37,41.9202832822525,43.5635025489192
0.761918990703851,0.819859457413358,1062,229,36,40,23,18,13,22,41.9202832822525,43.5635025489192
0.717831612390786,0.758291934557663,1069,222,32,62,10,15,22,47,41.9202832822525,43.5635025489192
0.744034971226206,0.7730183178248,1045,246,36,32,19,9,17,23,41.9202832822525,43.5635025489192
0.76879160266257,0.805601962107096,1067,224,31,73,15,13,16,60,41.9202832822525,43.5635025489192
0.752101383680331,0.765936879823323,1068,223,37,73,15,13,22,60,41.9202832822525,43.5635025489192
0.706387608806964,0.762925983840949,1090,201,31,36,13,5,18,31,41.9202832822525,43.5635025489192
0.69954642330182,0.757075767667839,1059,232,29,46,13,14,16,32,41.9202832822525,43.5635025489192
0.729943155180497,0.762537077537403,1067,224,27,56,11,16,16,40,41.9202832822525,43.5635025489192
0.723658247829518,0.797237818048551,1086,205,24,80,12,15,12,65,41.9202832822525,43.5635025489192
0.701453872587893,0.765298986911737,1070,221,30,88,10,15,20,73,41.9202832822525,43.5635025489192
0.772952073883819,0.820440330913285,1071,220,29,35,16,11,13,24,41.9202832822525,43.5635025489192
0.815424266455194,0.84791653786651,1075,216,30,27,15,1,15,26,41.9202832822525,43.5635025489192
0.729673995201945,0.776966612710302,1071,220,49,92,19,20,30,72,41.9202832822525,43.5635025489192
0.734332533972822,0.772863986991328,1096,195,40,71,17,20,23,51,41.9202832822525,43.5635025489192
0.757450076804915,0.793363561678784,1058,233,31,25,14,9,17,16,41.9202832822525,43.5635025489192
0.708115252445149,0.736736069103284,1062,229,30,35,13,8,17,27,41.9202832822525,43.5635025489192
0.727687849720224,0.770131751280691,1057,234,40,56,17,20,23,36,41.9202832822525,43.5635025489192
0.815789473684211,0.858604503168136,1059,232,38,66,25,23,13,43,41.9202832822525,43.5635025489192
0.688356965697974,0.767300250996635,1065,226,34,258,13,48,21,210,41.9202832822525,43.5635025489192
0.718850714502888,0.764611486442607,1050,241,26,66,13,16,13,50,41.9202832822525,43.5635025489192
0.688712661908538,0.75388081508804,1075,216,30,35,15,8,15,27,41.9202832822525,43.5635025489192
0.722332134292566,0.779934129838336,1064,227,40,61,19,21,21,40,41.9202832822525,43.5635025489192
0.696039024390244,0.745409470079396,1074,217,41,51,15,12,26,39,41.9202832822525,43.5635025489192
0.594073220686124,0.630240554130728,1067,224,31,36,11,9,20,27,41.9202832822525,43.5635025489192
0.764220900529948,0.805208885720988,1053,238,42,47,24,19,18,28,41.9202832822525,43.5635025489192
0.706794564348521,0.759852091692871,1063,228,40,81,18,26,22,55,41.9202832822525,43.5635025489192
0.787010391686651,0.809483442554615,1059,232,40,49,22,18,18,31,41.9202832822525,43.5635025489192
0.784839863787232,0.820288536628422,1075,216,37,40,20,14,17,26,41.9202832822525,43.5635025489192
0.712172033392964,0.733735630401839,1091,200,43,31,15,8,28,23,41.9202832822525,43.5635025489192
0.702907452907453,0.767012432844053,1064,227,37,66,14,11,23,55,41.9202832822525,43.5635025489192
0.751464455917395,0.779802633453104,1056,235,32,20,12,9,20,11,41.9202832822525,43.5635025489192
0.806493202062822,0.841942269631045,1037,254,27,56,18,22,9,34,41.9202832822525,43.5635025489192
0.777810978308986,0.80798769883156,1077,214,36,53,18,17,18,36,41.9202832822525,43.5635025489192
0.724317561419472,0.781939151794526,1068,223,35,108,13,19,22,89,41.9202832822525,43.5635025489192
0.753813936075624,0.798113847123942,1062,229,34,40,20,18,14,22,41.9202832822525,43.5635025489192
0.797361237488626,0.841532654569055,1074,217,35,37,21,10,14,27,41.9202832822525,43.5635025489192
0.795743834526651,0.846443699037902,1076,215,34,49,19,13,15,36,41.9202832822525,43.5635025489192
0.689333718745484,0.717083992798189,1054,237,33,26,12,4,21,22,41.9202832822525,43.5635025489192
0.761246692149368,0.815791371186726,1073,218,38,69,21,15,17,54,41.9202832822525,43.5635025489192
0.737934221027429,0.772735363920727,1070,221,38,64,16,13,22,51,41.9202832822525,43.5635025489192
0.706339356632248,0.740153406418331,1091,200,32,47,13,17,19,30,41.9202832822525,43.5635025489192
0.753523858787017,0.796008946484396,1067,224,37,52,20,19,17,33,41.9202832822525,43.5635025489192
0.684495532179618,0.778586791979982,1064,227,28,72,12,20,16,52,41.9202832822525,43.5635025489192
0.712341301612719,0.767683752544531,1072,219,42,34,20,14,22,20,41.9202832822525,43.5635025489192
0.744665718349929,0.802975027029712,1054,237,37,68,21,22,16,46,41.9202832822525,43.5635025489192
0.814875876842945,0.871997487806056,1048,243,38,108,24,37,14,71,41.9202832822525,43.5635025489192
0.805440582882945,0.844452365525378,1069,222,47,77,28,25,19,52,41.9202832822525,43.5635025489192
0.79278889899909,0.824793440588721,1076,215,35,48,17,12,18,36,41.9202832822525,43.5635025489192
0.738805813416222,0.778971274257384,1080,211,38,49,20,17,18,32,41.9202832822525,43.5635025489192
0.777699270910133,0.845541135641165,1057,234,39,108,25,32,14,76,41.9202832822525,43.5635025489192
0.763278048780488,0.807840846384209,1062,229,41,41,21,16,20,25,41.9202832822525,43.5635025489192
0.718596451319381,0.795992574028795,1074,217,35,132,18,33,17,99,41.9202832822525,43.5635025489192
0.670252324037184,0.701556283553518,1036,255,36,12,15,1,21,11,41.9202832822525,43.5635025489192
0.707544141252006,0.751978174404874,1086,205,45,79,20,18,25,61,41.9202832822525,43.5635025489192
0.700992436286554,0.736725327901503,1072,219,33,21,16,8,17,13,41.9202832822525,43.5635025489192
0.733628764649053,0.793929244364017,1073,218,38,74,17,16,21,58,41.9202832822525,43.5635025489192
0.699911634122161,0.745463619151924,1080,211,37,33,15,9,22,24,41.9202832822525,43.5635025489192
0.723445359772545,0.767044101587187,1059,232,44,57,19,22,25,35,41.9202832822525,43.5635025489192
0.763924475994455,0.807541726569476,1087,204,38,88,16,22,22,66,41.9202832822525,43.5635025489192
0.823151078293483,0.845698685813562,1046,245,27,36,19,13,8,23,41.9202832822525,43.5635025489192
0.816651501364877,0.857614811826484,1078,213,35,48,22,16,13,32,41.9202832822525,43.5635025489192
0.845542911332385,0.869249592816108,1061,230,37,50,26,19,11,31,41.9202832822525,43.5635025489192
0.815338645418327,0.844022508108463,1062,229,36,79,23,24,13,55,41.9202832822525,43.5635025489192
0.758678191024969,0.797727036119494,1088,203,46,69,19,23,27,46,41.9202832822525,43.5635025489192
0.807038512616202,0.860579482094502,1075,216,36,104,19,23,17,81,41.9202832822525,43.5635025489192
0.767056354916067,0.827877054538131,1054,237,40,133,23,31,17,102,41.9202832822525,43.5635025489192
0.709481902278512,0.751755806275081,1070,221,52,74,26,26,26,48,41.9202832822525,43.5635025489192
0.791649117881043,0.841404499904954,1091,200,34,73,19,22,15,51,41.9202832822525,43.5635025489192
0.716932270916335,0.763056486653558,1056,235,36,60,16,16,20,44,41.9202832822525,43.5635025489192
0.717446043165468,0.758055391081268,1061,230,40,36,18,11,22,25,41.9202832822525,43.5635025489192
0.689408577309195,0.754554915276813,1060,231,38,67,16,17,22,50,41.9202832822525,43.5635025489192
0.716423196104471,0.760702886954153,1075,216,36,43,16,15,20,28,41.9202832822525,43.5635025489192
0.755681102196833,0.804704076587515,1091,200,38,76,21,22,17,54,41.9202832822525,43.5635025489192
0.750865740090786,0.812112595266481,1069,222,34,54,17,15,17,39,41.9202832822525,43.5635025489192
0.699674045418726,0.73463450557744,1079,212,22,28,9,9,13,19,41.9202832822525,43.5635025489192
0.744241949910554,0.775936677980126,1054,237,43,28,20,9,23,19,41.9202832822525,43.5635025489192
0.729313173933427,0.790528575287495,1075,216,27,76,13,16,14,60,41.9202832822525,43.5635025489192
0.754603806994245,0.802628843503173,1083,208,36,52,20,15,16,37,41.9202832822525,43.5635025489192
0.712859672421425,0.727831427767893,1060,231,36,26,13,3,23,23,41.9202832822525,43.5635025489192
0.719481300575928,0.749441347998249,1043,248,44,35,18,9,26,26,41.9202832822525,43.5635025489192
0.724385805277525,0.75467860342461,1051,240,35,52,17,19,18,33,41.9202832822525,43.5635025489192
0.784915891987605,0.831840316028143,1068,223,36,41,21,11,15,30,41.9202832822525,43.5635025489192
0.681922293858161,0.745202692886231,1051,240,28,67,10,13,18,54,41.9202832822525,43.5635025489192
0.795822152653548,0.836210819292768,1085,206,43,64,26,20,17,44,41.9202832822525,43.5635025489192
0.705986859747922,0.750294932801098,1053,238,48,36,25,16,23,20,41.9202832822525,43.5635025489192
0.719308478951549,0.768074951087862,1052,239,32,34,13,10,19,24,41.9202832822525,43.5635025489192
0.692392927687045,0.729532422647841,1048,243,33,64,12,18,21,46,41.9202832822525,43.5635025489192
0.719365968965649,0.770260594031024,1068,223,42,48,21,12,21,36,41.9202832822525,43.5635025489192
0.793322102110534,0.841331365993589,1073,218,34,41,19,5,15,36,41.9202832822525,43.5635025489192
0.751200109724318,0.799469862380119,1075,216,23,49,11,15,12,34,41.9202832822525,43.5635025489192
0.765500468823254,0.807402780329986,1053,238,27,43,18,14,9,29,41.9202832822525,43.5635025489192
0.675266175266175,0.718097833511496,1057,234,37,44,15,13,22,31,41.9202832822525,43.5635025489192
0.670906007751938,0.703960399399403,1059,232,43,51,17,11,26,40,41.9202832822525,43.5635025489192
0.741765794343114,0.809765449200006,1057,234,30,47,16,17,14,30,41.9202832822525,43.5635025489192
0.688813729874776,0.724999955607067,1060,231,43,59,17,10,26,49,41.9202832822525,43.5635025489192
0.73827650013217,0.786443689631003,1072,219,30,35,15,9,15,26,41.9202832822525,43.5635025489192
0.757129513134317,0.799670904818423,1037,254,42,47,27,14,15,33,41.9202832822525,43.5635025489192
0.791731012213955,0.83041476621021,1061,230,34,28,19,9,15,19,41.9202832822525,43.5635025489192
0.748760236578708,0.786234008604866,1054,237,35,56,17,15,18,41,41.9202832822525,43.5635025489192
0.662529738302934,0.702970668426134,1086,205,30,60,9,10,21,50,41.9202832822525,43.5635025489192
0.766355777979982,0.800235568204161,1048,243,35,72,18,17,17,55,41.9202832822525,43.5635025489192
0.846482298382536,0.862139631708996,1071,220,28,34,21,12,7,22,41.9202832822525,43.5635025489192
0.721906278434941,0.762641021896401,1065,226,35,47,17,17,18,30,41.9202832822525,43.5635025489192
0.788611578085262,0.831078055859005,1093,198,37,96,19,24,18,72,41.9202832822525,43.5635025489192
0.698226427459654,0.729311920241388,1052,239,39,40,19,12,20,28,41.9202832822525,43.5635025489192
0.709101382488479,0.741035066052162,1071,220,31,39,7,7,24,32,41.9202832822525,43.5635025489192
0.75435468385681,0.779777564691243,1083,208,23,45,7,11,16,34,41.9202832822525,43.5635025489192
0.727888989990901,0.783552927462253,1074,217,35,66,13,9,22,57,41.9202832822525,43.5635025489192
0.791844858962693,0.830590893934004,1031,260,35,70,23,25,12,45,41.9202832822525,43.5635025489192
0.746363681493248,0.795658248876612,1076,215,32,67,16,17,16,50,41.9202832822525,43.5635025489192
0.742384383697434,0.821094320813098,1063,228,42,101,18,25,24,76,41.9202832822525,43.5635025489192
0.806125583681494,0.841722229785807,1063,228,39,28,23,11,16,17,41.9202832822525,43.5635025489192
0.666057990261177,0.700118659187464,1080,211,36,52,12,13,24,39,41.9202832822525,43.5635025489192
0.722479163655634,0.741517474531022,1060,231,33,25,14,5,19,20,41.9202832822525,43.5635025489192
0.739568515884305,0.791179366991158,1059,232,37,74,20,17,17,57,41.9202832822525,43.5635025489192
0.685160391278212,0.738794778784023,1070,221,29,29,11,7,18,22,41.9202832822525,43.5635025489192
0.756251091321809,0.802823469901143,1064,227,46,69,25,18,21,51,41.9202832822525,43.5635025489192
0.703995861890599,0.748300880978417,1052,239,37,63,17,18,20,45,41.9202832822525,43.5635025489192
0.737775609756098,0.805708586031045,1072,219,41,46,19,16,22,30,41.9202832822525,43.5635025489192
0.785904815386775,0.829062248594832,1064,227,34,56,20,15,14,41,41.9202832822525,43.5635025489192
0.727734568607267,0.768210505293055,1071,220,42,29,19,10,23,19,41.9202832822525,43.5635025489192
0.632724656927844,0.680736046137474,1069,222,36,42,10,14,26,28,41.9202832822525,43.5635025489192
0.805709736123749,0.847053429200339,1076,215,35,60,22,25,13,35,41.9202832822525,43.5635025489192
0.788007541395705,0.830642569926031,1078,213,29,63,16,18,13,45,41.9202832822525,43.5635025489192
0.77846392208942,0.810170721092858,1051,240,36,38,20,11,16,27,41.9202832822525,43.5635025489192
0.781503339353972,0.823192486236085,1067,224,38,58,19,27,19,31,41.9202832822525,43.5635025489192
0.787361664453298,0.818415104037128,1084,207,36,64,19,22,17,42,41.9202832822525,43.5635025489192
0.737051792828685,0.757751076584422,1068,223,36,18,14,5,22,13,41.9202832822525,43.5635025489192
0.704093962480544,0.735309525053087,1046,245,39,23,16,5,23,18,41.9202832822525,43.5635025489192
0.706994995450409,0.754031490233978,1050,241,35,40,16,13,19,27,41.9202832822525,43.5635025489192
0.742883181780945,0.792371088064243,1062,229,39,87,18,22,21,65,41.9202832822525,43.5635025489192
0.748970783532537,0.78088095660383,1065,226,36,37,16,7,20,30,41.9202832822525,43.5635025489192
0.684546437090042,0.728920501293323,1053,238,43,61,18,21,25,40,41.9202832822525,43.5635025489192
0.693236016765429,0.723268312298693,1062,229,33,34,13,8,20,26,41.9202832822525,43.5635025489192
0.733124436798558,0.775196147298091,1068,223,39,68,18,16,21,52,41.9202832822525,43.5635025489192
0.704858344400177,0.759819135346825,1067,224,36,43,16,10,20,33,41.9202832822525,43.5635025489192
0.702162010388881,0.738445262682658,1081,210,34,35,13,12,21,23,41.9202832822525,43.5635025489192
0.732315474727615,0.800958142304539,1046,245,39,95,22,24,17,71,41.9202832822525,43.5635025489192
0.789020922942334,0.827872196197376,1083,208,44,64,25,20,19,44,41.9202832822525,43.5635025489192
0.764842717420037,0.808142078411946,1054,237,30,52,15,15,15,37,41.9202832822525,43.5635025489192
0.763884780965526,0.828566401946287,1049,242,49,89,30,30,19,59,41.9202832822525,43.5635025489192
0.751789976133652,0.792515258907101,1068,223,34,53,16,17,18,36,41.9202832822525,43.5635025489192
0.72573354480571,0.761300731807124,1080,211,30,47,12,11,18,36,41.9202832822525,43.5635025489192
0.703584229390681,0.73307604797331,1073,218,31,30,10,8,21,22,41.9202832822525,43.5635025489192
0.734030707923113,0.770971868742181,1089,202,27,55,10,10,17,45,41.9202832822525,43.5635025489192
0.78362824608831,0.823912393475583,1069,222,39,28,17,10,22,18,41.9202832822525,43.5635025489192
0.6307493594321,0.703510594348917,1079,212,38,76,15,16,23,60,41.9202832822525,43.5635025489192
0.701334109228846,0.746452423787788,1075,216,37,47,12,10,25,37,41.9202832822525,43.5635025489192
0.601968503937008,0.632519939993743,1073,218,21,32,6,6,15,26,41.9202832822525,43.5635025489192
0.6532217415046,0.687823111016688,1059,232,38,51,12,12,26,39,41.9202832822525,43.5635025489192
0.733073541167066,0.778846355049552,1061,230,40,99,17,26,23,73,41.9202832822525,43.5635025489192
0.763687395203033,0.802495206984342,1037,254,44,37,27,18,17,19,41.9202832822525,43.5635025489192
0.782470119521912,0.813591724530176,1073,218,36,45,19,12,17,33,41.9202832822525,43.5635025489192
0.748598995506212,0.78025111104389,1038,253,30,32,18,10,12,22,41.9202832822525,43.5635025489192
0.735071833029154,0.761093739333858,1057,234,34,38,14,8,20,30,41.9202832822525,43.5635025489192
0.765334712703134,0.803454248701471,1078,213,37,57,19,15,18,42,41.9202832822525,43.5635025489192
0.68010474589422,0.747055106273642,1041,250,37,88,16,25,21,63,41.9202832822525,43.5635025489192
0.693204957945994,0.737500646925231,1057,234,36,67,15,19,21,48,41.9202832822525,43.5635025489192
0.758159364892679,0.789781311471041,1071,220,38,40,18,13,20,27,41.9202832822525,43.5635025489192
0.779040832485013,0.83236970874252,1048,243,28,46,15,15,13,31,41.9202832822525,43.5635025489192
0.79070243902439,0.822810556379042,1081,210,41,62,20,16,21,46,41.9202832822525,43.5635025489192
0.747687527099292,0.793115996871905,1062,229,33,45,16,11,17,34,41.9202832822525,43.5635025489192
0.680692653421263,0.727375244229387,1070,221,38,50,15,10,23,40,41.9202832822525,43.5635025489192
0.729869411243913,0.781349567893779,1068,223,36,69,18,20,18,49,41.9202832822525,43.5635025489192
0.766724433512224,0.804880041441826,1056,235,43,88,21,23,22,65,41.9202832822525,43.5635025489192
0.803740593182824,0.84313657742557,1053,238,36,49,24,15,12,34,41.9202832822525,43.5635025489192
0.748586874363272,0.781587000606032,1054,237,49,61,23,23,26,38,41.9202832822525,43.5635025489192
0.774332540311922,0.809601652315293,1060,231,30,50,16,15,14,35,41.9202832822525,43.5635025489192
0.766876936697654,0.809096634308412,1036,255,36,26,20,9,16,17,41.9202832822525,43.5635025489192
0.792925278219396,0.832647707671236,1066,225,33,35,16,14,17,21,41.9202832822525,43.5635025489192
0.706824308485701,0.761070937741922,1066,225,27,72,11,20,16,52,41.9202832822525,43.5635025489192
0.757983613109512,0.790012299187969,1067,224,40,68,19,20,21,48,41.9202832822525,43.5635025489192
0.74108521690299,0.791644189936623,1064,227,34,55,16,11,18,44,41.9202832822525,43.5635025489192
0.730373668587393,0.791736178546487,1068,223,46,45,22,14,24,31,41.9202832822525,43.5635025489192
0.807129826695044,0.872789985984906,1082,209,26,57,17,18,9,39,41.9202832822525,43.5635025489192
0.749421881774823,0.770975994316667,1046,245,33,21,15,5,18,16,41.9202832822525,43.5635025489192
0.736558575208972,0.784139768567436,1066,225,38,52,18,13,20,39,41.9202832822525,43.5635025489192
0.700035703784601,0.748298837993819,1067,224,38,37,19,10,19,27,41.9202832822525,43.5635025489192
0.803400818926297,0.863399884942653,1064,227,35,48,22,16,13,32,41.9202832822525,43.5635025489192
0.711177384802789,0.789724938255801,1059,232,38,61,18,21,20,40,41.9202832822525,43.5635025489192
0.740364135332186,0.787593087428205,1064,227,39,37,20,12,19,25,41.9202832822525,43.5635025489192
0.708848953594177,0.733412066388063,1076,215,35,30,14,4,21,26,41.9202832822525,43.5635025489192
0.746477430982223,0.789592922640951,1065,226,39,53,20,23,19,30,41.9202832822525,43.5635025489192
0.782360975609756,0.821929920789544,1054,237,41,38,23,11,18,27,41.9202832822525,43.5635025489192
0.735578832406672,0.769007247143106,1084,207,32,77,13,11,19,66,41.9202832822525,43.5635025489192
0.7584638971731,0.782976109458659,1055,236,38,47,17,13,21,34,41.9202832822525,43.5635025489192
0.731344924060751,0.795630022873997,1080,211,40,46,22,16,18,30,41.9202832822525,43.5635025489192
0.811260991207034,0.856233395455005,1058,233,40,38,26,15,14,23,41.9202832822525,43.5635025489192
0.796625690693487,0.82679526539953,1064,227,52,48,29,18,23,30,41.9202832822525,43.5635025489192
0.752598566308244,0.797347112615422,1070,221,31,49,13,11,18,38,41.9202832822525,43.5635025489192
0.716590548054011,0.773891717749051,1087,204,32,26,15,8,17,18,41.9202832822525,43.5635025489192
0.737642083002908,0.78280851363465,1063,228,30,43,15,17,15,26,41.9202832822525,43.5635025489192
0.768640786338364,0.832151634124058,1088,203,32,50,18,12,14,38,41.9202832822525,43.5635025489192
0.755096818220592,0.796074761151868,1057,234,57,62,32,25,25,37,41.9202832822525,43.5635025489192
0.753028196981732,0.814550067402307,1071,220,32,37,11,6,21,31,41.9202832822525,43.5635025489192
0.778953579858379,0.799354891781877,1058,233,20,21,9,5,11,16,41.9202832822525,43.5635025489192
0.734440076746689,0.766969629489618,1083,208,34,49,14,15,20,34,41.9202832822525,43.5635025489192
0.772959690230342,0.816266300664906,1065,226,32,20,19,5,13,15,41.9202832822525,43.5635025489192
0.782194244604317,0.834865084341738,1086,205,40,83,23,25,17,58,41.9202832822525,43.5635025489192
0.681430858972893,0.735078883027006,1070,221,42,71,15,20,27,51,41.9202832822525,43.5635025489192
0.734557524031208,0.767538013514215,1058,233,37,31,20,11,17,20,41.9202832822525,43.5635025489192
0.739360296061327,0.788478357621481,1069,222,30,27,17,8,13,19,41.9202832822525,43.5635025489192
0.782941095984128,0.832504420531851,1098,193,47,82,26,23,21,59,41.9202832822525,43.5635025489192
0.725166410650282,0.767734308999888,1070,221,31,24,11,3,20,21,41.9202832822525,43.5635025489192
0.769451269451269,0.813936319259539,1079,212,33,54,17,14,16,40,41.9202832822525,43.5635025489192
0.776361221779548,0.805119758854435,1075,216,36,61,18,17,18,44,41.9202832822525,43.5635025489192
0.782539166723678,0.81557214561361,1049,242,47,31,29,12,18,19,41.9202832822525,43.5635025489192
0.793838096469675,0.808982542790205,1042,249,37,48,20,12,17,36,41.9202832822525,43.5635025489192
0.686354581673307,0.729179798239799,1073,218,36,50,12,10,24,40,41.9202832822525,43.5635025489192
0.648341439422919,0.691279877638704,1079,212,29,35,9,10,20,25,41.9202832822525,43.5635025489192
0.670024334316065,0.717501436409902,1082,209,34,32,15,12,19,20,41.9202832822525,43.5635025489192
0.803687804878049,0.84544825174933,1056,235,41,79,22,20,19,59,41.9202832822525,43.5635025489192
0.796868083222665,0.82494225192506,1030,261,36,56,22,14,14,42,41.9202832822525,43.5635025489192
0.769046281997286,0.81534756065243,1077,214,34,27,17,14,17,13,41.9202832822525,43.5635025489192
0.743124444140384,0.778927433743658,1058,233,47,84,26,24,21,60,41.9202832822525,43.5635025489192
0.756167873424511,0.793556693169178,1058,233,48,62,25,17,23,45,41.9202832822525,43.5635025489192
0.679804620299828,0.71673936113011,1066,225,39,63,14,11,25,52,41.9202832822525,43.5635025489192
0.721984407178582,0.753018916094431,1052,239,55,64,24,22,31,42,41.9202832822525,43.5635025489192
0.767572385219444,0.81114847512087,1068,223,33,45,18,11,15,34,41.9202832822525,43.5635025489192
0.720113085621971,0.759448327539582,1058,233,53,79,22,25,31,54,41.9202832822525,43.5635025489192
0.739658273381295,0.787976321684687,1070,221,40,51,20,18,20,33,41.9202832822525,43.5635025489192
0.706153100775194,0.740368199702951,1076,215,43,92,14,21,29,71,41.9202832822525,43.5635025489192
0.736335617914565,0.782900577170635,1052,239,37,39,20,15,17,24,41.9202832822525,43.5635025489192
0.754252950812786,0.831939530799009,1053,238,38,122,21,29,17,93,41.9202832822525,43.5635025489192
0.706821795057089,0.732314824947999,1056,235,33,33,14,10,19,23,41.9202832822525,43.5635025489192
0.736197377501725,0.794996658396174,1068,223,49,78,29,23,20,55,41.9202832822525,43.5635025489192
0.69304196244802,0.739054054443016,1096,195,38,39,18,10,20,29,41.9202832822525,43.5635025489192
0.746776158272777,0.801215274038442,1086,205,38,70,18,15,20,55,41.9202832822525,43.5635025489192
0.743614431164232,0.787896007317247,1063,228,36,39,17,9,19,30,41.9202832822525,43.5635025489192
0.776728844404004,0.821210982528604,1066,225,35,63,22,19,13,44,41.9202832822525,43.5635025489192
0.755121382226434,0.800364948741952,1081,210,44,49,20,17,24,32,41.9202832822525,43.5635025489192
0.788276557315076,0.816322221194841,1070,221,38,21,18,6,20,15,41.9202832822525,43.5635025489192
0.746883530482256,0.783736700793103,1074,217,35,66,15,13,20,53,41.9202832822525,43.5635025489192
0.737458467874023,0.768634357282793,1057,234,34,24,14,9,20,15,41.9202832822525,43.5635025489192
0.755405762622258,0.79976678084641,1084,207,30,46,14,12,16,34,41.9202832822525,43.5635025489192
0.71073703366697,0.747880243209246,1061,230,35,39,16,9,19,30,41.9202832822525,43.5635025489192
0.761632669779635,0.797103973968459,1061,230,39,36,19,13,20,23,41.9202832822525,43.5635025489192
0.787716159809183,0.827915860750429,1042,249,43,49,28,24,15,25,41.9202832822525,43.5635025489192
0.757359511517077,0.8332713764461,1084,207,32,107,17,19,15,88,41.9202832822525,43.5635025489192
0.77619614062913,0.840660413736533,1097,194,30,43,16,10,14,33,41.9202832822525,43.5635025489192
0.757993680884676,0.794243267337591,1099,192,25,35,11,8,14,27,41.9202832822525,43.5635025489192
0.739589595059839,0.777725306858431,1087,204,29,24,14,2,15,22,41.9202832822525,43.5635025489192
0.787100185038329,0.842245978766027,1059,232,30,122,15,28,15,94,41.9202832822525,43.5635025489192
0.70176947652986,0.740108461871123,1077,214,39,41,16,10,23,31,41.9202832822525,43.5635025489192
0.73923635905406,0.772891790270588,1079,212,38,95,21,22,17,73,41.9202832822525,43.5635025489192
0.830190349712262,0.84706643614468,1074,217,36,21,21,7,15,14,41.9202832822525,43.5635025489192
0.787391193036354,0.838377376526666,1073,218,31,46,18,16,13,30,41.9202832822525,43.5635025489192
0.799040198261016,0.859185852120753,1066,225,38,92,24,30,14,62,41.9202832822525,43.5635025489192
0.718780487804878,0.775893297188251,1056,235,41,86,19,23,22,63,41.9202832822525,43.5635025489192
0.77287170263789,0.806089666552144,1076,215,40,53,17,18,23,35,41.9202832822525,43.5635025489192
0.800442451945617,0.828296204202,1077,214,27,27,16,9,11,18,41.9202832822525,43.5635025489192
0.70125624308971,0.740884128770163,1067,224,42,52,18,11,24,41,41.9202832822525,43.5635025489192
0.78110998699234,0.827942622595558,1092,199,33,40,18,13,15,27,41.9202832822525,43.5635025489192
0.765719406041987,0.8095971379578,1040,251,31,83,16,22,15,61,41.9202832822525,43.5635025489192
0.737831693500298,0.773771310254899,1059,232,43,43,22,14,21,29,41.9202832822525,43.5635025489192
0.7651728844404,0.837256274167929,1083,208,35,81,20,22,15,59,41.9202832822525,43.5635025489192
0.713235602973915,0.76950257336587,1085,206,38,27,18,6,20,21,41.9202832822525,43.5635025489192
0.700932666060054,0.751291976691383,1063,228,35,34,13,14,22,20,41.9202832822525,43.5635025489192
0.756528148252141,0.784272034912757,1054,237,34,33,16,10,18,23,41.9202832822525,43.5635025489192
0.672521982414069,0.703280399449101,1075,216,40,52,10,12,30,40,41.9202832822525,43.5635025489192
0.763242375601926,0.80833456326119,1049,242,45,62,24,18,21,44,41.9202832822525,43.5635025489192
0.731844524380496,0.772057093399408,1049,242,40,35,21,10,19,25,41.9202832822525,43.5635025489192
0.773691992720655,0.822639973012237,1057,234,35,38,19,12,16,26,41.9202832822525,43.5635025489192
0.739622818100987,0.786539961675426,1056,235,34,28,19,10,15,18,41.9202832822525,43.5635025489192
0.720257051865332,0.770296217347592,1055,236,35,65,13,18,22,47,41.9202832822525,43.5635025489192
0.727724741447892,0.782850412254241,1075,216,34,70,15,18,19,52,41.9202832822525,43.5635025489192
0.733559762971528,0.787936326831377,1074,217,33,58,18,13,15,45,41.9202832822525,43.5635025489192
0.754139570468332,0.806061688472326,1071,220,29,89,12,22,17,67,41.9202832822525,43.5635025489192
0.765206438928484,0.802429283933958,1058,233,39,34,21,10,18,24,41.9202832822525,43.5635025489192
0.685111464968153,0.732559332338246,1068,223,35,53,16,11,19,42,41.9202832822525,43.5635025489192
0.751582278481013,0.790305619041264,1097,194,27,102,10,20,17,82,41.9202832822525,43.5635025489192
0.665934940855323,0.69680434500894,1082,209,35,25,11,8,24,17,41.9202832822525,43.5635025489192
0.749887359711641,0.799244218065128,1059,232,39,92,17,20,22,72,41.9202832822525,43.5635025489192
0.717535971223021,0.765136660443378,1052,239,40,63,14,17,26,46,41.9202832822525,43.5635025489192
0.727349806201551,0.773985571998197,1057,234,43,76,20,23,23,53,41.9202832822525,43.5635025489192
0.762389442650569,0.805589071253869,1065,226,34,42,18,13,16,29,41.9202832822525,43.5635025489192
0.728878399931032,0.790827865471189,1059,232,37,42,21,12,16,30,41.9202832822525,43.5635025489192
0.770023980815348,0.8057571902723,1067,224,40,59,21,22,19,37,41.9202832822525,43.5635025489192
0.7299135577798,0.781185742910518,1056,235,35,89,18,21,17,68,41.9202832822525,43.5635025489192
0.82474460106039,0.846920660728946,1093,198,37,46,18,13,19,33,41.9202832822525,43.5635025489192
0.745568039950062,0.788347141224016,1036,255,45,60,25,21,20,39,41.9202832822525,43.5635025489192
0.719730440826052,0.756159428668985,1059,232,32,49,15,10,17,39,41.9202832822525,43.5635025489192
0.694300575475874,0.752347558905781,1068,223,36,135,15,29,21,106,41.9202832822525,43.5635025489192
0.680075087154733,0.724692942867837,1043,248,48,40,19,11,29,29,41.9202832822525,43.5635025489192
0.738487996630633,0.787076142099151,1044,247,34,47,17,14,17,33,41.9202832822525,43.5635025489192
0.749285142399634,0.801081825529739,1070,221,42,38,23,14,19,24,41.9202832822525,43.5635025489192
0.797896485563199,0.813278707344306,1056,235,34,17,16,4,18,13,41.9202832822525,43.5635025489192
0.666925694123577,0.705491486596012,1065,226,38,46,14,11,24,35,41.9202832822525,43.5635025489192
0.721655607438355,0.766767427023823,1073,218,39,41,17,9,22,32,41.9202832822525,43.5635025489192
0.765047961630695,0.775685410814877,1092,199,40,29,18,6,22,23,41.9202832822525,43.5635025489192
0.757992240013115,0.820472006359755,1053,238,29,41,19,12,10,29,41.9202832822525,43.5635025489192
0.671126604692342,0.730168071914951,1067,224,36,66,15,15,21,51,41.9202832822525,43.5635025489192
0.709833407871199,0.756298843912187,1060,231,43,48,20,16,23,32,41.9202832822525,43.5635025489192
0.697501275789167,0.738536685388983,1074,217,44,48,19,21,25,27,41.9202832822525,43.5635025489192
0.728316924519456,0.763578036673742,1069,222,27,20,12,3,15,17,41.9202832822525,43.5635025489192
0.709038054968288,0.755353152848094,1068,223,44,32,23,10,21,22,41.9202832822525,43.5635025489192
0.690550175844294,0.735455260979443,1069,222,33,62,14,11,19,51,41.9202832822525,43.5635025489192
0.746648562438036,0.787504511152214,1064,227,37,80,17,18,20,62,41.9202832822525,43.5635025489192
0.716083730789613,0.748935573840787,1079,212,33,61,13,18,20,43,41.9202832822525,43.5635025489192
0.751211240310077,0.8158373709124,1055,236,43,73,25,19,18,54,41.9202832822525,43.5635025489192
0.759763351868615,0.815780584047709,1073,218,37,96,21,25,16,71,41.9202832822525,43.5635025489192
0.780631746965178,0.824554412701529,1081,210,38,56,20,18,18,38,41.9202832822525,43.5635025489192
0.735511702444842,0.767202654979341,1063,228,43,114,17,28,26,86,41.9202832822525,43.5635025489192
0.673980487804878,0.706261917195004,1061,230,41,66,15,14,26,52,41.9202832822525,43.5635025489192
0.744150879993279,0.808394412733672,1082,209,38,73,16,22,22,51,41.9202832822525,43.5635025489192
0.797182254196643,0.838955574239681,1067,224,40,105,21,24,19,81,41.9202832822525,43.5635025489192
0.761498340445709,0.798452386415613,1075,216,37,24,19,7,18,17,41.9202832822525,43.5635025489192
0.732839024390244,0.771159895667578,1053,238,41,17,21,7,20,10,41.9202832822525,43.5635025489192
0.692537843598011,0.732240624641723,1058,233,29,129,11,22,18,107,41.9202832822525,43.5635025489192
0.765157873701039,0.80152225734089,1073,218,40,52,22,13,18,39,41.9202832822525,43.5635025489192
0.763866755201417,0.794891500507006,1070,221,36,61,17,13,19,48,41.9202832822525,43.5635025489192
0.677015596087761,0.724655417404903,1065,226,30,47,14,12,16,35,41.9202832822525,43.5635025489192
0.794282926829268,0.839205471887096,1087,204,41,48,26,18,15,30,41.9202832822525,43.5635025489192
0.701091711015528,0.729245119725166,1060,231,44,19,22,8,22,11,41.9202832822525,43.5635025489192
0.732059474072254,0.757914191438851,1062,229,39,49,16,17,23,32,41.9202832822525,43.5635025489192
0.752961313899273,0.781255483696048,1066,225,38,39,15,14,23,25,41.9202832822525,43.5635025489192
0.67886690647482,0.714622267329416,1039,252,40,45,16,13,24,32,41.9202832822525,43.5635025489192
0.714380121596616,0.77295174322961,1067,224,30,46,15,18,15,28,41.9202832822525,43.5635025489192
0.722068292682927,0.79618891775923,1105,186,41,101,18,25,23,76,41.9202832822525,43.5635025489192
0.647089378143909,0.712516412134892,1079,212,44,90,17,26,27,64,41.9202832822525,43.5635025489192
0.801748561310314,0.845676674356526,1039,252,36,69,22,21,14,48,41.9202832822525,43.5635025489192
0.76468980097689,0.802526690206794,1073,218,44,73,24,26,20,47,41.9202832822525,43.5635025489192
0.814684424838819,0.847869572432904,1046,245,28,56,17,14,11,42,41.9202832822525,43.5635025489192
0.772630919689743,0.804249331894953,1038,253,33,62,14,12,19,50,41.9202832822525,43.5635025489192
0.757158861139953,0.817010115129323,1066,225,29,84,16,25,13,59,41.9202832822525,43.5635025489192
0.750395882818686,0.775638613741466,1076,215,28,22,10,3,18,19,41.9202832822525,43.5635025489192
0.777161055505005,0.838918950349329,1072,219,35,67,21,23,14,44,41.9202832822525,43.5635025489192
0.79206745915067,0.827106541750413,1078,213,38,57,20,23,18,34,41.9202832822525,43.5635025489192
0.759840053957701,0.791906624656638,1056,235,33,61,16,23,17,38,41.9202832822525,43.5635025489192
0.727881543376751,0.80446068422132,1043,248,39,100,21,30,18,70,41.9202832822525,43.5635025489192
0.784922083391829,0.822923053959782,1064,227,34,102,20,27,14,75,41.9202832822525,43.5635025489192
0.70734005079053,0.779293628945563,1054,237,39,119,16,26,23,93,41.9202832822525,43.5635025489192
0.714147161515583,0.756824227271454,1050,241,37,65,18,24,19,41,41.9202832822525,43.5635025489192
0.754076738609113,0.798727839347524,1086,205,40,96,20,17,20,79,41.9202832822525,43.5635025489192
0.70328054773806,0.764218929857917,1059,232,38,34,15,13,23,21,41.9202832822525,43.5635025489192
0.730893572998836,0.776162661045685,1072,219,37,42,18,18,19,24,41.9202832822525,43.5635025489192
0.737453658536585,0.810339628071347,1070,221,41,66,21,19,20,47,41.9202832822525,43.5635025489192
0.789217470427661,0.829422143995867,1075,216,35,57,23,21,12,36,41.9202832822525,43.5635025489192
0.710720289667658,0.738553995532032,1082,209,37,42,15,10,22,32,41.9202832822525,43.5635025489192
0.755271185304371,0.79638916153713,1061,230,48,53,25,21,23,32,41.9202832822525,43.5635025489192
0.729986011191047,0.793335036640738,1074,217,40,60,20,14,20,46,41.9202832822525,43.5635025489192
0.773939287388654,0.818089886401555,1086,205,27,46,14,12,13,34,41.9202832822525,43.5635025489192
0.747265913000738,0.785606452315006,1067,224,39,36,20,13,19,23,41.9202832822525,43.5635025489192
0.78936656076251,0.825901072747351,1052,239,32,38,19,13,13,25,41.9202832822525,43.5635025489192
0.732259472673302,0.757400592625473,1081,210,46,46,20,18,26,28,41.9202832822525,43.5635025489192
0.672715148111751,0.709467695878126,1085,206,34,35,13,9,21,26,41.9202832822525,43.5635025489192
0.664811870694224,0.707245019595134,1073,218,33,56,14,10,19,46,41.9202832822525,43.5635025489192
0.717499339148824,0.757813476685262,1073,218,30,63,12,21,18,42,41.9202832822525,43.5635025489192
0.693394777265745,0.710753253587196,1077,214,31,25,10,6,21,19,41.9202832822525,43.5635025489192
0.680312665606783,0.733165195377777,1066,225,33,65,15,16,18,49,41.9202832822525,43.5635025489192
0.697606246799795,0.735626471385207,1090,201,31,40,13,11,18,29,41.9202832822525,43.5635025489192
0.789114159243675,0.822600937756442,1077,214,29,66,14,13,15,53,41.9202832822525,43.5635025489192
0.720897041302621,0.770196677760663,1062,229,32,91,16,23,16,68,41.9202832822525,43.5635025489192
0.778275705186533,0.820942790949019,1059,232,35,50,17,11,18,39,41.9202832822525,43.5635025489192
0.779739342037531,0.829643879315963,1071,220,34,44,18,18,16,26,41.9202832822525,43.5635025489192
0.731777231777232,0.790964599403814,1058,233,37,134,16,38,21,96,41.9202832822525,43.5635025489192
0.745721987810596,0.803983605649731,1067,224,27,84,14,23,13,61,41.9202832822525,43.5635025489192
0.782597866854196,0.819774732648511,1066,225,27,30,16,9,11,21,41.9202832822525,43.5635025489192
0.653141109023462,0.705642470067176,1067,224,33,36,12,10,21,26,41.9202832822525,43.5635025489192
0.731073703366697,0.772805055057516,1059,232,35,84,17,26,18,58,41.9202832822525,43.5635025489192
0.751180324709736,0.800991906507587,1072,219,33,62,17,19,16,43,41.9202832822525,43.5635025489192
0.710211282395934,0.738826887533215,1092,199,38,31,15,5,23,26,41.9202832822525,43.5635025489192
0.708246132848044,0.769846582770076,1051,240,35,120,16,42,19,78,41.9202832822525,43.5635025489192
0.760342426476612,0.811971285185489,1067,224,39,107,20,27,19,80,41.9202832822525,43.5635025489192
0.833212892036421,0.870384155313922,1074,217,33,127,20,40,13,87,41.9202832822525,43.5635025489192
0.735926117505065,0.794471956876523,1049,242,37,67,21,25,16,42,41.9202832822525,43.5635025489192
0.722552696236907,0.756524446967861,1083,208,37,53,15,9,22,44,41.9202832822525,43.5635025489192
0.758689717925387,0.792849437568342,1099,192,35,38,13,10,22,28,41.9202832822525,43.5635025489192
0.722372611464968,0.780078365775509,1063,228,35,44,18,14,17,30,41.9202832822525,43.5635025489192
0.779580487804878,0.805866756048285,1043,248,41,49,20,13,21,36,41.9202832822525,43.5635025489192
0.685478964855632,0.723267400156797,1064,227,34,98,12,23,22,75,41.9202832822525,43.5635025489192
0.68817994707439,0.725393518626474,1077,214,38,63,15,14,23,49,41.9202832822525,43.5635025489192
0.709772867209414,0.741155168185073,1062,229,47,67,20,18,27,49,41.9202832822525,43.5635025489192
0.694325853852264,0.744150731509958,1055,236,32,61,13,17,19,44,41.9202832822525,43.5635025489192
0.80293611122779,0.843591671217886,1074,217,38,53,23,19,15,34,41.9202832822525,43.5635025489192
0.79549741858618,0.824292056412398,1067,224,32,29,16,12,16,17,41.9202832822525,43.5635025489192
0.822685624012638,0.839358447382432,1080,211,25,25,9,4,16,21,41.9202832822525,43.5635025489192
0.791369754552652,0.818313160450717,1061,230,28,34,15,10,13,24,41.9202832822525,43.5635025489192
0.713901689708141,0.751289007817564,1065,226,31,12,12,5,19,7,41.9202832822525,43.5635025489192
0.809911554120455,0.837346771525941,1064,227,34,41,17,15,17,26,41.9202832822525,43.5635025489192
0.76489923814205,0.809320702364465,1108,183,39,72,19,21,20,51,41.9202832822525,43.5635025489192
0.759047033392964,0.803863800893406,1057,234,43,61,22,18,21,43,41.9202832822525,43.5635025489192
0.736478984932593,0.787279691797821,1051,240,30,57,14,12,16,45,41.9202832822525,43.5635025489192
0.757607724384432,0.809049164246862,1090,201,32,42,17,14,15,28,41.9202832822525,43.5635025489192
0.794610447100487,0.851520793793207,1059,232,36,76,24,28,12,48,41.9202832822525,43.5635025489192
0.717565886211967,0.779557563087195,1074,217,28,59,11,9,17,50,41.9202832822525,43.5635025489192
0.645959393453379,0.706622153087957,1053,238,44,83,19,23,25,60,41.9202832822525,43.5635025489192
0.736290967226219,0.785947540446235,1073,218,40,48,20,12,20,36,41.9202832822525,43.5635025489192
0.723877693126894,0.767986093397455,1047,244,39,35,20,16,19,19,41.9202832822525,43.5635025489192
0.697591545834357,0.764879354852436,1077,214,39,129,17,39,22,90,41.9202832822525,43.5635025489192
0.729147465437788,0.781223378550969,1083,208,31,97,14,20,17,77,41.9202832822525,43.5635025489192
0.756278434940855,0.775596706009566,1062,229,35,64,16,17,19,47,41.9202832822525,43.5635025489192
0.818835304822566,0.84893999569025,1095,196,35,28,20,7,15,21,41.9202832822525,43.5635025489192
0.711678220035778,0.761778408766245,1067,224,43,89,18,22,25,67,41.9202832822525,43.5635025489192
0.740987216142496,0.804700379046244,1053,238,49,57,25,19,24,38,41.9202832822525,43.5635025489192
0.770477170580081,0.793156885913039,1067,224,38,34,16,10,22,24,41.9202832822525,43.5635025489192
0.763970811796899,0.785856835904566,1082,209,26,119,8,21,18,98,41.9202832822525,43.5635025489192
0.750696321782584,0.79040921894184,1053,238,39,71,20,22,19,49,41.9202832822525,43.5635025489192
0.758715896859937,0.801517811252466,1070,221,34,27,19,10,15,17,41.9202832822525,43.5635025489192
0.717601291130703,0.76180706642995,1069,222,33,66,17,15,16,51,41.9202832822525,43.5635025489192
0.786333597673804,0.820050340418866,1045,246,30,65,17,18,13,47,41.9202832822525,43.5635025489192
0.758488981731793,0.811388223858242,1053,238,39,80,22,25,17,55,41.9202832822525,43.5635025489192
0.767725081589269,0.810002043279163,1061,230,54,66,29,20,25,46,41.9202832822525,43.5635025489192
0.788273586588193,0.83419834927031,1053,238,45,54,29,20,16,34,41.9202832822525,43.5635025489192
0.74697185223501,0.801180225276647,1084,207,37,51,16,9,21,42,41.9202832822525,43.5635025489192
0.7625,0.785248363910735,1057,234,35,43,16,15,19,28,41.9202832822525,43.5635025489192
0.722848395703633,0.769919984848865,1068,223,47,74,22,22,25,52,41.9202832822525,43.5635025489192
0.622312195121951,0.662774758382314,1077,214,41,41,13,9,28,32,41.9202832822525,43.5635025489192
0.873865430149961,0.876758665394997,1051,240,24,22,21,9,3,13,41.9202832822525,43.5635025489192
0.785009809167112,0.832330154530263,1047,244,45,72,27,26,18,46,41.9202832822525,43.5635025489192
0.848598284059238,0.893909783812559,1079,212,29,51,19,16,10,35,41.9202832822525,43.5635025489192
0.696499264789051,0.739499734441181,1065,226,28,82,10,16,18,66,41.9202832822525,43.5635025489192
0.702859590289422,0.738005316408717,1079,212,44,55,18,13,26,42,41.9202832822525,43.5635025489192
0.775919732441472,0.804988327659335,1061,230,26,61,16,17,10,44,41.9202832822525,43.5635025489192
0.802392281258261,0.816731876864259,1056,235,30,24,18,4,12,20,41.9202832822525,43.5635025489192
0.730370731707317,0.799930150246446,1082,209,41,48,20,16,21,32,41.9202832822525,43.5635025489192
0.755992509363296,0.801826445038126,1060,231,45,68,23,17,22,51,41.9202832822525,43.5635025489192
0.756297034085879,0.821626221734839,1057,234,36,86,23,31,13,55,41.9202832822525,43.5635025489192
0.734607930828861,0.763402295147029,1056,235,43,51,19,20,24,31,41.9202832822525,43.5635025489192
0.78744910852169,0.81995247609924,1078,213,34,84,17,18,17,66,41.9202832822525,43.5635025489192
0.714300819455459,0.761600069388975,1055,236,30,72,14,16,16,56,41.9202832822525,43.5635025489192
0.700181983621474,0.741696513179511,1070,221,35,43,14,13,21,30,41.9202832822525,43.5635025489192
0.781891993074079,0.834941767236683,1052,239,34,64,23,19,11,45,41.9202832822525,43.5635025489192
0.72129756097561,0.753326583819839,1069,222,41,85,17,17,24,68,41.9202832822525,43.5635025489192
0.638543623837741,0.696006783619454,1076,215,33,57,10,12,23,45,41.9202832822525,43.5635025489192
0.80390205371248,0.833748723359792,1092,199,25,39,15,11,10,28,41.9202832822525,43.5635025489192
0.728694158075601,0.779255930746654,1038,253,30,40,17,14,13,26,41.9202832822525,43.5635025489192
0.714990900818926,0.76170735608281,1088,203,35,59,14,12,21,47,41.9202832822525,43.5635025489192
0.765343494085532,0.821586630537602,1072,219,35,52,17,16,18,36,41.9202832822525,43.5635025489192
0.704570606463037,0.768437046539464,1074,217,36,55,15,14,21,41,41.9202832822525,43.5635025489192
0.73873367962937,0.775641692877016,1056,235,34,58,15,15,19,43,41.9202832822525,43.5635025489192
0.71484393279985,0.775623603288501,1061,230,34,58,16,17,18,41,41.9202832822525,43.5635025489192
0.710434868943606,0.749230224783381,1081,210,32,74,10,15,22,59,41.9202832822525,43.5635025489192
0.730531324345757,0.769613904628704,1064,227,30,36,15,13,15,23,41.9202832822525,43.5635025489192
0.760668437361664,0.817080029909774,1055,236,36,83,19,24,17,59,41.9202832822525,43.5635025489192
0.695337222158679,0.749143425061975,1078,213,42,66,20,18,22,48,41.9202832822525,43.5635025489192
0.755533717066779,0.798161683127593,1052,239,34,32,19,12,15,20,41.9202832822525,43.5635025489192
0.840363349131122,0.860196242030275,1062,229,25,45,16,15,9,30,41.9202832822525,43.5635025489192
0.732851682278321,0.798129775094173,1081,210,38,86,21,21,17,65,41.9202832822525,43.5635025489192
0.786611155167856,0.81061907828077,1069,222,30,48,15,16,15,32,41.9202832822525,43.5635025489192
0.769048342961386,0.80529200307145,1052,239,26,22,11,6,15,16,41.9202832822525,43.5635025489192
0.738217175767296,0.803722140711588,1076,215,44,74,23,20,21,54,41.9202832822525,43.5635025489192
0.720449172576832,0.77428046729149,1073,218,22,47,7,10,15,37,41.9202832822525,43.5635025489192
0.677119703435493,0.726937027823159,1073,218,37,50,14,11,23,39,41.9202832822525,43.5635025489192
0.716976538291279,0.754679888552327,1070,221,36,43,14,13,22,30,41.9202832822525,43.5635025489192
0.742550045495905,0.776051152550158,1085,206,35,33,17,6,18,27,41.9202832822525,43.5635025489192
0.729202409546685,0.761193659443108,1058,233,42,42,19,12,23,30,41.9202832822525,43.5635025489192
0.716270097849045,0.75683178377892,1092,199,37,30,15,6,22,24,41.9202832822525,43.5635025489192
0.758001328021249,0.808199655402771,1078,213,36,44,18,18,18,26,41.9202832822525,43.5635025489192
0.720482942580373,0.770226481247648,1062,229,34,56,13,11,21,45,41.9202832822525,43.5635025489192
0.764279967819791,0.820948821189323,1063,228,48,63,29,20,19,43,41.9202832822525,43.5635025489192
0.708729216152019,0.770202399398917,1094,197,28,44,12,9,16,35,41.9202832822525,43.5635025489192
0.765306767868438,0.803618136457221,1061,230,51,67,29,17,22,50,41.9202832822525,43.5635025489192
0.73183575978162,0.779242423186656,1064,227,35,50,17,18,18,32,41.9202832822525,43.5635025489192
0.808149058149058,0.854336426061393,1069,222,37,66,21,27,16,39,41.9202832822525,43.5635025489192
0.739685701637893,0.771324460534539,1079,212,36,30,17,7,19,23,41.9202832822525,43.5635025489192
0.766087705296762,0.811100308803187,1064,227,38,40,22,15,16,25,41.9202832822525,43.5635025489192
0.762926073483842,0.807188494457464,1067,224,36,72,20,19,16,53,41.9202832822525,43.5635025489192
0.704390243902439,0.744351237239631,1055,236,41,78,20,21,21,57,41.9202832822525,43.5635025489192
0.812886597938144,0.847396997830609,1078,213,30,18,19,8,11,10,41.9202832822525,43.5635025489192
0.751458832933653,0.802471948752492,1080,211,40,110,18,27,22,83,41.9202832822525,43.5635025489192
0.773777340869993,0.812308495179787,1043,248,39,82,23,25,16,57,41.9202832822525,43.5635025489192
0.733792083712466,0.781910813637094,1084,207,35,53,13,9,22,44,41.9202832822525,43.5635025489192
0.779550515705579,0.811788961885699,1079,212,27,59,15,18,12,41,41.9202832822525,43.5635025489192
0.736055433423854,0.781620902977243,1083,208,37,77,19,20,18,57,41.9202832822525,43.5635025489192
0.72152767741003,0.774519645831751,1070,221,33,103,15,26,18,77,41.9202832822525,43.5635025489192
0.764720942140297,0.812218736574809,1055,236,31,38,17,10,14,28,41.9202832822525,43.5635025489192
0.725962815405046,0.775132704990899,1068,223,36,58,14,12,22,46,41.9202832822525,43.5635025489192
0.715770252324037,0.755264284420371,1081,210,36,51,18,16,18,35,41.9202832822525,43.5635025489192
0.775375544012354,0.817918851729181,1078,213,34,54,17,16,17,38,41.9202832822525,43.5635025489192
0.724502369668246,0.764022487922546,1070,221,25,21,12,8,13,13,41.9202832822525,43.5635025489192
0.706596906278435,0.748209178623397,1076,215,35,22,14,9,21,13,41.9202832822525,43.5635025489192
0.749379532634972,0.787006446595524,1070,221,50,80,23,19,27,61,41.9202832822525,43.5635025489192
0.741950956993776,0.798689002631456,1079,212,34,66,18,15,16,51,41.9202832822525,43.5635025489192
0.760689607990696,0.817241842729291,1044,247,47,104,29,34,18,70,41.9202832822525,43.5635025489192
0.782570546118209,0.817790829316148,1075,216,34,31,14,7,20,24,41.9202832822525,43.5635025489192
0.734762190247802,0.773391095292861,1050,241,40,52,21,16,19,36,41.9202832822525,43.5635025489192
0.689913835830569,0.743851143143327,1072,219,42,66,19,15,23,51,41.9202832822525,43.5635025489192
0.637967229902714,0.669092401482174,1065,226,31,58,8,11,23,47,41.9202832822525,43.5635025489192
0.774103682170543,0.816412174101168,1069,222,43,69,22,22,21,47,41.9202832822525,43.5635025489192
0.77150974025974,0.820709934697284,1069,222,59,106,35,40,24,66,41.9202832822525,43.5635025489192
0.718709621093068,0.768396058245596,1054,237,46,74,16,17,30,57,41.9202832822525,43.5635025489192
0.770871355702186,0.797788416108746,1070,221,34,63,18,21,16,42,41.9202832822525,43.5635025489192
0.74479386026487,0.78688640593957,1076,215,34,46,15,11,19,35,41.9202832822525,43.5635025489192
0.757810444619837,0.797998852147429,1064,227,24,22,15,7,9,15,41.9202832822525,43.5635025489192
0.68120780381255,0.7306550011946,1082,209,32,47,11,12,21,35,41.9202832822525,43.5635025489192
0.735053828078037,0.803353319789109,1058,233,29,76,15,16,14,60,41.9202832822525,43.5635025489192
0.737808207670013,0.779697726699276,1057,234,38,88,16,19,22,69,41.9202832822525,43.5635025489192
0.770109631620952,0.808384275456749,1077,214,38,37,19,9,19,28,41.9202832822525,43.5635025489192
0.773229891207419,0.813194448582361,1045,246,45,112,23,38,22,74,41.9202832822525,43.5635025489192
0.71642920969023,0.752468811772409,1062,229,32,30,13,10,19,20,41.9202832822525,43.5635025489192
0.729814634146342,0.775344682365725,1086,205,41,55,18,12,23,43,41.9202832822525,43.5635025489192
0.726781454979129,0.763350068394082,1067,224,43,51,19,12,24,39,41.9202832822525,43.5635025489192
0.748450641876937,0.790567921718843,1055,236,36,106,18,26,18,80,41.9202832822525,43.5635025489192
0.731152604239787,0.75978464038063,1068,223,34,39,16,9,18,30,41.9202832822525,43.5635025489192
0.759092988676656,0.80687099238067,1071,220,42,59,19,20,23,39,41.9202832822525,43.5635025489192
0.74249756097561,0.797972085296749,1057,234,41,47,20,16,21,31,41.9202832822525,43.5635025489192
0.710939179024285,0.727718164864139,1068,223,22,31,7,11,15,20,41.9202832822525,43.5635025489192
0.784020618556701,0.826824010771923,1058,233,30,52,18,19,12,33,41.9202832822525,43.5635025489192
0.701777040432373,0.742095525578578,1060,231,47,48,23,14,24,34,41.9202832822525,43.5635025489192
0.817688008864479,0.850600568166314,1064,227,33,50,20,17,13,33,41.9202832822525,43.5635025489192
0.77516998443516,0.817954622162539,1051,240,39,58,23,26,16,32,41.9202832822525,43.5635025489192
0.793906810035842,0.825907299153628,1071,220,31,65,18,15,13,50,41.9202832822525,43.5635025489192
0.738101089538789,0.788083965615016,1077,214,39,63,16,16,23,47,41.9202832822525,43.5635025489192
0.727582065652522,0.773913397124373,1079,212,42,37,16,8,26,29,41.9202832822525,43.5635025489192
0.757843902439024,0.78651790905719,1073,218,41,62,16,13,25,49,41.9202832822525,43.5635025489192
0.788888888888889,0.842237673320204,1060,231,40,92,23,18,17,74,41.9202832822525,43.5635025489192
0.751167455932649,0.8090885449655,1077,214,24,39,11,10,13,29,41.9202832822525,43.5635025489192
0.705805355715428,0.731899052495508,1058,233,40,51,17,18,23,33,41.9202832822525,43.5635025489192
0.829225284989897,0.85897317744836,1087,204,42,51,26,16,16,35,41.9202832822525,43.5635025489192
0.764963264542094,0.790535615882008,1074,217,34,39,15,14,19,25,41.9202832822525,43.5635025489192
0.70550708609814,0.761385898747713,1070,221,39,68,18,19,21,49,41.9202832822525,43.5635025489192
0.761056511056511,0.812050198038811,1090,201,33,77,16,20,17,57,41.9202832822525,43.5635025489192
0.756362007168459,0.807475737601143,1080,211,31,61,17,13,14,48,41.9202832822525,43.5635025489192
0.72216787989081,0.778521582355503,1101,190,35,58,13,11,22,47,41.9202832822525,43.5635025489192
0.709606020362992,0.770772931196615,1052,239,36,41,16,10,20,31,41.9202832822525,43.5635025489192
0.696153846153846,0.737260237764696,1072,219,30,43,11,9,19,34,41.9202832822525,43.5635025489192
0.71333895949166,0.756305480709196,1070,221,32,83,13,22,19,61,41.9202832822525,43.5635025489192
0.764220900529948,0.817903735565875,1073,218,42,75,20,15,22,60,41.9202832822525,43.5635025489192
0.724382136146842,0.78222339818688,1064,227,33,39,18,13,15,26,41.9202832822525,43.5635025489192
0.657705716805981,0.707505450796417,1060,231,38,87,18,19,20,68,41.9202832822525,43.5635025489192
0.738800393672086,0.761712996928772,1053,238,44,39,18,9,26,30,41.9202832822525,43.5635025489192
0.714729083150136,0.758611001959035,1045,246,37,89,15,27,22,62,41.9202832822525,43.5635025489192
0.784096297254192,0.810928416304107,1072,219,37,53,18,13,19,40,41.9202832822525,43.5635025489192
0.707169263886939,0.755340792337814,1057,234,34,50,14,16,20,34,41.9202832822525,43.5635025489192
0.808956014838368,0.850771282741861,1069,222,33,53,17,18,16,35,41.9202832822525,43.5635025489192
0.725526328467505,0.770937923956348,1066,225,33,45,14,13,19,32,41.9202832822525,43.5635025489192
0.728152309612984,0.7519343643606,1071,220,45,43,23,16,22,27,41.9202832822525,43.5635025489192
0.753287370103917,0.801294865019151,1067,224,40,68,18,21,22,47,41.9202832822525,43.5635025489192
0.785703637447824,0.832622708749896,1059,232,43,82,24,26,19,56,41.9202832822525,43.5635025489192
0.796708961141951,0.808992125828445,1075,216,30,22,15,6,15,16,41.9202832822525,43.5635025489192
0.703440078692825,0.736117709545294,1091,200,29,96,8,18,21,78,41.9202832822525,43.5635025489192
0.708427498724211,0.76136754479201,1059,232,44,60,20,11,24,49,41.9202832822525,43.5635025489192
0.741091177193414,0.788461223072544,1068,223,39,41,17,14,22,27,41.9202832822525,43.5635025489192
0.771391414762022,0.803653279279009,1097,194,39,57,17,8,22,49,41.9202832822525,43.5635025489192
0.737876632613475,0.795998261348627,1048,243,37,82,22,20,15,62,41.9202832822525,43.5635025489192
0.744507896606372,0.77528981532002,1059,232,29,17,13,2,16,15,41.9202832822525,43.5635025489192
0.644674491506889,0.68558014229577,1085,206,44,61,15,9,29,52,41.9202832822525,43.5635025489192
0.748114195914091,0.77998887708823,1063,228,46,52,23,18,23,34,41.9202832822525,43.5635025489192
0.779890809827115,0.808663143759106,1058,233,35,44,14,12,21,32,41.9202832822525,43.5635025489192
0.745552775250228,0.781419086890217,1049,242,35,47,18,19,17,28,41.9202832822525,43.5635025489192
0.71897663174859,0.735150193216207,1054,237,50,34,19,10,31,24,41.9202832822525,43.5635025489192
0.792644976147883,0.826777201104866,1080,211,43,34,23,13,20,21,41.9202832822525,43.5635025489192
0.7305998229305,0.769437559825358,1071,220,36,49,18,21,18,28,41.9202832822525,43.5635025489192
0.792940826052423,0.831788079673017,1067,224,32,52,17,15,15,37,41.9202832822525,43.5635025489192
0.698541167066347,0.738676254734481,1066,225,40,23,16,6,24,17,41.9202832822525,43.5635025489192
0.689935167615433,0.72577431813892,1038,253,51,51,21,15,30,36,41.9202832822525,43.5635025489192
0.718369081106423,0.781509201629585,1089,202,27,51,13,14,14,37,41.9202832822525,43.5635025489192
0.779783454009118,0.808536729197342,1073,218,48,42,21,14,27,28,41.9202832822525,43.5635025489192
0.781293285703871,0.807365622122903,1029,262,44,52,22,18,22,34,41.9202832822525,43.5635025489192
0.701553652487248,0.749630749363395,1067,224,34,38,13,11,21,27,41.9202832822525,43.5635025489192
0.749109481403876,0.821907555459072,1091,200,46,139,20,30,26,109,41.9202832822525,43.5635025489192
0.758165919930626,0.804524033805665,1090,201,33,78,16,15,17,63,41.9202832822525,43.5635025489192
0.728928729526339,0.772973936243912,1066,225,36,64,17,22,19,42,41.9202832822525,43.5635025489192
0.69763442369788,0.74270046108055,1085,206,34,40,16,15,18,25,41.9202832822525,43.5635025489192
0.773566861577136,0.791380512348032,1061,230,29,31,14,6,15,25,41.9202832822525,43.5635025489192
0.734249605055292,0.770784872112511,1061,230,25,34,12,9,13,25,41.9202832822525,43.5635025489192
0.779891431512939,0.822909101428194,1097,194,34,39,17,9,17,30,41.9202832822525,43.5635025489192
0.709639220894201,0.764706015422563,1069,222,36,24,15,5,21,19,41.9202832822525,43.5635025489192
0.683634390104039,0.728345564981079,1056,235,39,28,16,8,23,20,41.9202832822525,43.5635025489192
0.791757215296046,0.811593530531629,1055,236,42,40,24,17,18,23,41.9202832822525,43.5635025489192
0.726204477674633,0.813792177076997,1079,212,38,73,18,20,20,53,41.9202832822525,43.5635025489192
0.733483213429257,0.7772882043648,1056,235,40,46,21,13,19,33,41.9202832822525,43.5635025489192
0.721583927254854,0.760766628884276,1063,228,39,19,20,6,19,13,41.9202832822525,43.5635025489192
0.722617500171034,0.767855492514903,1069,222,47,50,26,17,21,33,41.9202832822525,43.5635025489192
0.803812549642573,0.836294486614258,1089,202,32,25,16,4,16,21,41.9202832822525,43.5635025489192
0.729226618705036,0.765507286813523,1066,225,40,37,21,10,19,27,41.9202832822525,43.5635025489192
0.686139488771068,0.723298698032594,1077,214,37,44,14,9,23,35,41.9202832822525,43.5635025489192
0.715772782542969,0.750352875025865,1076,215,49,68,19,19,30,49,41.9202832822525,43.5635025489192
0.670364214481862,0.696984467603049,1070,221,33,43,9,7,24,36,41.9202832822525,43.5635025489192
0.833731739707835,0.836274548252197,1053,238,36,20,24,6,12,14,41.9202832822525,43.5635025489192
0.728742111095052,0.763522911699847,1082,209,33,71,14,21,19,50,41.9202832822525,43.5635025489192
0.786423956696351,0.832680700660373,1057,234,46,85,27,32,19,53,41.9202832822525,43.5635025489192
0.790925952690659,0.829153635698532,1069,222,33,48,19,15,14,33,41.9202832822525,43.5635025489192
0.756053563523683,0.81013221201839,1072,219,36,40,20,14,16,26,41.9202832822525,43.5635025489192
0.779938673499391,0.816580349331397,1089,202,38,40,20,13,18,27,41.9202832822525,43.5635025489192
0.740184034301681,0.771498600422357,1061,230,33,70,11,12,22,58,41.9202832822525,43.5635025489192
0.696874743999345,0.749127548719594,1054,237,39,43,20,11,19,32,41.9202832822525,43.5635025489192
0.733172819689674,0.790400989466979,1078,213,45,72,21,22,24,50,41.9202832822525,43.5635025489192
0.771222749611459,0.800344646137819,1070,221,38,46,18,13,20,33,41.9202832822525,43.5635025489192
0.753563523683046,0.795860306396154,1068,223,36,143,17,34,19,109,41.9202832822525,43.5635025489192
0.717645883293365,0.763465128796756,1056,235,40,60,19,17,21,43,41.9202832822525,43.5635025489192
0.804260734838424,0.827875004795642,1051,240,36,38,20,16,16,22,41.9202832822525,43.5635025489192
0.699779436715304,0.749115601791357,1089,202,28,61,11,9,17,52,41.9202832822525,43.5635025489192
0.731843228752978,0.773254865044358,1058,233,32,37,17,11,15,26,41.9202832822525,43.5635025489192
0.736885207543638,0.77138840974957,1077,214,34,29,15,9,19,20,41.9202832822525,43.5635025489192
0.758942845723421,0.803286099414992,1068,223,40,34,19,8,21,26,41.9202832822525,43.5635025489192
0.680035413899956,0.728584096789574,1049,242,36,56,14,17,22,39,41.9202832822525,43.5635025489192
0.75510752688172,0.77538634947095,1062,229,31,66,15,14,16,52,41.9202832822525,43.5635025489192
0.746849666064603,0.791900932698959,1068,223,38,55,20,17,18,38,41.9202832822525,43.5635025489192
0.722827570518653,0.776934835335456,1069,222,35,29,19,11,16,18,41.9202832822525,43.5635025489192
0.725727934485896,0.76313911131629,1036,255,35,51,16,18,19,33,41.9202832822525,43.5635025489192
0.739324116743472,0.78291745804625,1071,220,31,52,16,12,15,40,41.9202832822525,43.5635025489192
0.769968533126428,0.806810611403518,1065,226,37,60,20,20,17,40,41.9202832822525,43.5635025489192
0.701980688822794,0.742299965839278,1077,214,37,110,14,24,23,86,41.9202832822525,43.5635025489192
0.738943535781006,0.765038700572675,1062,229,42,58,19,14,23,44,41.9202832822525,43.5635025489192
0.772913428823455,0.832397440022569,1056,235,38,73,24,25,14,48,41.9202832822525,43.5635025489192
0.737430610626487,0.769511117610883,1070,221,30,45,13,11,17,34,41.9202832822525,43.5635025489192
0.762065778972571,0.805114726701618,1068,223,38,103,20,27,18,76,41.9202832822525,43.5635025489192
0.767250492090107,0.81230113010356,1071,220,44,75,29,29,15,46,41.9202832822525,43.5635025489192
0.768289353958144,0.813624577601681,1046,245,35,115,20,31,15,84,41.9202832822525,43.5635025489192
0.791391870339239,0.821781548848643,1076,215,37,42,20,10,17,32,41.9202832822525,43.5635025489192
0.706096451319381,0.733882738919844,1083,208,35,17,15,3,20,14,41.9202832822525,43.5635025489192
0.712943585077343,0.74846030781911,1065,226,35,60,14,13,21,47,41.9202832822525,43.5635025489192
0.752117602054757,0.790786509519582,1076,215,29,62,11,16,18,46,41.9202832822525,43.5635025489192
0.723085436033643,0.782191602304115,1094,197,36,86,16,17,20,69,41.9202832822525,43.5635025489192
0.776582842874978,0.814866008471782,1061,230,45,66,24,27,21,39,41.9202832822525,43.5635025489192
0.78232414068745,0.827093006024199,1056,235,40,119,23,26,17,93,41.9202832822525,43.5635025489192
0.734198101845161,0.780249616464002,1051,240,33,37,15,9,18,28,41.9202832822525,43.5635025489192
0.759543603664744,0.814600969646813,1052,239,28,91,15,18,13,73,41.9202832822525,43.5635025489192
0.74979512195122,0.811133784012247,1090,201,41,52,24,18,17,34,41.9202832822525,43.5635025489192
0.797668376742962,0.836466670299107,1075,216,24,24,11,8,13,16,41.9202832822525,43.5635025489192
0.729489227492423,0.776421366256295,1063,228,39,41,17,13,22,28,41.9202832822525,43.5635025489192
0.718150493574222,0.768535152680297,1066,225,52,84,23,18,29,66,41.9202832822525,43.5635025489192
0.755516378525933,0.793440308265454,1069,222,35,34,20,16,15,18,41.9202832822525,43.5635025489192
0.641602832779303,0.72839788411314,1071,220,33,153,14,32,19,121,41.9202832822525,43.5635025489192
0.744899225575854,0.797403820451779,1072,219,32,57,16,20,16,37,41.9202832822525,43.5635025489192
0.717582594681708,0.753639466716425,1072,219,50,61,20,18,30,43,41.9202832822525,43.5635025489192
0.82695102862254,0.855466839214144,1074,217,43,53,23,20,20,33,41.9202832822525,43.5635025489192
0.70234291799787,0.758743116991944,1081,210,39,61,16,15,23,46,41.9202832822525,43.5635025489192
0.769580487804878,0.79514890686289,1066,225,41,80,21,21,20,59,41.9202832822525,43.5635025489192
0.754021048451152,0.814297240255673,1048,243,32,56,18,14,14,42,41.9202832822525,43.5635025489192
0.737765853658537,0.772678252301934,1063,228,41,73,20,19,21,54,41.9202832822525,43.5635025489192
0.699505437455599,0.751127003795469,1069,222,29,49,11,12,18,37,41.9202832822525,43.5635025489192
0.735668789808917,0.780329168073528,1058,233,35,47,16,10,19,37,41.9202832822525,43.5635025489192
0.696639992512518,0.752334005159726,1065,226,34,54,12,17,22,37,41.9202832822525,43.5635025489192
0.727003077839555,0.764258989112939,1085,206,32,31,14,10,18,21,41.9202832822525,43.5635025489192
0.743092682926829,0.791862873093611,1061,230,41,63,21,20,20,43,41.9202832822525,43.5635025489192
0.775513428120063,0.798309620633816,1076,215,25,40,13,10,12,30,41.9202832822525,43.5635025489192
0.707185262790292,0.758752975310894,1058,233,46,74,21,21,25,53,41.9202832822525,43.5635025489192
0.736311753165686,0.799815258911466,1068,223,45,126,24,27,21,99,41.9202832822525,43.5635025489192
0.723078971082166,0.758193599682966,1055,236,39,48,19,15,20,33,41.9202832822525,43.5635025489192
0.722393923520168,0.764523206442957,1060,231,46,55,20,19,26,36,41.9202832822525,43.5635025489192
0.713147550189527,0.790126120319895,1037,254,34,67,21,27,13,40,41.9202832822525,43.5635025489192
0.653433337643864,0.685688488907603,1075,216,37,52,13,12,24,40,41.9202832822525,43.5635025489192
0.800814183167124,0.830435897113969,1057,234,33,52,20,21,13,31,41.9202832822525,43.5635025489192
0.718874106433677,0.772857409542456,1045,246,32,41,17,16,15,25,41.9202832822525,43.5635025489192
0.746673835386746,0.802649460074302,1060,231,44,95,26,26,18,69,41.9202832822525,43.5635025489192
0.740850769118612,0.768698727227056,1055,236,44,25,20,10,24,15,41.9202832822525,43.5635025489192
0.748071542765787,0.791757685963609,1070,221,40,66,22,26,18,40,41.9202832822525,43.5635025489192
0.823713174445548,0.854528183179889,1086,205,19,50,13,18,6,32,41.9202832822525,43.5635025489192
0.724589421957843,0.761792804141861,1063,228,37,41,18,15,19,26,41.9202832822525,43.5635025489192
0.75485516402265,0.780706638753733,1064,227,34,30,17,9,17,21,41.9202832822525,43.5635025489192
0.712193823216188,0.757548247786575,1073,218,39,58,18,15,21,43,41.9202832822525,43.5635025489192
0.731814548361311,0.761304078612327,1091,200,40,22,17,7,23,15,41.9202832822525,43.5635025489192
0.715682362330407,0.761436824639841,1080,211,38,58,16,16,22,42,41.9202832822525,43.5635025489192
0.731364908073541,0.753185162257925,1049,242,40,17,18,7,22,10,41.9202832822525,43.5635025489192
0.775874280655157,0.833323793432277,1078,213,36,44,18,15,18,29,41.9202832822525,43.5635025489192
0.715104640582348,0.75632451272746,1099,192,35,53,16,13,19,40,41.9202832822525,43.5635025489192
0.705926779313876,0.74337720871334,1078,213,31,32,13,9,18,23,41.9202832822525,43.5635025489192
0.75931326091711,0.807668895926527,1078,213,44,54,25,18,19,36,41.9202832822525,43.5635025489192
0.733156214558743,0.773322808918714,1065,226,38,38,20,12,18,26,41.9202832822525,43.5635025489192
0.745750389120996,0.784480781781842,1068,223,39,55,19,16,20,39,41.9202832822525,43.5635025489192
0.696917652411283,0.758379980139077,1050,241,35,90,17,29,18,61,41.9202832822525,43.5635025489192
0.818067671160455,0.843261044416237,1062,229,30,37,17,11,13,26,41.9202832822525,43.5635025489192
0.766544931385569,0.789725398667148,1078,213,36,30,15,12,21,18,41.9202832822525,43.5635025489192
0.755112195121951,0.817959597234369,1073,218,41,98,20,30,21,68,41.9202832822525,43.5635025489192
0.714294070850297,0.751523091614418,1054,237,34,28,15,10,19,18,41.9202832822525,43.5635025489192
0.731926751592357,0.782923944588138,1060,231,35,79,17,15,18,64,41.9202832822525,43.5635025489192
0.707923375074538,0.774344521289451,1081,210,43,55,20,13,23,42,41.9202832822525,43.5635025489192
0.755334227451459,0.78592109480119,1054,237,53,33,32,17,21,16,41.9202832822525,43.5635025489192
0.75689205870251,0.790450238733996,1094,197,23,48,10,13,13,35,41.9202832822525,43.5635025489192
0.772115766481335,0.795925490283139,1078,213,32,44,14,9,18,35,41.9202832822525,43.5635025489192
0.743399816929229,0.779288383285934,1084,207,33,58,15,17,18,41,41.9202832822525,43.5635025489192
0.816576145523514,0.844716740156696,1067,224,37,36,23,15,14,21,41.9202832822525,43.5635025489192
0.736284265507644,0.803085233094913,1065,226,42,110,22,33,20,77,41.9202832822525,43.5635025489192
0.719559651817716,0.788222824350632,1074,217,31,82,14,19,17,63,41.9202832822525,43.5635025489192
0.742620751341682,0.782926244772692,1062,229,43,55,22,13,21,42,41.9202832822525,43.5635025489192
0.738401503107385,0.762972520756981,1078,213,33,40,16,14,17,26,41.9202832822525,43.5635025489192
0.773272254269879,0.8105580711015,1077,214,28,21,18,8,10,13,41.9202832822525,43.5635025489192
0.707002457002457,0.756816419515541,1085,206,37,26,17,11,20,15,41.9202832822525,43.5635025489192
0.712792891183479,0.743053630784748,1108,183,32,36,13,8,19,28,41.9202832822525,43.5635025489192
0.690081892629663,0.743687075310668,1089,202,35,58,13,20,22,38,41.9202832822525,43.5635025489192
0.691621039824044,0.734504622504287,1072,219,34,76,11,24,23,52,41.9202832822525,43.5635025489192
0.734594953519256,0.781268187493953,1050,241,36,56,18,21,18,35,41.9202832822525,43.5635025489192
0.758960832490244,0.799980819096113,1059,232,33,96,18,20,15,76,41.9202832822525,43.5635025489192
0.769532070399462,0.809401310912648,1074,217,38,44,19,12,19,32,41.9202832822525,43.5635025489192
0.76234076433121,0.827134925805196,1057,234,35,28,20,10,15,18,41.9202832822525,43.5635025489192
0.762013502779984,0.799292498871049,1079,212,32,69,15,14,17,55,41.9202832822525,43.5635025489192
0.742983621071271,0.789892889430138,1078,213,36,63,19,17,17,46,41.9202832822525,43.5635025489192
0.767368841097156,0.802592397289024,1075,216,38,42,17,14,21,28,41.9202832822525,43.5635025489192
0.713222033990928,0.767531108066323,1088,203,29,105,8,28,21,77,41.9202832822525,43.5635025489192
0.684497270245678,0.748252160320827,1062,229,35,50,14,11,21,39,41.9202832822525,43.5635025489192
0.816835395575553,0.845062496069207,1068,223,21,46,15,14,6,32,41.9202832822525,43.5635025489192
0.748003194888179,0.794015906135979,1054,237,39,39,22,12,17,27,41.9202832822525,43.5635025489192
0.753450896929158,0.787680007579588,1062,229,26,36,14,10,12,26,41.9202832822525,43.5635025489192
0.780414746543779,0.831401375228933,1068,223,31,58,16,12,15,46,41.9202832822525,43.5635025489192
0.770119330392489,0.798231654302618,1058,233,28,58,12,18,16,40,41.9202832822525,43.5635025489192
0.744170641229465,0.801494889618865,1078,213,33,140,16,28,17,112,41.9202832822525,43.5635025489192
0.710502434705622,0.750111652858132,1096,195,36,29,15,8,21,21,41.9202832822525,43.5635025489192
0.717932599965078,0.750177189629546,1060,231,46,72,18,16,28,56,41.9202832822525,43.5635025489192
0.772243285939968,0.795010643756265,1079,212,25,43,9,10,16,33,41.9202832822525,43.5635025489192
0.819491573351431,0.870919591917227,1067,224,28,77,20,25,8,52,41.9202832822525,43.5635025489192
0.740270514883347,0.777175338709349,1078,213,48,113,21,29,27,84,41.9202832822525,43.5635025489192
0.728184028956,0.764577321000712,1067,224,28,33,12,9,16,24,41.9202832822525,43.5635025489192
0.753250219222998,0.781539457354346,1069,222,42,37,19,13,23,24,41.9202832822525,43.5635025489192
0.724513798462637,0.744759893510927,1058,233,38,39,20,13,18,26,41.9202832822525,43.5635025489192
0.769241009256984,0.806541992569261,1065,226,39,58,24,19,15,39,41.9202832822525,43.5635025489192
0.710252578527895,0.747239378904847,1043,248,27,24,16,5,11,19,41.9202832822525,43.5635025489192
0.710296061326989,0.74993618190994,1047,244,30,54,12,18,18,36,41.9202832822525,43.5635025489192
0.785521615513596,0.828145872755011,1053,238,44,49,26,20,18,29,41.9202832822525,43.5635025489192
0.820882513546436,0.852084835980323,1047,244,38,51,24,21,14,30,41.9202832822525,43.5635025489192
0.748809523809524,0.782683418592628,1097,194,31,40,11,9,20,31,41.9202832822525,43.5635025489192
0.729826716668822,0.768336217597506,1058,233,37,51,17,10,20,41,41.9202832822525,43.5635025489192
0.767244606673218,0.808753346359274,1057,234,34,45,19,12,15,33,41.9202832822525,43.5635025489192
0.824434750552961,0.878053099082721,1061,230,39,85,28,23,11,62,41.9202832822525,43.5635025489192
0.714471987810595,0.759086035448669,1057,234,27,32,11,8,16,24,41.9202832822525,43.5635025489192
0.641556754596323,0.66595740098445,1074,217,40,37,12,11,28,26,41.9202832822525,43.5635025489192
0.712181350626118,0.762027580456925,1078,213,43,71,20,17,23,54,41.9202832822525,43.5635025489192
0.769438125568699,0.805136378705155,1060,231,35,36,19,14,16,22,41.9202832822525,43.5635025489192
0.752577319587629,0.794845869913784,1047,244,30,51,13,14,17,37,41.9202832822525,43.5635025489192
0.772103982973548,0.829140011166788,1052,239,26,51,16,11,10,40,41.9202832822525,43.5635025489192
0.742499627310674,0.779781287968146,1065,226,43,53,21,10,22,43,41.9202832822525,43.5635025489192
0.705761776982707,0.739574070897156,1066,225,43,46,18,6,25,40,41.9202832822525,43.5635025489192
0.73575258141382,0.784204373001054,1063,228,32,102,11,23,21,79,41.9202832822525,43.5635025489192
0.724715650591447,0.79383092513128,1068,223,35,55,17,15,18,40,41.9202832822525,43.5635025489192
0.718921074184232,0.78038594734232,1061,230,37,60,19,13,18,47,41.9202832822525,43.5635025489192
0.606918901212036,0.646426958138341,1072,219,34,32,8,6,26,26,41.9202832822525,43.5635025489192
0.731190243902439,0.779963987146135,1069,222,41,64,19,23,22,41,41.9202832822525,43.5635025489192
0.748560365369341,0.784630065319311,1050,241,32,15,17,8,15,7,41.9202832822525,43.5635025489192
0.76114492964934,0.800796935357251,1069,222,44,89,20,32,24,57,41.9202832822525,43.5635025489192
0.753101262364064,0.765727276065585,1055,236,29,54,13,14,16,40,41.9202832822525,43.5635025489192
0.735524568393094,0.762487571862042,1057,234,36,23,15,7,21,16,41.9202832822525,43.5635025489192
0.739605734767025,0.792843838615605,1081,210,31,49,16,12,15,37,41.9202832822525,43.5635025489192
0.712147406733394,0.738360090857777,1075,216,35,13,15,2,20,11,41.9202832822525,43.5635025489192
0.688895128457111,0.753311088168404,1054,237,34,87,15,25,19,62,41.9202832822525,43.5635025489192
0.749880095923261,0.807997759706269,1082,209,40,79,20,18,20,61,41.9202832822525,43.5635025489192
0.699886028425851,0.739078696973132,1050,241,48,96,17,28,31,68,41.9202832822525,43.5635025489192
0.694918805657412,0.719474868521852,1080,211,46,48,14,11,32,37,41.9202832822525,43.5635025489192
0.783941438865378,0.821569513837491,1065,226,42,33,23,9,19,24,41.9202832822525,43.5635025489192
0.764979526842584,0.786916620077667,1049,242,35,24,16,9,19,15,41.9202832822525,43.5635025489192
0.747618431828958,0.776725556137372,1049,242,37,47,19,9,18,38,41.9202832822525,43.5635025489192
0.723990333415253,0.759537493070979,1055,236,39,38,15,11,24,27,41.9202832822525,43.5635025489192
0.769970731707317,0.815425861771934,1053,238,41,47,21,16,20,31,41.9202832822525,43.5635025489192
0.770495905368517,0.836784706195076,1048,243,35,95,21,28,14,67,41.9202832822525,43.5635025489192
0.746081504702194,0.803870711596077,1056,235,44,66,23,25,21,41,41.9202832822525,43.5635025489192
0.757010698936203,0.790406473128699,1043,248,53,49,29,14,24,35,41.9202832822525,43.5635025489192
0.711482334869432,0.763871774333445,1074,217,31,68,13,10,18,58,41.9202832822525,43.5635025489192
0.728070973612375,0.797255583128292,1082,209,35,50,17,14,18,36,41.9202832822525,43.5635025489192
0.737281887441632,0.778552062022558,1068,223,39,29,18,11,21,18,41.9202832822525,43.5635025489192
0.775870455709165,0.803553027668553,1061,230,31,55,15,16,16,39,41.9202832822525,43.5635025489192
0.770650959210281,0.820917963788787,1064,227,52,67,29,25,23,42,41.9202832822525,43.5635025489192
0.722573839662447,0.766002475828519,1063,228,27,42,12,13,15,29,41.9202832822525,43.5635025489192
0.7439398193645,0.790980166304552,1078,213,34,81,17,20,17,61,41.9202832822525,43.5635025489192
0.739228125826064,0.78592274457026,1062,229,30,29,15,13,15,16,41.9202832822525,43.5635025489192
0.778102628558938,0.80443825080333,1075,216,29,39,14,6,15,33,41.9202832822525,43.5635025489192
0.682453985085564,0.735031705791197,1076,215,37,64,14,15,23,49,41.9202832822525,43.5635025489192
0.715387689848122,0.738247037086001,1064,227,40,31,15,9,25,22,41.9202832822525,43.5635025489192
0.780414808036906,0.811006810551999,1048,243,42,52,25,16,17,36,41.9202832822525,43.5635025489192
0.816094005964632,0.835966917570086,1062,229,38,28,22,5,16,23,41.9202832822525,43.5635025489192
0.72380275011854,0.757611373365409,1086,205,37,60,15,14,22,46,41.9202832822525,43.5635025489192
0.716534496431404,0.757810427485517,1059,232,30,51,15,14,15,37,41.9202832822525,43.5635025489192
0.754030675940788,0.793689583887391,1060,231,45,27,25,12,20,15,41.9202832822525,43.5635025489192
0.744480625870402,0.780441773786757,1077,214,39,32,17,9,22,23,41.9202832822525,43.5635025489192
0.748739169791802,0.80347427967558,1073,218,37,91,21,25,16,66,41.9202832822525,43.5635025489192
0.77384764954821,0.80981585991728,1078,213,42,34,19,12,23,22,41.9202832822525,43.5635025489192
0.696013701350278,0.745848672305727,1057,234,32,93,17,26,15,67,41.9202832822525,43.5635025489192
0.773993949114238,0.820028588339095,1067,224,44,48,27,20,17,28,41.9202832822525,43.5635025489192
0.761839580701015,0.813693786927879,1068,223,34,51,18,16,16,35,41.9202832822525,43.5635025489192
0.687864577376187,0.72292419601082,1052,239,42,68,16,18,26,50,41.9202832822525,43.5635025489192
0.721691322478157,0.7594778284918,1067,224,32,44,13,14,19,30,41.9202832822525,43.5635025489192
0.806489558551414,0.838537398638718,1060,231,30,30,15,12,15,18,41.9202832822525,43.5635025489192
0.7949246629659,0.823537707373636,1072,219,30,39,14,12,16,27,41.9202832822525,43.5635025489192
0.707375099127676,0.777125633021258,1084,207,30,98,11,18,19,80,41.9202832822525,43.5635025489192
0.731807758903084,0.777570928433084,1090,201,34,55,14,14,20,41,41.9202832822525,43.5635025489192
0.756762716847986,0.794454113886403,1069,222,38,25,22,7,16,18,41.9202832822525,43.5635025489192
0.745004102203469,0.761225281471413,1068,223,27,68,13,21,14,47,41.9202832822525,43.5635025489192
0.724891455722127,0.761967985512714,1065,226,39,54,17,19,22,35,41.9202832822525,43.5635025489192
0.719979877392484,0.763545530631068,1080,211,34,43,19,12,15,31,41.9202832822525,43.5635025489192
0.759586293080768,0.790861359014253,1078,213,24,19,12,8,12,11,41.9202832822525,43.5635025489192
0.699699662430501,0.746930698004292,1059,232,32,55,13,11,19,44,41.9202832822525,43.5635025489192
0.721891152325935,0.74967431993545,1067,224,26,31,7,8,19,23,41.9202832822525,43.5635025489192
0.72105033061916,0.768757954637341,1047,244,29,64,15,19,14,45,41.9202832822525,43.5635025489192
0.728122047124089,0.769488057768665,1075,216,53,55,28,19,25,36,41.9202832822525,43.5635025489192
0.795932220434433,0.841019750835469,1094,197,48,96,27,24,21,72,41.9202832822525,43.5635025489192
0.687298440391224,0.734601093350287,1055,236,30,102,7,23,23,79,41.9202832822525,43.5635025489192
0.655111941865838,0.692110491177469,1065,226,38,37,15,14,23,23,41.9202832822525,43.5635025489192
0.753610069399543,0.796505294280948,1072,219,37,45,16,13,21,32,41.9202832822525,43.5635025489192
0.841780971637794,0.879281710595363,1059,232,29,41,23,18,6,23,41.9202832822525,43.5635025489192
0.730223550243471,0.781056004651469,1074,217,36,50,15,14,21,36,41.9202832822525,43.5635025489192
0.71629142689125,0.754176313065831,1070,221,38,47,17,16,21,31,41.9202832822525,43.5635025489192
0.688628820207768,0.721720832345382,1091,200,37,22,11,2,26,20,41.9202832822525,43.5635025489192
0.754757431228019,0.790656558376728,1082,209,33,63,16,16,17,47,41.9202832822525,43.5635025489192
0.795147175815434,0.822662404615124,1086,205,34,82,15,20,19,62,41.9202832822525,43.5635025489192
0.67126216077829,0.708751054286464,1061,230,31,26,11,7,20,19,41.9202832822525,43.5635025489192
0.818946319737459,0.856760444039867,1073,218,27,44,18,14,9,30,41.9202832822525,43.5635025489192
0.75491461477363,0.802968779798347,1049,242,32,54,15,11,17,43,41.9202832822525,43.5635025489192
0.747709535120462,0.767780471281748,1089,202,28,40,11,5,17,35,41.9202832822525,43.5635025489192
0.726281305228674,0.766961786259396,1107,184,37,64,14,13,23,51,41.9202832822525,43.5635025489192
0.72242098986285,0.768602543556642,1077,214,43,77,18,18,25,59,41.9202832822525,43.5635025489192
0.73646406519091,0.782833612569429,1040,251,38,48,20,17,18,31,41.9202832822525,43.5635025489192
0.765744213112634,0.797477407751767,1062,229,37,77,21,23,16,54,41.9202832822525,43.5635025489192
0.791253412192903,0.828946352862394,1095,196,35,48,19,11,16,37,41.9202832822525,43.5635025489192
0.749193308181096,0.793623833042244,1031,260,32,36,15,15,17,21,41.9202832822525,43.5635025489192
0.804936305732484,0.834534915754379,1088,203,35,29,16,8,19,21,41.9202832822525,43.5635025489192
0.7245173673226,0.774436791028868,1068,223,43,55,20,12,23,43,41.9202832822525,43.5635025489192
0.764073882494935,0.806063661917537,1084,207,37,29,18,8,19,21,41.9202832822525,43.5635025489192
0.701189048760991,0.745179111350912,1070,221,40,44,16,12,24,32,41.9202832822525,43.5635025489192
0.802464252226911,0.834379213332607,1069,222,27,60,19,17,8,43,41.9202832822525,43.5635025489192
0.715382912793271,0.76398460465467,1064,227,36,80,16,20,20,60,41.9202832822525,43.5635025489192
0.745109738406102,0.789071890735965,1108,183,34,42,15,8,19,34,41.9202832822525,43.5635025489192
0.764116283217407,0.809861800509627,1056,235,45,61,23,20,22,41,41.9202832822525,43.5635025489192
0.785253167606109,0.811285979882237,1062,229,33,15,19,6,14,9,41.9202832822525,43.5635025489192
0.712249772520473,0.750769362788787,1080,211,35,56,16,16,19,40,41.9202832822525,43.5635025489192
0.779157798723016,0.819960819308604,1082,209,26,59,13,17,13,42,41.9202832822525,43.5635025489192
0.791742493175614,0.843976241667297,1061,230,35,62,17,18,18,44,41.9202832822525,43.5635025489192
0.757930153646727,0.801029385231728,1081,210,42,36,18,8,24,28,41.9202832822525,43.5635025489192
0.776357827476038,0.805623290669579,1064,227,39,47,18,15,21,32,41.9202832822525,43.5635025489192
0.75679986206302,0.786354083272757,1051,240,37,36,20,15,17,21,41.9202832822525,43.5635025489192
0.712284196547145,0.759995480475994,1082,209,36,43,17,8,19,35,41.9202832822525,43.5635025489192
0.703769559032717,0.742939848239817,1059,232,37,68,16,25,21,43,41.9202832822525,43.5635025489192
0.720811766421229,0.775666152816216,1073,218,44,87,18,23,26,64,41.9202832822525,43.5635025489192
0.755218864418821,0.786734934620163,1060,231,29,27,15,7,14,20,41.9202832822525,43.5635025489192
0.700128008192524,0.769482943567812,1056,235,31,50,14,14,17,36,41.9202832822525,43.5635025489192
0.695271187233843,0.782023075504189,1074,217,34,129,16,28,18,101,41.9202832822525,43.5635025489192
0.725374552772808,0.77960768444722,1059,232,43,63,22,16,21,47,41.9202832822525,43.5635025489192
0.748052235502435,0.782588518743848,1053,238,36,72,17,23,19,49,41.9202832822525,43.5635025489192
0.809782414838595,0.856778753853545,1038,253,45,48,29,24,16,24,41.9202832822525,43.5635025489192
0.733473612374886,0.755321209045832,1051,240,35,37,17,13,18,24,41.9202832822525,43.5635025489192
0.742201956119482,0.793794596262627,1054,237,30,60,15,14,15,46,41.9202832822525,43.5635025489192
0.761642319610447,0.789962019124024,1053,238,36,100,15,20,21,80,41.9202832822525,43.5635025489192
0.739192081326913,0.793568629233445,1055,236,45,117,19,31,26,86,41.9202832822525,43.5635025489192
0.733224674978078,0.7851365339155,1098,193,42,58,15,6,27,52,41.9202832822525,43.5635025489192
0.754928909952607,0.796264201728632,1045,246,25,35,12,10,13,25,41.9202832822525,43.5635025489192
0.742025788937903,0.793121660883032,1085,206,28,77,10,14,18,63,41.9202832822525,43.5635025489192
0.754504504504505,0.786215069941711,1075,216,33,25,15,6,18,19,41.9202832822525,43.5635025489192
0.739524567788899,0.784077360267446,1091,200,35,65,12,15,23,50,41.9202832822525,43.5635025489192
0.82442662827641,0.863595925230754,1071,220,32,73,21,20,11,53,41.9202832822525,43.5635025489192
0.752847625188051,0.801179662231597,1065,226,22,35,13,14,9,21,41.9202832822525,43.5635025489192
0.709406278434941,0.727042667854124,1058,233,35,32,12,9,23,23,41.9202832822525,43.5635025489192
0.7881592421915,0.826329049405612,1066,225,31,130,14,31,17,99,41.9202832822525,43.5635025489192
0.769111623143881,0.815713751431003,1067,224,31,50,17,13,14,37,41.9202832822525,43.5635025489192
0.717526481630464,0.768398334193284,1068,223,48,56,26,17,22,39,41.9202832822525,43.5635025489192
0.744491007508294,0.805613474241154,1069,222,46,95,22,19,24,76,41.9202832822525,43.5635025489192
0.74699148565299,0.776781030696065,1065,226,48,45,19,14,29,31,41.9202832822525,43.5635025489192
0.74421094369548,0.803228866608658,1059,232,30,71,16,20,14,51,41.9202832822525,43.5635025489192
0.820777160983347,0.852212633190453,1058,233,30,48,17,15,13,33,41.9202832822525,43.5635025489192
0.763253012048193,0.797455848314223,1041,250,46,46,24,20,22,26,41.9202832822525,43.5635025489192
0.72587370929309,0.771219897704669,1051,240,32,54,14,16,18,38,41.9202832822525,43.5635025489192
0.768278446792824,0.792898083786299,1078,213,39,27,19,7,20,20,41.9202832822525,43.5635025489192
0.737330135891287,0.76856413985581,1085,206,40,57,18,9,22,48,41.9202832822525,43.5635025489192
0.747076888080073,0.799223998030609,1090,201,35,45,19,13,16,32,41.9202832822525,43.5635025489192
0.73329143669053,0.783718619593737,1065,226,29,66,13,15,16,51,41.9202832822525,43.5635025489192
0.748571848615953,0.780648016788539,1078,213,38,23,19,6,19,17,41.9202832822525,43.5635025489192
0.696566777231309,0.731602587840822,1067,224,42,29,19,9,23,20,41.9202832822525,43.5635025489192
0.708894449499545,0.748224083585598,1056,235,35,41,14,17,21,24,41.9202832822525,43.5635025489192
0.724783395836027,0.760881514488968,1068,223,37,55,15,13,22,42,41.9202832822525,43.5635025489192
0.702752678333143,0.782754186695366,1039,252,42,142,19,36,23,106,41.9202832822525,43.5635025489192
0.688508642582125,0.715561998011114,1087,204,39,27,14,6,25,21,41.9202832822525,43.5635025489192
0.794513457556936,0.833827036659675,1050,241,49,82,32,29,17,53,41.9202832822525,43.5635025489192
0.673293903548681,0.70565901890814,1088,203,35,23,13,8,22,15,41.9202832822525,43.5635025489192
0.761161071143086,0.8137908970883,1061,230,40,85,22,26,18,59,41.9202832822525,43.5635025489192
0.6833052025417,0.709317698955902,1059,232,32,60,5,13,27,47,41.9202832822525,43.5635025489192
0.697403693407466,0.737531670073308,1050,241,32,26,14,7,18,19,41.9202832822525,43.5635025489192
0.786577373638076,0.830838602302994,1065,226,39,64,24,21,15,43,41.9202832822525,43.5635025489192
0.750887170154686,0.789035805859921,1073,218,35,47,17,14,18,33,41.9202832822525,43.5635025489192
0.765972780906409,0.829851532140068,1071,220,48,128,26,32,22,96,41.9202832822525,43.5635025489192
0.780425386715196,0.821388516774248,1061,230,35,37,21,13,14,24,41.9202832822525,43.5635025489192
0.719399756374176,0.771444946545358,1082,209,38,40,17,12,21,28,41.9202832822525,43.5635025489192
0.73255063542494,0.799614367963633,1066,225,32,46,18,16,14,30,41.9202832822525,43.5635025489192
0.70763723150358,0.73070520531104,1074,217,34,68,11,15,23,53,41.9202832822525,43.5635025489192
0.7534503793511,0.790350952126145,1067,224,42,83,20,20,22,63,41.9202832822525,43.5635025489192
0.782826261008807,0.823991321717122,1067,224,42,50,22,19,20,31,41.9202832822525,43.5635025489192
0.734114183307732,0.766376001123438,1049,242,31,62,17,21,14,41,41.9202832822525,43.5635025489192
0.745223820943245,0.798840545673429,1049,242,40,44,22,18,18,26,41.9202832822525,43.5635025489192
0.76358844037468,0.8065413163725,1089,202,38,58,17,16,21,42,41.9202832822525,43.5635025489192
0.755853447029917,0.780083402791454,1062,229,33,38,19,10,14,28,41.9202832822525,43.5635025489192
0.73533173461231,0.780709874243811,1068,223,40,26,21,5,19,21,41.9202832822525,43.5635025489192
0.760031720856463,0.803417335326036,1083,208,30,83,16,19,14,64,41.9202832822525,43.5635025489192
0.784100021870672,0.826875940867654,1084,207,44,71,23,21,21,50,41.9202832822525,43.5635025489192
0.755312339989759,0.784959267249448,1069,222,31,44,14,15,17,29,41.9202832822525,43.5635025489192
0.78536169244768,0.84271767288873,1052,239,35,72,21,23,14,49,41.9202832822525,43.5635025489192
0.712769784172662,0.752996701580633,1081,210,40,69,14,16,26,53,41.9202832822525,43.5635025489192
0.720225624496374,0.765851268481476,1092,199,50,62,24,21,26,41,41.9202832822525,43.5635025489192
0.774390243902439,0.807181969237782,1074,217,41,46,21,13,20,33,41.9202832822525,43.5635025489192
0.706336528221512,0.756923788961227,1056,235,39,44,17,11,22,33,41.9202832822525,43.5635025489192
0.73465439017881,0.78037847805683,1060,231,42,54,23,16,19,38,41.9202832822525,43.5635025489192
0.676298960831335,0.726981058124274,1074,217,40,63,15,12,25,51,41.9202832822525,43.5635025489192
0.672843839206327,0.726323846385087,1066,225,34,37,14,10,20,27,41.9202832822525,43.5635025489192
0.756493050680893,0.829408351425629,1100,191,34,92,17,21,17,71,41.9202832822525,43.5635025489192
0.796790809948705,0.840028606892736,1079,212,37,111,16,25,21,86,41.9202832822525,43.5635025489192
0.727660675029096,0.763101058809528,1064,227,37,37,18,10,19,27,41.9202832822525,43.5635025489192
0.741871530531324,0.784675088927453,1074,217,30,35,14,9,16,26,41.9202832822525,43.5635025489192
0.713759213759214,0.742281779421202,1054,237,33,26,14,6,19,20,41.9202832822525,43.5635025489192
0.741795969324059,0.777490735478673,1065,226,45,62,24,16,21,46,41.9202832822525,43.5635025489192
0.797201103160405,0.832393071739179,1060,231,43,26,28,10,15,16,41.9202832822525,43.5635025489192
0.738943488943489,0.76836337199987,1089,202,37,21,14,7,23,14,41.9202832822525,43.5635025489192
0.754713372315427,0.800860443265163,1089,202,29,59,13,10,16,49,41.9202832822525,43.5635025489192
0.756263431738491,0.808742821464932,1052,239,28,58,17,18,11,40,41.9202832822525,43.5635025489192
0.71458143767061,0.73887702685508,1045,246,35,32,16,8,19,24,41.9202832822525,43.5635025489192
0.723160975609756,0.760673927758586,1060,231,41,86,19,26,22,60,41.9202832822525,43.5635025489192
0.688424947145877,0.729219477988552,1078,213,44,25,19,8,25,17,41.9202832822525,43.5635025489192
0.712444501918186,0.766772010066979,1063,228,37,51,17,15,20,36,41.9202832822525,43.5635025489192
0.725327640984909,0.78758588392551,1078,213,32,104,14,26,18,78,41.9202832822525,43.5635025489192
0.735416904952534,0.792628720358001,1065,226,42,64,23,17,19,47,41.9202832822525,43.5635025489192
0.695545863071636,0.757349325158461,1088,203,30,171,15,34,15,137,41.9202832822525,43.5635025489192
0.751856118791603,0.797328941254526,1049,242,31,80,15,24,16,56,41.9202832822525,43.5635025489192
0.704316069057105,0.737287732969428,1054,237,36,71,13,16,23,55,41.9202832822525,43.5635025489192
0.757731958762887,0.810523542644984,1078,213,30,53,17,17,13,36,41.9202832822525,43.5635025489192
0.732890659583887,0.779676544714074,1077,214,36,61,16,12,20,49,41.9202832822525,43.5635025489192
0.655646029294773,0.697801934511395,1076,215,34,42,11,11,23,31,41.9202832822525,43.5635025489192
0.753168240010345,0.779579264645712,1041,250,37,8,17,2,20,6,41.9202832822525,43.5635025489192
0.773859420918244,0.821171614260134,1047,244,33,42,20,14,13,28,41.9202832822525,43.5635025489192
0.677931387608807,0.736336784482112,1074,217,31,31,11,8,20,23,41.9202832822525,43.5635025489192
0.709088581669227,0.745391884635419,1066,225,31,59,11,14,20,45,41.9202832822525,43.5635025489192
0.737196544433914,0.782025316534265,1081,210,44,41,19,11,25,30,41.9202832822525,43.5635025489192
0.789010936069759,0.855829929735321,1100,191,33,73,20,21,13,52,41.9202832822525,43.5635025489192
0.708166515013649,0.78004699241574,1071,220,35,71,16,20,19,51,41.9202832822525,43.5635025489192
0.785776773346942,0.825634185538135,1083,208,44,71,20,16,24,55,41.9202832822525,43.5635025489192
0.756065518783542,0.797027536171744,1082,209,43,49,16,13,27,36,41.9202832822525,43.5635025489192
0.738788033027938,0.79247800009198,1075,216,28,61,14,9,14,52,41.9202832822525,43.5635025489192
0.815167495491557,0.854333642787192,1070,221,29,48,18,17,11,31,41.9202832822525,43.5635025489192
0.645838453346441,0.696621495655993,1069,222,39,100,14,23,25,77,41.9202832822525,43.5635025489192
0.716733154817203,0.766634223397377,1092,199,29,48,12,12,17,36,41.9202832822525,43.5635025489192
0.779493269992082,0.805566783920203,1076,215,28,44,14,10,14,34,41.9202832822525,43.5635025489192
0.685268379428144,0.734632109405917,1064,227,34,46,16,14,18,32,41.9202832822525,43.5635025489192
0.775152697658636,0.813806429170738,1066,225,28,27,15,7,13,20,41.9202832822525,43.5635025489192
0.655024390243902,0.720498322851663,1063,228,41,91,16,20,25,71,41.9202832822525,43.5635025489192
0.730554190218727,0.7645810477157,1061,230,39,81,19,19,20,62,41.9202832822525,43.5635025489192
0.741091177193414,0.774695788877787,1065,226,39,25,15,9,24,16,41.9202832822525,43.5635025489192
0.695880149812734,0.747798289440901,1083,208,45,59,18,15,27,44,41.9202832822525,43.5635025489192
0.777633487762647,0.820380490261439,1072,219,34,37,19,8,15,29,41.9202832822525,43.5635025489192
0.821011058451817,0.839647930544888,1078,213,25,91,15,24,10,67,41.9202832822525,43.5635025489192
0.752907087574821,0.795923688336837,1063,228,42,48,20,12,22,36,41.9202832822525,43.5635025489192
0.755062120010574,0.774666328273872,1082,209,30,21,15,10,15,11,41.9202832822525,43.5635025489192
0.722577097664842,0.787974966251852,1058,233,34,62,16,19,18,43,41.9202832822525,43.5635025489192
0.780976078225947,0.830994151833672,1069,222,46,72,26,19,20,53,41.9202832822525,43.5635025489192
0.732305234701401,0.790368626426731,1068,223,39,34,21,15,18,19,41.9202832822525,43.5635025489192
0.778302611367127,0.839343465270234,1086,205,31,92,14,22,17,70,41.9202832822525,43.5635025489192
0.740668513523365,0.781500765117991,1043,248,44,46,23,12,21,34,41.9202832822525,43.5635025489192
0.747242206235012,0.784554585848958,1062,229,40,45,22,7,18,38,41.9202832822525,43.5635025489192
0.736706923875622,0.782044913537757,1067,224,29,53,16,19,13,34,41.9202832822525,43.5635025489192
0.707784578392262,0.766756052178638,1076,215,29,62,12,19,17,43,41.9202832822525,43.5635025489192
0.721248780487805,0.7703423661234,1049,242,41,90,20,21,21,69,41.9202832822525,43.5635025489192
0.70743221102646,0.753722493485647,1057,234,39,76,15,21,24,55,41.9202832822525,43.5635025489192
0.699193761564896,0.751819047263635,1055,236,30,54,13,11,17,43,41.9202832822525,43.5635025489192
0.767023142323383,0.797626332932827,1049,242,42,61,21,22,21,39,41.9202832822525,43.5635025489192
0.708628414510767,0.774382075987671,1059,232,33,89,16,16,17,73,41.9202832822525,43.5635025489192
0.758664074116436,0.797108245120717,1048,243,42,22,24,5,18,17,41.9202832822525,43.5635025489192
0.69557536618466,0.732186892610946,1067,224,34,32,14,6,20,26,41.9202832822525,43.5635025489192
0.725426926131851,0.750882138829358,1075,216,32,71,11,13,21,58,41.9202832822525,43.5635025489192
0.744997263460354,0.790351818969367,1066,225,47,78,24,21,23,57,41.9202832822525,43.5635025489192
0.783015499642962,0.81737424144416,1067,224,38,81,17,19,21,62,41.9202832822525,43.5635025489192
0.764460032763473,0.817955140075904,1066,225,38,41,23,13,15,28,41.9202832822525,43.5635025489192
0.681784572342126,0.707982518727762,1073,218,40,22,15,4,25,18,41.9202832822525,43.5635025489192
0.791600423953365,0.821885972581393,1053,238,33,75,20,23,13,52,41.9202832822525,43.5635025489192
0.776338928856914,0.829980033713102,1043,248,40,48,25,10,15,38,41.9202832822525,43.5635025489192
0.738417656922068,0.77754669725052,1081,210,44,40,24,17,20,23,41.9202832822525,43.5635025489192
0.755765825586543,0.795163869866862,1060,231,36,61,20,21,16,40,41.9202832822525,43.5635025489192
0.749487967229903,0.812233148713838,1071,220,31,70,18,21,13,49,41.9202832822525,43.5635025489192
0.732638888888889,0.788804249142782,1075,216,27,52,8,11,19,41,41.9202832822525,43.5635025489192
0.691146525011067,0.727998162398779,1056,235,36,34,16,8,20,26,41.9202832822525,43.5635025489192
0.792551910198969,0.824343985929471,1053,238,33,79,18,25,15,54,41.9202832822525,43.5635025489192
0.707243339596281,0.782903230142424,1043,248,33,88,15,18,18,70,41.9202832822525,43.5635025489192
0.772745411013568,0.822798309023213,1068,223,38,62,22,23,16,39,41.9202832822525,43.5635025489192
0.684033835580227,0.727009218801689,1058,233,30,25,14,11,16,14,41.9202832822525,43.5635025489192
0.714785303231518,0.772859505691497,1057,234,36,40,16,12,20,28,41.9202832822525,43.5635025489192
0.762086849507736,0.80411878288955,1057,234,27,50,12,12,15,38,41.9202832822525,43.5635025489192
0.77363031233999,0.805968157527812,1087,204,31,28,14,10,17,18,41.9202832822525,43.5635025489192
0.717083712465878,0.768202300351912,1065,226,35,25,16,6,19,19,41.9202832822525,43.5635025489192
0.774569543828265,0.799165964849935,1053,238,43,50,18,13,25,37,41.9202832822525,43.5635025489192
0.669747235387046,0.737110304584066,1086,205,25,24,10,6,15,18,41.9202832822525,43.5635025489192
0.741272403949647,0.777085666856458,1070,221,34,39,16,12,18,27,41.9202832822525,43.5635025489192
0.697314539419802,0.753360160312072,1061,230,37,29,17,11,20,18,41.9202832822525,43.5635025489192
0.734721880888015,0.774924587519987,1087,204,39,76,15,16,24,60,41.9202832822525,43.5635025489192
0.736752988047809,0.789065094812531,1061,230,36,104,17,23,19,81,41.9202832822525,43.5635025489192
0.765544421003282,0.810052269006009,1067,224,27,32,14,7,13,25,41.9202832822525,43.5635025489192
0.785409753433864,0.822353950176566,1070,221,38,43,20,10,18,33,41.9202832822525,43.5635025489192
0.736023206751055,0.769294451310434,1067,224,27,47,8,11,19,36,41.9202832822525,43.5635025489192
0.811245261827881,0.845302364358398,1079,212,34,51,21,13,13,38,41.9202832822525,43.5635025489192
0.751585668080817,0.804510906462789,1081,210,38,81,18,21,20,60,41.9202832822525,43.5635025489192
0.740457233848954,0.764914926483498,1095,196,35,31,12,8,23,23,41.9202832822525,43.5635025489192
0.766086386822032,0.801129565613085,1050,241,34,54,17,15,17,39,41.9202832822525,43.5635025489192
0.691541463414634,0.759196857201131,1067,224,41,152,17,29,24,123,41.9202832822525,43.5635025489192
0.71884505592213,0.742506368106565,1086,205,34,21,13,7,21,14,41.9202832822525,43.5635025489192
0.766503639672429,0.797233246117528,1065,226,35,49,15,16,20,33,41.9202832822525,43.5635025489192
0.726716604244694,0.775362593532862,1073,218,45,72,20,27,25,45,41.9202832822525,43.5635025489192
0.748532842458264,0.777962493858068,1055,236,44,46,21,13,23,33,41.9202832822525,43.5635025489192
0.744355909694555,0.810501592203082,1075,216,36,104,18,25,18,79,41.9202832822525,43.5635025489192
0.735882926829268,0.759923137308489,1044,247,41,24,19,9,22,15,41.9202832822525,43.5635025489192
0.753400818926297,0.796560251689172,1068,223,35,52,16,14,19,38,41.9202832822525,43.5635025489192
0.765335880933226,0.807139575463322,1057,234,48,41,27,19,21,22,41.9202832822525,43.5635025489192
0.730898475238375,0.76921368783971,1061,230,38,88,18,26,20,62,41.9202832822525,43.5635025489192
0.697990906856721,0.740863971672332,1058,233,39,79,17,17,22,62,41.9202832822525,43.5635025489192
0.66593962480544,0.704565915548966,1065,226,39,37,12,11,27,26,41.9202832822525,43.5635025489192
0.794415377616014,0.818300222051778,1072,219,35,32,19,13,16,19,41.9202832822525,43.5635025489192
0.706000452437507,0.748992836751652,1056,235,28,61,13,21,15,40,41.9202832822525,43.5635025489192
0.767472353870458,0.803800048633944,1058,233,25,45,13,14,12,31,41.9202832822525,43.5635025489192
0.765300357220967,0.810524600786905,1073,218,44,48,23,11,21,37,41.9202832822525,43.5635025489192
0.69058017727639,0.734769182341003,1063,228,50,50,24,14,26,36,41.9202832822525,43.5635025489192
0.732796755959695,0.777857245309826,1047,244,39,49,19,16,20,33,41.9202832822525,43.5635025489192
0.737663820492454,0.770628890319938,1077,214,32,52,16,18,16,34,41.9202832822525,43.5635025489192
0.783013844515442,0.818446577805317,1068,223,39,37,23,13,16,24,41.9202832822525,43.5635025489192
0.708038914490527,0.75651904084735,1061,230,31,44,13,11,18,33,41.9202832822525,43.5635025489192
0.769782565528197,0.792043912133185,1040,251,32,52,16,17,16,35,41.9202832822525,43.5635025489192
0.689550283120408,0.750288234391969,1074,217,34,38,17,9,17,29,41.9202832822525,43.5635025489192
0.749769104467401,0.785388254958005,1040,251,47,39,27,11,20,28,41.9202832822525,43.5635025489192
0.732945993802568,0.796854870868425,1087,204,36,61,15,19,21,42,41.9202832822525,43.5635025489192
0.622911034652249,0.650143459621726,1053,238,39,60,11,14,28,46,41.9202832822525,43.5635025489192
0.734191128927971,0.787405378389577,1089,202,37,78,15,18,22,60,41.9202832822525,43.5635025489192
0.679299363057325,0.727072814978172,1093,198,35,105,11,16,24,89,41.9202832822525,43.5635025489192
0.733040702314445,0.766529196048366,1047,244,38,31,18,8,20,23,41.9202832822525,43.5635025489192
0.692814737209708,0.731107284093449,1047,244,46,45,18,16,28,29,41.9202832822525,43.5635025489192
0.73796201793395,0.783450015969306,1035,256,44,29,24,9,20,20,41.9202832822525,43.5635025489192
0.665742117503527,0.696500749196179,1053,238,42,47,17,11,25,36,41.9202832822525,43.5635025489192
0.733555083482409,0.773640463466477,1050,241,43,65,18,16,25,49,41.9202832822525,43.5635025489192
0.7695479777954,0.846232802411054,1044,247,30,121,17,35,13,86,41.9202832822525,43.5635025489192
0.74348441223193,0.77391432980061,1071,220,32,21,16,7,16,14,41.9202832822525,43.5635025489192
0.789527899126291,0.821205563341744,1049,242,32,38,20,11,12,27,41.9202832822525,43.5635025489192
0.77837596955244,0.811989258357873,1079,212,33,100,15,21,18,79,41.9202832822525,43.5635025489192
0.785247952684258,0.818309490259129,1088,203,35,39,18,13,17,26,41.9202832822525,43.5635025489192
0.790616469517743,0.821598376835448,1054,237,35,63,20,20,15,43,41.9202832822525,43.5635025489192
0.707999906406477,0.772295498009627,1050,241,34,78,12,23,22,55,41.9202832822525,43.5635025489192
0.746074544012688,0.812595804565507,1093,198,30,65,15,21,15,44,41.9202832822525,43.5635025489192
0.754083257506824,0.790688462895884,1058,233,35,33,16,3,19,30,41.9202832822525,43.5635025489192
0.725932666060055,0.766648033039604,1081,210,35,36,14,12,21,24,41.9202832822525,43.5635025489192
0.774727024567789,0.847113855403559,1065,226,35,114,21,30,14,84,41.9202832822525,43.5635025489192
0.713370696557246,0.75377185502285,1074,217,42,54,15,11,27,43,41.9202832822525,43.5635025489192
0.753160467958792,0.798451103813141,1038,253,46,48,28,17,18,31,41.9202832822525,43.5635025489192
0.715945194598888,0.764362873808124,1081,210,32,85,13,18,19,67,41.9202832822525,43.5635025489192
0.689932227572677,0.737477184088352,1077,214,45,48,19,11,26,37,41.9202832822525,43.5635025489192
0.762600321027287,0.798912805432266,1073,218,45,121,24,36,21,85,41.9202832822525,43.5635025489192
0.72558378960176,0.752760550192124,1079,212,34,52,14,14,20,38,41.9202832822525,43.5635025489192
0.747611931551805,0.785451304035951,1076,215,27,33,13,10,14,23,41.9202832822525,43.5635025489192
0.693699807714059,0.733036600902301,1065,226,28,36,11,8,17,28,41.9202832822525,43.5635025489192
0.753661916072842,0.810082659355825,1077,214,28,41,12,8,16,33,41.9202832822525,43.5635025489192
0.734521012077163,0.793009373807866,1060,231,29,43,13,17,16,26,41.9202832822525,43.5635025489192
0.716551459293395,0.754419859604787,1052,239,31,69,16,14,15,55,41.9202832822525,43.5635025489192
0.742452412571935,0.786128612068157,1073,218,36,28,18,7,18,21,41.9202832822525,43.5635025489192
0.769500567060108,0.786534265247558,1067,224,38,34,19,11,19,23,41.9202832822525,43.5635025489192
0.76278801843318,0.796815501118733,1067,224,31,49,15,14,16,35,41.9202832822525,43.5635025489192
0.731334932054356,0.788249551899021,1079,212,40,33,20,15,20,18,41.9202832822525,43.5635025489192
0.652401263823065,0.68734443592134,1087,204,25,52,8,12,17,40,41.9202832822525,43.5635025489192
0.724647107000048,0.766002523307219,1069,222,33,52,15,13,18,39,41.9202832822525,43.5635025489192
0.7674135577798,0.827741401403983,1068,223,35,96,21,26,14,70,41.9202832822525,43.5635025489192
0.778652058432935,0.814020583650151,1061,230,36,32,18,9,18,23,41.9202832822525,43.5635025489192
0.712953827940016,0.754478884636355,1072,219,24,36,10,9,14,27,41.9202832822525,43.5635025489192
0.762927605409706,0.815075020825987,1065,226,34,41,16,14,18,27,41.9202832822525,43.5635025489192
0.807695737471018,0.850312565702378,1025,266,45,94,24,32,21,62,41.9202832822525,43.5635025489192
0.752125509931755,0.808739353604796,1060,231,42,75,21,21,21,54,41.9202832822525,43.5635025489192
0.700827394118129,0.736721449152995,1043,248,39,35,19,12,20,23,41.9202832822525,43.5635025489192
0.732315474727615,0.794396253329756,1048,243,39,105,20,29,19,76,41.9202832822525,43.5635025489192
0.839324970903918,0.870152212384899,1069,222,37,55,25,19,12,36,41.9202832822525,43.5635025489192
0.716212738078525,0.763965833944866,1074,217,34,45,15,11,19,34,41.9202832822525,43.5635025489192
0.764690600697238,0.797233044720801,1063,228,48,58,23,20,25,38,41.9202832822525,43.5635025489192
0.707070418239353,0.751994778410495,1068,223,42,65,13,15,29,50,41.9202832822525,43.5635025489192
0.728120849933599,0.772536020737672,1076,215,36,50,16,14,20,36,41.9202832822525,43.5635025489192
0.731756141947225,0.778653663841694,1069,222,35,67,18,18,17,49,41.9202832822525,43.5635025489192
0.782137201674019,0.817223717154929,1074,217,28,52,14,20,14,32,41.9202832822525,43.5635025489192
0.770843246100978,0.788610247519455,1069,222,30,26,16,8,14,18,41.9202832822525,43.5635025489192
0.728684426052847,0.7723307154079,1057,234,37,47,18,14,19,33,41.9202832822525,43.5635025489192
0.748480068355845,0.801675346490246,1058,233,49,99,23,25,26,74,41.9202832822525,43.5635025489192
0.796173061550759,0.823421958837127,1068,223,40,34,26,16,14,18,41.9202832822525,43.5635025489192
0.761523017758172,0.801041106273794,1082,209,28,51,15,14,13,37,41.9202832822525,43.5635025489192
0.743795036028823,0.77762015081618,1041,250,42,56,20,14,22,42,41.9202832822525,43.5635025489192
0.772213375796178,0.802356701777544,1046,245,35,51,21,16,14,35,41.9202832822525,43.5635025489192
0.735613604034657,0.778403057112786,1073,218,37,84,17,20,20,64,41.9202832822525,43.5635025489192
0.701641348000698,0.755861016950459,1071,220,46,75,21,16,25,59,41.9202832822525,43.5635025489192
0.748796722990272,0.805984890826438,1086,205,31,55,16,12,15,43,41.9202832822525,43.5635025489192
0.706613008929303,0.734273708531446,1059,232,39,23,16,6,23,17,41.9202832822525,43.5635025489192
0.676569608735214,0.717604373736495,1042,249,35,62,13,12,22,50,41.9202832822525,43.5635025489192
0.722808280381255,0.76201510620453,1077,214,32,42,10,12,22,30,41.9202832822525,43.5635025489192
0.690232974910394,0.727941998175239,1084,207,31,79,8,15,23,64,41.9202832822525,43.5635025489192
0.696518177163338,0.73923099809091,1063,228,31,111,14,28,17,83,41.9202832822525,43.5635025489192
0.726548899129544,0.766705855600065,1070,221,31,44,13,12,18,32,41.9202832822525,43.5635025489192
0.722993774372306,0.784394132336607,1055,236,47,101,26,28,21,73,41.9202832822525,43.5635025489192
0.780095437044319,0.828809908925096,1073,218,39,88,24,25,15,63,41.9202832822525,43.5635025489192
0.72956126270733,0.782372275803341,1053,238,45,68,23,17,22,51,41.9202832822525,43.5635025489192
0.733490667701194,0.787012570008223,1062,229,37,41,15,7,22,34,41.9202832822525,43.5635025489192
0.695223932066037,0.749948329267467,1074,217,37,55,18,18,19,37,41.9202832822525,43.5635025489192
0.706940689768166,0.75617617367922,1073,218,39,60,15,15,24,45,41.9202832822525,43.5635025489192
0.735179708826206,0.757757540902048,1064,227,35,26,14,8,21,18,41.9202832822525,43.5635025489192
0.690815726467006,0.730515566738904,1058,233,38,67,14,16,24,51,41.9202832822525,43.5635025489192
0.743140364789849,0.771955697005455,1084,207,30,52,14,14,16,38,41.9202832822525,43.5635025489192
0.723159557661927,0.78283546876839,1073,218,25,69,11,17,14,52,41.9202832822525,43.5635025489192
0.734307215582116,0.779781073293226,1056,235,36,77,15,22,21,55,41.9202832822525,43.5635025489192
0.755955235811351,0.804216335814312,1066,225,40,46,22,16,18,30,41.9202832822525,43.5635025489192
0.691521951219512,0.726447916877501,1069,222,41,53,13,16,28,37,41.9202832822525,43.5635025489192
0.670573541167066,0.712586494624286,1072,219,40,77,15,18,25,59,41.9202832822525,43.5635025489192
0.746400449943757,0.785172544552017,1078,213,21,23,10,6,11,17,41.9202832822525,43.5635025489192
0.718839024390244,0.782817243553339,1064,227,41,58,19,10,22,48,41.9202832822525,43.5635025489192
0.657913026211279,0.696959813189968,1070,221,32,74,12,14,20,60,41.9202832822525,43.5635025489192
0.731971363715732,0.761042514754377,1074,217,46,67,16,18,30,49,41.9202832822525,43.5635025489192
0.732767673373378,0.783083152745049,1089,202,38,62,16,15,22,47,41.9202832822525,43.5635025489192
0.768425841674249,0.811396321611084,1055,236,35,52,19,19,16,33,41.9202832822525,43.5635025489192
0.75646482813749,0.790463320579729,1066,225,40,75,18,15,22,60,41.9202832822525,43.5635025489192
0.758466135458167,0.806470564416478,1055,236,36,32,24,15,12,17,41.9202832822525,43.5635025489192
0.7321044546851,0.765513137836454,1080,211,31,50,12,13,19,37,41.9202832822525,43.5635025489192
0.726274041836305,0.772987132112657,1063,228,34,71,18,18,16,53,41.9202832822525,43.5635025489192
0.745302099334357,0.801438113887749,1050,241,31,54,16,14,15,40,41.9202832822525,43.5635025489192
0.720307658255865,0.753389659391755,1058,233,36,58,14,11,22,47,41.9202832822525,43.5635025489192
0.70175187769263,0.744331881891639,1067,224,42,50,20,15,22,35,41.9202832822525,43.5635025489192
0.796466252348605,0.85664135689232,1071,220,33,100,20,20,13,80,41.9202832822525,43.5635025489192
0.744717940101651,0.776823814018901,1076,215,38,41,19,12,19,29,41.9202832822525,43.5635025489192
0.724990007993605,0.761117480613229,1088,203,40,41,14,10,26,31,41.9202832822525,43.5635025489192
0.732712133227597,0.787685780059181,1058,233,30,24,11,8,19,16,41.9202832822525,43.5635025489192
0.73524789729969,0.781933287608433,1072,219,36,48,18,12,18,36,41.9202832822525,43.5635025489192
0.784376672017122,0.829547714689856,1080,211,45,63,22,19,23,44,41.9202832822525,43.5635025489192
0.757015135918258,0.799135062687614,1056,235,42,68,24,25,18,43,41.9202832822525,43.5635025489192
0.740663456393793,0.799741674331871,1082,209,45,75,25,25,20,50,41.9202832822525,43.5635025489192
0.731488172664643,0.777574268514278,1074,217,33,52,15,11,18,41,41.9202832822525,43.5635025489192
0.682524597495528,0.740676428131543,1040,251,43,41,23,15,20,26,41.9202832822525,43.5635025489192
0.679404284667443,0.711346865362726,1075,216,37,49,13,14,24,35,41.9202832822525,43.5635025489192
0.646526745205688,0.696578652040321,1090,201,42,67,13,15,29,52,41.9202832822525,43.5635025489192
0.78499942811392,0.812093494961398,1069,222,42,57,21,14,21,43,41.9202832822525,43.5635025489192
0.714108708118293,0.767794525191308,1054,237,39,55,18,16,21,39,41.9202832822525,43.5635025489192
0.761343328038125,0.804348917709516,1072,219,32,54,12,10,20,44,41.9202832822525,43.5635025489192
0.711141463414634,0.762315896370016,1070,221,41,62,15,15,26,47,41.9202832822525,43.5635025489192
0.805798252581414,0.816229084474839,1094,197,32,30,16,9,16,21,41.9202832822525,43.5635025489192
0.715494202336308,0.766182417951358,1066,225,37,48,16,13,21,35,41.9202832822525,43.5635025489192
0.764302439024391,0.784294601351088,1077,214,41,38,19,14,22,24,41.9202832822525,43.5635025489192
0.736040853687912,0.772107256219558,1103,188,33,60,14,17,19,43,41.9202832822525,43.5635025489192
0.749267209793526,0.797285110746467,1054,237,37,106,18,29,19,77,41.9202832822525,43.5635025489192
0.761878430408782,0.803863530250364,1064,227,39,84,19,25,20,59,41.9202832822525,43.5635025489192
0.700520193331695,0.739422023598755,1069,222,39,57,16,16,23,41,41.9202832822525,43.5635025489192
0.678722840487546,0.72810627820893,1079,212,33,85,13,23,20,62,41.9202832822525,43.5635025489192
0.740292682926829,0.774049879188524,1083,208,41,85,17,20,24,65,41.9202832822525,43.5635025489192
0.754207429705138,0.782638451379526,1057,234,47,70,23,24,24,46,41.9202832822525,43.5635025489192
0.712928168810522,0.776678682596455,1047,244,33,37,17,8,16,29,41.9202832822525,43.5635025489192
0.771951377214535,0.806545426194627,1049,242,37,48,20,13,17,35,41.9202832822525,43.5635025489192
0.706730769230769,0.737672795576247,1084,207,43,41,16,10,27,31,41.9202832822525,43.5635025489192
0.781985586597407,0.833985124004788,1084,207,34,66,19,18,15,48,41.9202832822525,43.5635025489192
0.762579063883618,0.797010052141522,1072,219,51,77,25,23,26,54,41.9202832822525,43.5635025489192
0.774955732625055,0.800419627630658,1085,206,36,38,17,8,19,30,41.9202832822525,43.5635025489192
0.762429541841307,0.798609760384672,1072,219,33,53,17,11,16,42,41.9202832822525,43.5635025489192
0.74181136543015,0.765184994141441,1086,205,24,21,9,5,15,16,41.9202832822525,43.5635025489192
0.775083064251954,0.801385352572843,1067,224,34,30,20,9,14,21,41.9202832822525,43.5635025489192
0.683979501827194,0.727453714748443,1071,220,38,55,14,13,24,42,41.9202832822525,43.5635025489192
0.737101910828025,0.774575991172964,1065,226,35,31,18,11,17,20,41.9202832822525,43.5635025489192
0.783503197442046,0.803506338421076,1055,236,40,36,20,13,20,23,41.9202832822525,43.5635025489192
0.775939248601119,0.833442966411854,1065,226,40,55,25,20,15,35,41.9202832822525,43.5635025489192
0.776049160671463,0.820850177734617,1053,238,40,38,20,13,20,25,41.9202832822525,43.5635025489192
0.736341463414634,0.794768661935229,1070,221,41,125,23,35,18,90,41.9202832822525,43.5635025489192
0.757218400486686,0.80046340567918,1049,242,34,75,17,21,17,54,41.9202832822525,43.5635025489192
0.687793271359008,0.747496408474426,1070,221,36,49,16,15,20,34,41.9202832822525,43.5635025489192
0.718343513177242,0.749811931121006,1068,223,28,25,13,6,15,19,41.9202832822525,43.5635025489192
0.798566308243728,0.827931094375133,1073,218,31,42,19,10,12,32,41.9202832822525,43.5635025489192
0.706740086463924,0.759159708700163,1052,239,43,58,19,16,24,42,41.9202832822525,43.5635025489192
0.716122616924976,0.765286301934952,1072,219,23,52,10,10,13,42,41.9202832822525,43.5635025489192
0.735336432049579,0.789909514549092,1067,224,36,46,16,16,20,30,41.9202832822525,43.5635025489192
0.798558127505496,0.854963765917599,1074,217,37,151,24,37,13,114,41.9202832822525,43.5635025489192
0.728131916777335,0.767550411511274,1053,238,36,44,13,10,23,34,41.9202832822525,43.5635025489192
0.748255352894528,0.787126372593069,1057,234,30,85,15,20,15,65,41.9202832822525,43.5635025489192
0.759318996415771,0.802929360055837,1061,230,31,52,15,12,16,40,41.9202832822525,43.5635025489192
0.765601945461501,0.80015792473789,1075,216,29,82,15,21,14,61,41.9202832822525,43.5635025489192
0.729526842584167,0.776285103879068,1080,211,35,59,17,12,18,47,41.9202832822525,43.5635025489192
0.687980425925148,0.729447529214833,1065,226,38,39,14,10,24,29,41.9202832822525,43.5635025489192
0.747341929645968,0.780207644447703,1067,224,28,14,14,2,14,12,41.9202832822525,43.5635025489192
0.784048827321355,0.813946422811003,1055,236,23,92,14,23,9,69,41.9202832822525,43.5635025489192
0.711390488482923,0.7392167629078,1076,215,32,31,12,7,20,24,41.9202832822525,43.5635025489192
0.706364177918983,0.761167187837482,1072,219,32,63,13,13,19,50,41.9202832822525,43.5635025489192
0.764649815090167,0.816338103737102,1069,222,42,53,24,21,18,32,41.9202832822525,43.5635025489192
0.782419512195122,0.827083416508578,1084,207,41,94,20,22,21,72,41.9202832822525,43.5635025489192
0.749478347130054,0.805287801786118,1068,223,47,67,22,19,25,48,41.9202832822525,43.5635025489192
0.737631532013554,0.775083787084445,1047,244,45,52,24,19,21,33,41.9202832822525,43.5635025489192
0.79650209252347,0.830340620867047,1066,225,28,48,14,12,14,36,41.9202832822525,43.5635025489192
0.688927223987291,0.751035985696544,1074,217,32,52,12,12,20,40,41.9202832822525,43.5635025489192
0.76609595148921,0.834319233038645,1093,198,45,110,21,28,24,82,41.9202832822525,43.5635025489192
0.755034446210917,0.809355186987452,1079,212,33,104,14,21,19,83,41.9202832822525,43.5635025489192
0.721200612055303,0.772564535028339,1095,196,29,46,14,13,15,33,41.9202832822525,43.5635025489192
0.773837981407702,0.82093627531849,1047,244,36,107,20,26,16,81,41.9202832822525,43.5635025489192
0.752457002457002,0.78164963800963,1076,215,33,30,16,8,17,22,41.9202832822525,43.5635025489192
0.76745140003567,0.818671821808642,1094,197,45,41,24,14,21,27,41.9202832822525,43.5635025489192
0.762078048780488,0.779633977155017,1045,246,41,122,19,30,22,92,41.9202832822525,43.5635025489192
0.705305755395684,0.750201706196494,1077,214,40,60,18,15,22,45,41.9202832822525,43.5635025489192
0.70184331797235,0.733540107156383,1101,190,31,52,12,10,19,42,41.9202832822525,43.5635025489192
0.728630234804889,0.775624750736111,1074,217,38,85,19,24,19,61,41.9202832822525,43.5635025489192
0.789462907883961,0.823550143418897,1059,232,37,52,21,13,16,39,41.9202832822525,43.5635025489192
0.733350951374207,0.767940726034036,1082,209,44,34,22,10,22,24,41.9202832822525,43.5635025489192
0.756960873521383,0.793712126183871,1053,238,35,43,17,13,18,30,41.9202832822525,43.5635025489192
0.69674885537867,0.721086629015318,1088,203,38,62,10,11,28,51,41.9202832822525,43.5635025489192
0.698566878980892,0.741285559251874,1084,207,35,62,12,10,23,52,41.9202832822525,43.5635025489192
0.804603551634431,0.829770870506197,1075,216,28,45,17,11,11,34,41.9202832822525,43.5635025489192
0.718625042154454,0.767567257986314,1073,218,33,68,14,14,19,54,41.9202832822525,43.5635025489192
0.807819128827656,0.850843750143398,1074,217,38,73,24,27,14,46,41.9202832822525,43.5635025489192
0.674048855819177,0.714458205515096,1062,229,34,37,12,9,22,28,41.9202832822525,43.5635025489192
0.653791492026786,0.732018457887535,1053,238,33,37,14,11,19,26,41.9202832822525,43.5635025489192
0.788255959308591,0.819282390931915,1052,239,37,63,20,17,17,46,41.9202832822525,43.5635025489192
0.729256594724221,0.758605336072878,1078,213,40,53,15,13,25,40,41.9202832822525,43.5635025489192
0.772865978536905,0.808626898013172,1087,204,39,38,20,11,19,27,41.9202832822525,43.5635025489192
0.747752808988764,0.797958790372284,1060,231,45,45,25,11,20,34,41.9202832822525,43.5635025489192
0.764783255175569,0.822248725468052,1076,215,42,60,23,17,19,43,41.9202832822525,43.5635025489192
0.73061444148065,0.765007950908352,1075,216,34,55,17,19,17,36,41.9202832822525,43.5635025489192
0.787594068171758,0.834583859165005,1069,222,36,55,22,18,14,37,41.9202832822525,43.5635025489192
0.704975609756098,0.786874723100741,1080,211,41,81,23,26,18,55,41.9202832822525,43.5635025489192
0.755888376856119,0.803990746302085,1077,214,31,72,16,18,15,54,41.9202832822525,43.5635025489192
0.759951219512195,0.785897076016373,1064,227,41,62,18,15,23,47,41.9202832822525,43.5635025489192
0.734020618556701,0.78303040895159,1085,206,30,65,13,14,17,51,41.9202832822525,43.5635025489192
0.746502877379371,0.816380278912339,1075,216,36,56,18,13,18,43,41.9202832822525,43.5635025489192
0.7204,0.781719489642484,1055,236,41,57,18,16,23,41,41.9202832822525,43.5635025489192
0.739316856963916,0.77440217248487,1071,220,33,79,13,15,20,64,41.9202832822525,43.5635025489192
0.756376541115258,0.797277472243262,1067,224,28,28,14,9,14,19,41.9202832822525,43.5635025489192
0.749054899819381,0.812403507078603,1062,229,38,63,18,12,20,51,41.9202832822525,43.5635025489192
0.782290718835305,0.823762398021047,1076,215,35,30,21,3,14,27,41.9202832822525,43.5635025489192
0.73609569125033,0.777371943129439,1077,214,30,42,14,14,16,28,41.9202832822525,43.5635025489192
0.723122384345662,0.767397699298612,1079,212,28,36,11,9,17,27,41.9202832822525,43.5635025489192
0.779909042268593,0.798382029030383,1064,227,45,37,22,12,23,25,41.9202832822525,43.5635025489192
0.715889444949954,0.745485745905838,1070,221,35,40,13,6,22,34,41.9202832822525,43.5635025489192
0.800975609756098,0.838657892787576,1063,228,41,86,23,26,18,60,41.9202832822525,43.5635025489192
0.673363643810928,0.722411721444896,1066,225,39,63,15,15,24,48,41.9202832822525,43.5635025489192
0.744167976252837,0.784713762452788,1081,210,46,62,17,14,29,48,41.9202832822525,43.5635025489192
0.700116384326911,0.736544721576317,1040,251,37,102,15,25,22,77,41.9202832822525,43.5635025489192
0.781134075251722,0.830667076553051,1087,204,33,42,17,12,16,30,41.9202832822525,43.5635025489192
0.763450462929212,0.825307063176316,1065,226,44,154,24,43,20,111,41.9202832822525,43.5635025489192
0.736865308604439,0.803093779631741,1063,228,26,45,12,10,14,35,41.9202832822525,43.5635025489192
0.806027651784251,0.834492908056638,1085,206,29,19,17,4,12,15,41.9202832822525,43.5635025489192
0.7755280482787,0.801972505375553,1068,223,23,61,10,12,13,49,41.9202832822525,43.5635025489192
0.692307692307692,0.727177359060511,1049,242,39,36,19,12,20,24,41.9202832822525,43.5635025489192
0.677490512333966,0.726936539057183,1079,212,51,80,17,19,34,61,41.9202832822525,43.5635025489192
0.698878048780488,0.732577037844264,1053,238,41,32,18,12,23,20,41.9202832822525,43.5635025489192
0.744688353048226,0.78767881070352,1092,199,35,56,16,12,19,44,41.9202832822525,43.5635025489192
0.750740153317473,0.802980322833594,1093,198,30,38,9,4,21,34,41.9202832822525,43.5635025489192
0.78624107850912,0.833125776907521,1083,208,30,51,17,16,13,35,41.9202832822525,43.5635025489192
0.752001819836215,0.790087404767706,1068,223,35,56,19,20,16,36,41.9202832822525,43.5635025489192
0.753432576961989,0.792241048099478,1062,229,33,22,19,7,14,15,41.9202832822525,43.5635025489192
0.690920202549328,0.725673669256759,1079,212,46,68,18,16,28,52,41.9202832822525,43.5635025489192
0.735505840768999,0.779413574169644,1084,207,37,41,17,10,20,31,41.9202832822525,43.5635025489192
0.713435148295706,0.738300100168311,1070,221,36,26,14,4,22,22,41.9202832822525,43.5635025489192
0.657745243814099,0.70429125954641,1065,226,42,44,17,8,25,36,41.9202832822525,43.5635025489192
0.767814549791294,0.810993464550689,1069,222,43,102,26,23,17,79,41.9202832822525,43.5635025489192
0.747182254196643,0.768861780387782,1057,234,40,32,21,9,19,23,41.9202832822525,43.5635025489192
0.728309636650869,0.772019999068065,1078,213,25,56,13,13,12,43,41.9202832822525,43.5635025489192
0.739984610802224,0.78341632194682,1076,215,32,45,16,10,16,35,41.9202832822525,43.5635025489192
0.683214549029245,0.723750419458661,1085,206,39,106,14,21,25,85,41.9202832822525,43.5635025489192
0.798976360140256,0.846054720420228,1065,226,28,39,17,16,11,23,41.9202832822525,43.5635025489192
0.752447366265258,0.80187872275695,1061,230,39,32,19,7,20,25,41.9202832822525,43.5635025489192
0.790935467265665,0.806252014308841,1070,221,34,33,16,11,18,22,41.9202832822525,43.5635025489192
0.784107615407233,0.804644533366509,1080,211,38,43,18,9,20,34,41.9202832822525,43.5635025489192
0.725653984744256,0.770927335555833,1044,247,34,38,18,14,16,24,41.9202832822525,43.5635025489192
0.727946109123435,0.766214831187033,1055,236,43,42,23,16,20,26,41.9202832822525,43.5635025489192
0.686072708653354,0.733535677019793,1061,230,31,45,11,10,20,35,41.9202832822525,43.5635025489192
0.749214254094732,0.798043132649246,1082,209,36,51,15,10,21,41,41.9202832822525,43.5635025489192
0.714877879269261,0.74304435900556,1062,229,32,48,15,12,17,36,41.9202832822525,43.5635025489192
0.709192645883293,0.749539759139344,1080,211,40,56,16,17,24,39,41.9202832822525,43.5635025489192
0.645595387726105,0.676722301549747,1068,223,29,99,11,22,18,77,41.9202832822525,43.5635025489192
0.743329841103545,0.778295113683342,1051,240,46,38,23,8,23,30,41.9202832822525,43.5635025489192
0.707531938789836,0.741626024334327,1036,255,34,51,15,12,19,39,41.9202832822525,43.5635025489192
0.757086477362986,0.794041552347563,1051,240,32,30,19,10,13,20,41.9202832822525,43.5635025489192
0.736783439490446,0.783317290542007,1069,222,35,109,16,23,19,86,41.9202832822525,43.5635025489192
0.75394241009257,0.797406151514021,1073,218,39,44,20,14,19,30,41.9202832822525,43.5635025489192
0.71149491737727,0.744999567459808,1077,214,33,53,14,15,19,38,41.9202832822525,43.5635025489192
0.802193413615139,0.846207192466708,1062,229,39,52,24,19,15,33,41.9202832822525,43.5635025489192
0.774486405540737,0.810153899376945,1048,243,34,43,19,15,15,28,41.9202832822525,43.5635025489192
0.734869431643625,0.810152453070058,1072,219,31,70,15,15,16,55,41.9202832822525,43.5635025489192
0.708722454329483,0.747611012845079,1054,237,39,35,18,10,21,25,41.9202832822525,43.5635025489192
0.778833030027298,0.837045745280395,1070,221,35,39,20,12,15,27,41.9202832822525,43.5635025489192
0.718238158477202,0.772643468500894,1075,216,36,52,16,18,20,34,41.9202832822525,43.5635025489192
0.747670250896057,0.774348342418392,1075,216,31,50,14,10,17,40,41.9202832822525,43.5635025489192
0.730171530977983,0.769862808676898,1069,222,31,38,12,9,19,29,41.9202832822525,43.5635025489192
0.736661546338966,0.76756735068168,1073,218,31,72,14,16,17,56,41.9202832822525,43.5635025489192
0.79135900140647,0.831474840827349,1062,229,27,29,14,8,13,21,41.9202832822525,43.5635025489192
0.747202238209432,0.792704629653264,1080,211,40,94,19,25,21,69,41.9202832822525,43.5635025489192
0.717782584954005,0.748105051426764,1085,206,38,37,18,10,20,27,41.9202832822525,43.5635025489192
0.772171018945212,0.815719519059156,1073,218,31,82,14,19,17,63,41.9202832822525,43.5635025489192
0.70404931568827,0.735129337483679,1082,209,28,32,11,8,17,24,41.9202832822525,43.5635025489192
0.698374306106265,0.734028473442164,1056,235,30,54,14,19,16,35,41.9202832822525,43.5635025489192
0.695141655599823,0.730364221921558,1035,256,36,59,15,17,21,42,41.9202832822525,43.5635025489192
0.695383693045564,0.738329323733598,1055,236,40,56,19,17,21,39,41.9202832822525,43.5635025489192
0.775243215565796,0.816169743475211,1052,239,31,26,20,11,11,15,41.9202832822525,43.5635025489192
0.645606463036742,0.690682264833895,1067,224,36,51,11,12,25,39,41.9202832822525,43.5635025489192
0.686853558627752,0.724447244911883,1101,190,31,48,10,12,21,36,41.9202832822525,43.5635025489192
0.756122045017532,0.792103104696969,1072,219,28,18,14,7,14,11,41.9202832822525,43.5635025489192
0.774573073868149,0.809648735219303,1049,242,32,38,17,11,15,27,41.9202832822525,43.5635025489192
0.760401678657074,0.825521415614976,1040,251,40,84,23,27,17,57,41.9202832822525,43.5635025489192
0.74827768945416,0.798355436151449,1062,229,33,107,18,28,15,79,41.9202832822525,43.5635025489192
0.757031456515993,0.793378578824856,1074,217,30,41,15,9,15,32,41.9202832822525,43.5635025489192
0.706993776030699,0.739733857714548,1066,225,34,46,12,14,22,32,41.9202832822525,43.5635025489192
0.763049560351719,0.795698675017198,1049,242,40,48,18,14,22,34,41.9202832822525,43.5635025489192
0.737934183064997,0.791474092112267,1086,205,43,61,21,16,22,45,41.9202832822525,43.5635025489192
0.703250035097571,0.741338456942612,1064,227,34,116,16,26,18,90,41.9202832822525,43.5635025489192
0.697964669738863,0.769831776469897,1057,234,31,129,12,31,19,98,41.9202832822525,43.5635025489192
0.776198959393734,0.803259162925421,1053,238,28,40,16,10,12,30,41.9202832822525,43.5635025489192
0.799620197825018,0.836962970227269,1071,220,29,55,16,11,13,44,41.9202832822525,43.5635025489192
0.743761140819964,0.781735277610351,1089,202,33,74,13,15,20,59,41.9202832822525,43.5635025489192
0.690342037331215,0.741058803098187,1074,217,32,56,15,16,17,40,41.9202832822525,43.5635025489192
0.76388688153394,0.804810771051627,1046,245,33,39,20,11,13,28,41.9202832822525,43.5635025489192
0.741207916287534,0.796108238864111,1077,214,35,25,16,8,19,17,41.9202832822525,43.5635025489192
0.732736658621614,0.782740047454191,1074,217,48,67,21,18,27,49,41.9202832822525,43.5635025489192
0.752025232403718,0.804413497745783,1072,219,36,75,15,19,21,56,41.9202832822525,43.5635025489192
0.692087206728641,0.732981371863796,1069,222,36,52,17,15,19,37,41.9202832822525,43.5635025489192
0.718985802223987,0.758640714609512,1059,232,32,97,14,18,18,79,41.9202832822525,43.5635025489192
0.696258459416354,0.732810221442339,1051,240,37,96,14,18,23,78,41.9202832822525,43.5635025489192
0.738222299444003,0.770657035298986,1063,228,32,20,12,5,20,15,41.9202832822525,43.5635025489192
0.745083267248216,0.783744877362179,1059,232,30,60,13,18,17,42,41.9202832822525,43.5635025489192
0.67636968766001,0.721706071278209,1066,225,31,39,12,10,19,29,41.9202832822525,43.5635025489192
0.756387716830755,0.796604201172671,1082,209,27,58,14,15,13,43,41.9202832822525,43.5635025489192
0.789717073170732,0.82020672007396,1065,226,41,51,21,18,20,33,41.9202832822525,43.5635025489192
0.748933143669986,0.787242046751397,1063,228,37,80,15,15,22,65,41.9202832822525,43.5635025489192
0.717584167424932,0.754080042569694,1073,218,35,50,10,15,25,35,41.9202832822525,43.5635025489192
0.741029280974208,0.780397998237895,1055,236,47,30,24,9,23,21,41.9202832822525,43.5635025489192
0.714219356248975,0.760148000246128,1064,227,29,33,13,4,16,29,41.9202832822525,43.5635025489192
0.749687486529592,0.796328761798742,1087,204,37,49,17,13,20,36,41.9202832822525,43.5635025489192
0.784371273106738,0.821879368367699,1073,218,43,49,22,16,21,33,41.9202832822525,43.5635025489192
0.741566746602718,0.784067494158399,1062,229,40,56,17,11,23,45,41.9202832822525,43.5635025489192
0.797752616816036,0.837627906006459,1072,219,47,52,28,17,19,35,41.9202832822525,43.5635025489192
0.667314235308943,0.717526288100883,1045,246,38,46,16,13,22,33,41.9202832822525,43.5635025489192
0.773580487804878,0.809611891871006,1067,224,41,29,24,9,17,20,41.9202832822525,43.5635025489192
0.722498690413829,0.773904280810243,1050,241,46,43,23,15,23,28,41.9202832822525,43.5635025489192
0.677006762716848,0.731024196835975,1070,221,38,76,16,21,22,55,41.9202832822525,43.5635025489192
0.745068036504727,0.804748269884713,1036,255,29,29,18,12,11,17,41.9202832822525,43.5635025489192
0.744222020018198,0.787374912387893,1066,225,35,61,18,20,17,41,41.9202832822525,43.5635025489192
0.752585521081941,0.812928691920075,1067,224,34,104,20,23,14,81,41.9202832822525,43.5635025489192
0.750166034155598,0.787530028700195,1073,218,51,77,24,19,27,58,41.9202832822525,43.5635025489192
0.746803912647862,0.800379332579706,1062,229,35,47,17,13,18,34,41.9202832822525,43.5635025489192
0.694744818546736,0.751147709990748,1076,215,39,45,17,10,22,35,41.9202832822525,43.5635025489192
0.69568345323741,0.740443045869235,1061,230,40,138,16,34,24,104,41.9202832822525,43.5635025489192
0.721215139442231,0.773971559076142,1090,201,36,75,14,19,22,56,41.9202832822525,43.5635025489192
0.74887989593872,0.789669971749371,1053,238,33,47,15,12,18,35,41.9202832822525,43.5635025489192
0.678373560726502,0.725817588723331,1062,229,33,132,12,37,21,95,41.9202832822525,43.5635025489192
0.752231990148457,0.786220628836123,1037,254,47,88,26,30,21,58,41.9202832822525,43.5635025489192
0.693618447180302,0.734616726501239,1081,210,32,80,10,14,22,66,41.9202832822525,43.5635025489192
0.785895943790681,0.809752876348518,1075,216,37,62,20,20,17,42,41.9202832822525,43.5635025489192
0.83012385476756,0.865071890742187,1071,220,28,55,20,19,8,36,41.9202832822525,43.5635025489192
0.762068217950571,0.808251960798307,1078,213,33,58,19,23,14,35,41.9202832822525,43.5635025489192
0.713823665308523,0.759862011393547,1076,215,38,37,20,14,18,23,41.9202832822525,43.5635025489192
0.726831754801368,0.757427590116873,1073,218,24,20,10,4,14,16,41.9202832822525,43.5635025489192
0.807114639236732,0.837969430732313,1055,236,43,60,25,21,18,39,41.9202832822525,43.5635025489192
0.70434124305004,0.752968390978917,1069,222,32,120,13,28,19,92,41.9202832822525,43.5635025489192
0.734117719341361,0.784774691527386,1050,241,39,71,20,22,19,49,41.9202832822525,43.5635025489192
0.724322314994853,0.753494719088784,1065,226,42,66,17,17,25,49,41.9202832822525,43.5635025489192
0.776638504864311,0.840095333083141,1061,230,31,72,17,24,14,48,41.9202832822525,43.5635025489192
0.753998603108084,0.795728236670883,1073,218,46,52,24,15,22,37,41.9202832822525,43.5635025489192
0.657558654271802,0.693030516980577,1055,236,36,107,13,18,23,89,41.9202832822525,43.5635025489192
0.714707835325365,0.757503383155996,1082,209,36,57,14,12,22,45,41.9202832822525,43.5635025489192
0.722044728434505,0.770269603456989,1060,231,39,49,19,14,20,35,41.9202832822525,43.5635025489192
0.730959963603276,0.782005538325877,1065,226,35,52,18,15,17,37,41.9202832822525,43.5635025489192
0.758012394864985,0.780525588002339,1075,216,36,20,18,7,18,13,41.9202832822525,43.5635025489192
0.749822394666375,0.789253259408526,1078,213,29,33,14,10,15,23,41.9202832822525,43.5635025489192
0.699670117372603,0.745882353404392,1057,234,44,84,16,26,28,58,41.9202832822525,43.5635025489192
0.731959087663292,0.815432557386943,1085,206,38,84,19,18,19,66,41.9202832822525,43.5635025489192
0.703574590526782,0.744632349977892,1083,208,36,61,14,11,22,50,41.9202832822525,43.5635025489192
0.750570889594917,0.782863582492742,1057,234,32,65,17,19,15,46,41.9202832822525,43.5635025489192
0.726502586053148,0.768429674849594,1044,247,45,67,22,19,23,48,41.9202832822525,43.5635025489192
0.791616706634692,0.8322323524173,1096,195,40,66,26,19,14,47,41.9202832822525,43.5635025489192
0.805271439811172,0.859734920623696,1045,246,20,69,13,16,7,53,41.9202832822525,43.5635025489192
0.68926296633303,0.761535760992109,1073,218,35,58,15,15,20,43,41.9202832822525,43.5635025489192
0.751988409272582,0.808909783592494,1041,250,40,84,23,25,17,59,41.9202832822525,43.5635025489192
0.76703737230053,0.788420819882931,1078,213,37,38,17,9,20,29,41.9202832822525,43.5635025489192
0.744743249225321,0.79380664684564,1067,224,36,96,18,21,18,75,41.9202832822525,43.5635025489192
0.699157291262555,0.775410910088903,1058,233,37,60,22,22,15,38,41.9202832822525,43.5635025489192
0.764973439575033,0.806583632969125,1054,237,36,25,17,7,19,18,41.9202832822525,43.5635025489192
0.768298461762776,0.81197529130328,1061,230,44,45,22,13,22,32,41.9202832822525,43.5635025489192
0.749169986719788,0.797203048577775,1062,229,36,78,19,24,17,54,41.9202832822525,43.5635025489192
0.708242115345146,0.760029339633732,1055,236,47,204,21,41,26,163,41.9202832822525,43.5635025489192
0.734165853658537,0.775646232182718,1030,261,41,25,21,9,20,16,41.9202832822525,43.5635025489192
0.717629268292683,0.756591980764949,1062,229,41,33,20,7,21,26,41.9202832822525,43.5635025489192
0.719872306464485,0.760584571164861,1073,218,38,57,15,17,23,40,41.9202832822525,43.5635025489192
0.800651638503113,0.849162082846842,1057,234,47,74,35,28,12,46,41.9202832822525,43.5635025489192
0.722280249037437,0.771476173046883,1080,211,39,92,15,18,24,74,41.9202832822525,43.5635025489192
0.818823930846224,0.840636963468217,1065,226,35,56,16,12,19,44,41.9202832822525,43.5635025489192
0.790198073868149,0.808897497781071,1064,227,32,24,19,6,13,18,41.9202832822525,43.5635025489192
0.768302493966211,0.820873644248529,1057,234,48,68,27,24,21,44,41.9202832822525,43.5635025489192
0.749701195219123,0.803367662636743,1033,258,36,37,21,13,15,24,41.9202832822525,43.5635025489192
0.70939549791294,0.770331411131879,1078,213,43,94,22,31,21,63,41.9202832822525,43.5635025489192
0.788034068042491,0.819734277581845,1062,229,34,31,24,11,10,20,41.9202832822525,43.5635025489192
0.7362681248464,0.764347477580122,1069,222,39,59,17,15,22,44,41.9202832822525,43.5635025489192
0.752320291173794,0.787695279569563,1067,224,35,49,14,13,21,36,41.9202832822525,43.5635025489192
0.737610215871085,0.792211696157893,1061,230,26,34,13,9,13,25,41.9202832822525,43.5635025489192
0.742153607791058,0.786793048270938,1054,237,36,51,19,15,17,36,41.9202832822525,43.5635025489192
0.741116702886118,0.770720621809266,1078,213,42,39,18,15,24,24,41.9202832822525,43.5635025489192
0.712787154242851,0.769415180509393,1085,206,27,25,12,7,15,18,41.9202832822525,43.5635025489192
0.716874429917908,0.755964819561086,1083,208,26,104,9,21,17,83,41.9202832822525,43.5635025489192
0.728910290708044,0.759929148432912,1055,236,45,56,21,19,24,37,41.9202832822525,43.5635025489192
0.767677931387609,0.809398275708443,1072,219,31,51,14,15,17,36,41.9202832822525,43.5635025489192
0.672002216119863,0.724388126337752,1053,238,33,49,16,14,17,35,41.9202832822525,43.5635025489192
0.697114596426034,0.737967428550643,1052,239,29,34,12,8,17,26,41.9202832822525,43.5635025489192
0.724398286218339,0.76092949546056,1080,211,38,63,21,18,17,45,41.9202832822525,43.5635025489192
0.716554195737542,0.747087626715852,1074,217,42,27,18,11,24,16,41.9202832822525,43.5635025489192
0.748391286970424,0.816462039588377,1050,241,40,133,24,35,16,98,41.9202832822525,43.5635025489192
0.733810947022972,0.766004258841472,1075,216,27,71,10,17,17,54,41.9202832822525,43.5635025489192
0.774642289348172,0.80653979350074,1054,237,33,30,17,11,16,19,41.9202832822525,43.5635025489192
0.789312039312039,0.823641658912242,1062,229,33,20,19,4,14,16,41.9202832822525,43.5635025489192
0.772952684258417,0.809098026241435,1072,219,35,70,20,22,15,48,41.9202832822525,43.5635025489192
0.767895086321381,0.809146264143957,1056,235,36,73,18,17,18,56,41.9202832822525,43.5635025489192
0.694017220414736,0.734151008904646,1054,237,49,145,20,35,29,110,41.9202832822525,43.5635025489192
0.727093206951027,0.776982956306259,1077,214,25,52,11,10,14,42,41.9202832822525,43.5635025489192
0.740713976008094,0.788394937609038,1075,216,33,37,15,11,18,26,41.9202832822525,43.5635025489192
0.748074369189907,0.789016433398681,1066,225,36,21,19,9,17,12,41.9202832822525,43.5635025489192
0.747113806844819,0.750850530206404,1065,226,27,43,12,10,15,33,41.9202832822525,43.5635025489192
0.766685623293904,0.81625819154338,1071,220,35,77,20,19,15,58,41.9202832822525,43.5635025489192
0.772265431392733,0.800558192189922,1057,234,42,48,18,12,24,36,41.9202832822525,43.5635025489192
0.744943820224719,0.789504021354009,1061,230,45,73,21,20,24,53,41.9202832822525,43.5635025489192
0.788682893539581,0.813605265134836,1070,221,35,47,15,9,20,38,41.9202832822525,43.5635025489192
0.725829383886256,0.763901997747921,1082,209,25,29,9,6,16,23,41.9202832822525,43.5635025489192
0.688811420982736,0.731774334797724,1063,228,36,24,16,5,20,19,41.9202832822525,43.5635025489192
0.696213029576339,0.74237373546849,1049,242,40,29,16,8,24,21,41.9202832822525,43.5635025489192
0.755043902439025,0.806975628063884,1077,214,41,28,18,10,23,18,41.9202832822525,43.5635025489192
0.746269335759782,0.780364456254202,1048,243,35,41,15,10,20,31,41.9202832822525,43.5635025489192
0.749152844658463,0.802129698892331,1074,217,45,69,22,21,23,48,41.9202832822525,43.5635025489192
0.745628596724214,0.785458230150579,1053,238,36,46,17,16,19,30,41.9202832822525,43.5635025489192
0.797055811571941,0.828503454168306,1080,211,31,23,12,4,19,19,41.9202832822525,43.5635025489192
0.71646407172723,0.785416367846603,1061,230,37,32,21,12,16,20,41.9202832822525,43.5635025489192
0.781419330449027,0.814932631753558,1048,243,38,31,23,10,15,21,41.9202832822525,43.5635025489192
0.778944968075403,0.823900102230862,1073,218,26,127,12,30,14,97,41.9202832822525,43.5635025489192
0.739564322148907,0.795839020379718,1080,211,34,58,16,15,18,43,41.9202832822525,43.5635025489192
0.799358798518722,0.869688917348773,1078,213,23,29,15,10,8,19,41.9202832822525,43.5635025489192
0.736630695443645,0.766096664256872,1076,215,40,39,17,8,23,31,41.9202832822525,43.5635025489192
0.722919091340144,0.777453272964924,1070,221,37,67,19,15,18,52,41.9202832822525,43.5635025489192
0.648747904060655,0.722171712471515,1078,213,44,71,17,17,27,54,41.9202832822525,43.5635025489192
0.786039820220944,0.83268316104372,1041,250,38,55,23,22,15,33,41.9202832822525,43.5635025489192
0.75245726046961,0.806849084623724,1079,212,38,50,19,15,19,35,41.9202832822525,43.5635025489192
0.774677787835683,0.819893279151484,1094,197,37,55,21,17,16,38,41.9202832822525,43.5635025489192
0.80558115719406,0.83891100674619,1074,217,31,55,20,15,11,40,41.9202832822525,43.5635025489192
0.753866331493524,0.793765440858069,1056,235,29,64,14,23,15,41,41.9202832822525,43.5635025489192
0.73607457394487,0.770925026916686,1067,224,42,46,17,14,25,32,41.9202832822525,43.5635025489192
0.797202001819836,0.839049412983422,1056,235,35,88,22,23,13,65,41.9202832822525,43.5635025489192
0.707560002981515,0.752430043186862,1059,232,43,59,18,18,25,41,41.9202832822525,43.5635025489192
0.782279344858963,0.824566099249806,1041,250,35,130,22,35,13,95,41.9202832822525,43.5635025489192
0.743079766455244,0.786460044018725,1040,251,38,80,16,18,22,62,41.9202832822525,43.5635025489192
0.785015676915158,0.825948038926056,1079,212,34,48,21,15,13,33,41.9202832822525,43.5635025489192
0.739385318332687,0.765408289002413,1065,226,37,20,17,6,20,14,41.9202832822525,43.5635025489192
0.697811355811793,0.732670129912522,1057,234,29,75,10,18,19,57,41.9202832822525,43.5635025489192
0.785148295706065,0.828735181252548,1076,215,36,79,17,19,19,60,41.9202832822525,43.5635025489192
0.732700181983621,0.788202290893413,1073,218,35,47,18,14,17,33,41.9202832822525,43.5635025489192
0.806519481938904,0.831566685814136,1084,207,29,22,14,5,15,17,41.9202832822525,43.5635025489192
0.706662033359809,0.791845231773248,1089,202,32,48,16,10,16,38,41.9202832822525,43.5635025489192
0.724314649903964,0.775580519657276,1055,236,46,40,20,11,26,29,41.9202832822525,43.5635025489192
0.648263414634146,0.705487808475577,1067,224,41,53,15,13,26,40,41.9202832822525,43.5635025489192
0.775154935812306,0.800948973726046,1045,246,36,44,21,15,15,29,41.9202832822525,43.5635025489192
0.699528548978523,0.736162158753944,1077,214,46,34,20,6,26,28,41.9202832822525,43.5635025489192
0.751583929636255,0.771391610606135,1078,213,43,37,20,10,23,27,41.9202832822525,43.5635025489192
0.659923550436855,0.724830643673791,1084,207,32,31,12,4,20,27,41.9202832822525,43.5635025489192
0.687192842441299,0.72146693862607,1078,213,38,66,15,18,23,48,41.9202832822525,43.5635025489192
0.7516771019678,0.792543807767079,1072,219,43,59,22,17,21,42,41.9202832822525,43.5635025489192
0.684196547144754,0.729745165467994,1101,190,36,112,13,24,23,88,41.9202832822525,43.5635025489192
0.756024919394502,0.799337779585276,1058,233,29,65,13,14,16,51,41.9202832822525,43.5635025489192
0.722728609232579,0.749705212703833,1054,237,38,23,16,4,22,19,41.9202832822525,43.5635025489192
0.657317315329627,0.709916341820254,1072,219,32,88,14,19,18,69,41.9202832822525,43.5635025489192
0.756621728786677,0.782962619969765,1057,234,30,25,15,8,15,17,41.9202832822525,43.5635025489192
0.730399860310808,0.754424349046971,1089,202,46,35,18,8,28,27,41.9202832822525,43.5635025489192
0.733972105016409,0.763704862598665,1073,218,27,58,12,12,15,46,41.9202832822525,43.5635025489192
0.814888068448195,0.837470205052404,1086,205,27,43,15,12,12,31,41.9202832822525,43.5635025489192
0.776088069636457,0.814316402723928,1062,229,31,48,18,15,13,33,41.9202832822525,43.5635025489192
0.76622399291722,0.793486680213542,1031,260,36,25,20,10,16,15,41.9202832822525,43.5635025489192
0.706393686377673,0.749179325218065,1050,241,42,35,20,10,22,25,41.9202832822525,43.5635025489192
0.724780487804878,0.751514899222903,1061,230,41,70,14,15,27,55,41.9202832822525,43.5635025489192
0.746671786994368,0.787621069455018,1079,212,31,33,13,12,18,21,41.9202832822525,43.5635025489192
0.712461266046923,0.754282405965525,1068,223,36,76,14,12,22,64,41.9202832822525,43.5635025489192
0.716702243844321,0.752549840158222,1074,217,32,21,15,9,17,12,41.9202832822525,43.5635025489192
0.763501549358123,0.829696163897935,1079,212,36,64,21,26,15,38,41.9202832822525,43.5635025489192
0.809122701838529,0.837582929589446,1052,239,40,83,22,21,18,62,41.9202832822525,43.5635025489192
0.762236831326288,0.823048096690151,1070,221,39,90,18,17,21,73,41.9202832822525,43.5635025489192
0.722088780784433,0.740218954359736,1066,225,26,37,8,8,18,29,41.9202832822525,43.5635025489192
0.709987838248708,0.745521134282462,1055,236,26,37,10,10,16,27,41.9202832822525,43.5635025489192
0.734539619300575,0.79909523271555,1047,244,36,34,22,14,14,20,41.9202832822525,43.5635025489192
0.774516527225346,0.819333542063193,1082,209,23,58,11,13,12,45,41.9202832822525,43.5635025489192
0.755373808578237,0.798317848018867,1081,210,32,39,18,12,14,27,41.9202832822525,43.5635025489192
0.790691098292048,0.822836666523941,1070,221,28,70,14,17,14,53,41.9202832822525,43.5635025489192
0.7276,0.819337161315145,1067,224,41,141,24,37,17,104,41.9202832822525,43.5635025489192
0.696359008410801,0.75420537772193,1086,205,36,44,17,15,19,29,41.9202832822525,43.5635025489192
0.72824926607953,0.761127601261746,1091,200,42,50,16,14,26,36,41.9202832822525,43.5635025489192
0.769975652943781,0.814167278392157,1069,222,36,37,22,10,14,27,41.9202832822525,43.5635025489192
0.814834911865299,0.855875154515407,1030,261,24,82,15,20,9,62,41.9202832822525,43.5635025489192
0.825258536585366,0.854675785815455,1054,237,41,65,27,22,14,43,41.9202832822525,43.5635025489192
0.737400079936051,0.785396704591675,1077,214,40,30,25,9,15,21,41.9202832822525,43.5635025489192
0.744183665110183,0.777893776341709,1067,224,39,44,15,12,24,32,41.9202832822525,43.5635025489192
0.735598960114935,0.788209731539406,1070,221,47,48,25,14,22,34,41.9202832822525,43.5635025489192
0.738663304452778,0.77455130261202,1048,243,37,28,17,7,20,21,41.9202832822525,43.5635025489192
0.738554271954156,0.773676832695173,1081,210,53,92,22,21,31,71,41.9202832822525,43.5635025489192
0.749426198152905,0.783766275784702,1041,250,29,33,13,11,16,22,41.9202832822525,43.5635025489192
0.756142074968412,0.806557047793647,1067,224,34,42,19,13,15,29,41.9202832822525,43.5635025489192
0.691456396635679,0.738602388187256,1081,210,36,51,15,11,21,40,41.9202832822525,43.5635025489192
0.677996422182469,0.705738672047734,1058,233,43,33,17,9,26,24,41.9202832822525,43.5635025489192
0.765041699761716,0.790934182819438,1069,222,32,29,16,13,16,16,41.9202832822525,43.5635025489192
0.6782276562628,0.721674464178801,1057,234,39,34,17,12,22,22,41.9202832822525,43.5635025489192
0.70030778395552,0.748212462881974,1085,206,32,45,14,12,18,33,41.9202832822525,43.5635025489192
0.705901177675371,0.755682883264742,1058,233,31,72,11,14,20,58,41.9202832822525,43.5635025489192
0.798043676069154,0.838257700513601,1068,223,35,65,22,19,13,46,41.9202832822525,43.5635025489192
0.763694267515924,0.817811824239706,1072,219,35,57,16,13,19,44,41.9202832822525,43.5635025489192
0.757181259600614,0.800880955311489,1064,227,31,39,16,15,15,24,41.9202832822525,43.5635025489192
0.697746341463415,0.746479662054721,1075,216,41,57,20,15,21,42,41.9202832822525,43.5635025489192
0.78441712926249,0.813269712399766,1086,205,30,45,14,15,16,30,41.9202832822525,43.5635025489192
0.758898431294678,0.822633941147637,1089,202,32,101,17,20,15,81,41.9202832822525,43.5635025489192
0.837110311750599,0.874774577045336,1061,230,40,93,26,29,14,64,41.9202832822525,43.5635025489192
0.742705835331735,0.79216844817313,1051,240,40,67,18,14,22,53,41.9202832822525,43.5635025489192
0.688253454866216,0.732500491925716,1062,229,38,34,16,10,22,24,41.9202832822525,43.5635025489192
0.695143312101911,0.754419242851307,1062,229,35,106,15,20,20,86,41.9202832822525,43.5635025489192
0.830632411067194,0.86255228827599,1051,240,26,74,17,27,9,47,41.9202832822525,43.5635025489192
0.700417476838614,0.748960179990025,1063,228,42,65,15,18,27,47,41.9202832822525,43.5635025489192
0.747119815668203,0.801102113427801,1059,232,31,52,13,9,18,43,41.9202832822525,43.5635025489192
0.698224182784753,0.744194232154953,1050,241,28,42,14,10,14,32,41.9202832822525,43.5635025489192
0.815298288795124,0.844560012628301,1051,240,27,45,18,19,9,26,41.9202832822525,43.5635025489192
0.713726884779516,0.742682983131905,1065,226,37,68,16,16,21,52,41.9202832822525,43.5635025489192
0.760731707317073,0.788844688099562,1052,239,41,30,23,13,18,17,41.9202832822525,43.5635025489192
0.765570973612375,0.798708888520208,1062,229,35,56,17,14,18,42,41.9202832822525,43.5635025489192
0.772341860577155,0.819470265788627,1059,232,33,81,15,20,18,61,41.9202832822525,43.5635025489192
0.712204063242402,0.781815649350573,1049,242,39,100,18,25,21,75,41.9202832822525,43.5635025489192
0.784337123871028,0.819353737819219,1052,239,34,52,19,16,15,36,41.9202832822525,43.5635025489192
0.689842762880809,0.739317039932906,1071,220,34,51,13,9,21,42,41.9202832822525,43.5635025489192
0.77787011610541,0.821653323323701,1053,238,33,46,19,13,14,33,41.9202832822525,43.5635025489192
0.690223716539506,0.733525973088004,1082,209,37,30,13,5,24,25,41.9202832822525,43.5635025489192
0.655003276808389,0.716889511136316,1054,237,39,44,18,10,21,34,41.9202832822525,43.5635025489192
0.721390168970814,0.745717173721501,1051,240,31,33,14,6,17,27,41.9202832822525,43.5635025489192
0.838389288569145,0.855057911782287,1074,217,40,21,27,6,13,15,41.9202832822525,43.5635025489192
0.773761055734943,0.813038770343072,1087,204,34,70,18,19,16,51,41.9202832822525,43.5635025489192
0.774990301306091,0.80687284247115,1075,216,37,85,21,22,16,63,41.9202832822525,43.5635025489192
0.749710940887412,0.792911757995117,1101,190,33,92,10,18,23,74,41.9202832822525,43.5635025489192
0.764288569144684,0.795073449806193,1050,241,40,54,19,15,21,39,41.9202832822525,43.5635025489192
0.781326912787587,0.810875978484531,1052,239,45,49,25,19,20,30,41.9202832822525,43.5635025489192
0.777737787926926,0.811596998632152,1099,192,32,49,16,15,16,34,41.9202832822525,43.5635025489192
0.745977260683143,0.777026566241476,1066,225,33,46,17,10,16,36,41.9202832822525,43.5635025489192
0.764915649430805,0.795317179048463,1080,211,23,53,12,12,11,41,41.9202832822525,43.5635025489192
0.751543800207662,0.804458298466709,1041,250,29,43,18,11,11,32,41.9202832822525,43.5635025489192
0.824372500843089,0.872704699789994,1053,238,33,40,19,16,14,24,41.9202832822525,43.5635025489192
0.681240063593005,0.728460417301907,1056,235,33,45,12,10,21,35,41.9202832822525,43.5635025489192
0.747841983235242,0.809930193626485,1065,226,45,104,23,25,22,79,41.9202832822525,43.5635025489192
0.750185038329368,0.797920951139057,1072,219,30,78,13,13,17,65,41.9202832822525,43.5635025489192
0.711924148860594,0.804467790373502,1067,224,29,38,16,11,13,27,41.9202832822525,43.5635025489192
0.742082160709035,0.797706422585807,1071,220,38,58,16,13,22,45,41.9202832822525,43.5635025489192
0.660335295166756,0.69641280450462,1063,228,45,60,13,15,32,45,41.9202832822525,43.5635025489192
0.766346922462031,0.819127695761194,1071,220,40,69,23,18,17,51,41.9202832822525,43.5635025489192
0.788673700438406,0.829622362539336,1076,215,33,52,20,18,13,34,41.9202832822525,43.5635025489192
0.696933650541898,0.730946634395736,1049,242,30,18,11,5,19,13,41.9202832822525,43.5635025489192
0.744805810595284,0.798012925811403,1045,246,37,50,22,14,15,36,41.9202832822525,43.5635025489192
0.778417471171896,0.824104701735455,1049,242,48,73,27,14,21,59,41.9202832822525,43.5635025489192
0.740032289765548,0.799265050053491,1041,250,34,31,19,11,15,20,41.9202832822525,43.5635025489192
0.743664787782435,0.78364900736547,1076,215,33,71,18,23,15,48,41.9202832822525,43.5635025489192
0.768977111082374,0.823328405087055,1059,232,37,45,20,16,17,29,41.9202832822525,43.5635025489192
0.761443116423196,0.786219605906877,1065,226,36,69,16,11,20,58,41.9202832822525,43.5635025489192
0.69471163943378,0.734830173496252,1072,219,38,28,19,7,19,21,41.9202832822525,43.5635025489192
0.745905368516833,0.786589899537935,1057,234,35,32,17,8,18,24,41.9202832822525,43.5635025489192
0.737769784172662,0.786423286227612,1067,224,40,72,20,18,20,54,41.9202832822525,43.5635025489192
0.768738267632073,0.822778513988842,1051,240,48,70,23,20,25,50,41.9202832822525,43.5635025489192
0.720293683951831,0.763460605413846,1068,223,39,37,18,9,21,28,41.9202832822525,43.5635025489192
0.723878354008416,0.764678139773347,1066,225,29,42,10,9,19,33,41.9202832822525,43.5635025489192
0.747102072581306,0.82915820756174,1060,231,39,48,20,14,19,34,41.9202832822525,43.5635025489192
0.715127807233071,0.748176947683075,1067,224,37,50,15,10,22,40,41.9202832822525,43.5635025489192
0.762699254292947,0.80436450682629,1050,241,47,53,23,18,24,35,41.9202832822525,43.5635025489192
0.785494440031771,0.832130690934676,1075,216,32,56,15,12,17,44,41.9202832822525,43.5635025489192
0.678915719032243,0.708789951929987,1091,200,34,33,14,10,20,23,41.9202832822525,43.5635025489192
0.73894449499545,0.784021446926115,1065,226,35,63,20,21,15,42,41.9202832822525,43.5635025489192
0.805258467023173,0.836090974965605,1089,202,33,39,18,16,15,23,41.9202832822525,43.5635025489192
0.700448513148194,0.740226053686471,1062,229,39,54,18,18,21,36,41.9202832822525,43.5635025489192
0.766048680618744,0.809617961751807,1074,217,35,111,18,24,17,87,41.9202832822525,43.5635025489192
0.622197225346832,0.65490688437042,1073,218,21,33,9,6,12,27,41.9202832822525,43.5635025489192
0.691078509119746,0.730274449514707,1059,232,30,59,10,19,20,40,41.9202832822525,43.5635025489192
0.700231643970237,0.725320902908783,1058,233,34,33,12,9,22,24,41.9202832822525,43.5635025489192
0.782117367168914,0.845710769263855,1068,223,30,66,15,18,15,48,41.9202832822525,43.5635025489192
0.808148734177215,0.864288138337741,1072,219,27,27,17,8,10,19,41.9202832822525,43.5635025489192
0.744075154196835,0.806857732311411,1081,210,48,90,23,24,25,66,41.9202832822525,43.5635025489192
0.722366512237353,0.750908369220529,1068,223,34,30,15,7,19,23,41.9202832822525,43.5635025489192
0.799953795102281,0.856289241478594,1053,238,38,134,22,37,16,97,41.9202832822525,43.5635025489192
0.78315550563901,0.805805386684911,1069,222,34,30,16,7,18,23,41.9202832822525,43.5635025489192
0.771333895949166,0.801264197246901,1093,198,32,40,18,10,14,30,41.9202832822525,43.5635025489192
0.721057347670251,0.766387581291945,1052,239,31,53,15,10,16,43,41.9202832822525,43.5635025489192
0.781392174704277,0.820561141921338,1079,212,35,30,19,12,16,18,41.9202832822525,43.5635025489192
0.745131707317073,0.794424304899069,1086,205,41,38,18,9,23,29,41.9202832822525,43.5635025489192
0.733910938274429,0.778939194409315,1066,225,42,82,18,21,24,61,41.9202832822525,43.5635025489192
0.768390243902439,0.819582700358524,1070,221,41,44,25,15,16,29,41.9202832822525,43.5635025489192
0.765770252324037,0.800391147005147,1057,234,36,99,20,20,16,79,41.9202832822525,43.5635025489192
0.737619187633889,0.786586668509515,1082,209,38,67,18,15,20,52,41.9202832822525,43.5635025489192
0.695609756097561,0.735201718444543,1067,224,41,55,17,12,24,43,41.9202832822525,43.5635025489192
0.767137519539441,0.804788734667933,1053,238,42,42,22,13,20,29,41.9202832822525,43.5635025489192
0.73405650581999,0.767368314750535,1063,228,29,36,12,8,17,28,41.9202832822525,43.5635025489192
0.654643902439024,0.675762798003786,1066,225,41,27,11,5,30,22,41.9202832822525,43.5635025489192
0.728919239904988,0.769147535650478,1091,200,28,52,15,13,13,39,41.9202832822525,43.5635025489192
0.660134212920837,0.70244728683543,1080,211,35,36,14,12,21,24,41.9202832822525,43.5635025489192
0.788248847926267,0.810054261292161,1054,237,31,74,13,14,18,60,41.9202832822525,43.5635025489192
0.783518812930578,0.812560198093873,1096,195,33,69,15,12,18,57,41.9202832822525,43.5635025489192
0.779351171564734,0.802439525666529,1073,218,32,37,16,13,16,24,41.9202832822525,43.5635025489192
0.804521134296415,0.822986558577182,1056,235,45,24,29,15,16,9,41.9202832822525,43.5635025489192
0.719395232553127,0.758201793433509,1046,245,37,36,21,13,16,23,41.9202832822525,43.5635025489192
0.673095557543232,0.701574642138435,1062,229,43,33,14,9,29,24,41.9202832822525,43.5635025489192
0.71696148626515,0.772309270864311,1077,214,34,54,16,14,18,40,41.9202832822525,43.5635025489192
0.715093266606005,0.770066656543518,1057,234,35,64,16,17,19,47,41.9202832822525,43.5635025489192
0.760831334932054,0.796767080945523,1048,243,40,54,23,15,17,39,41.9202832822525,43.5635025489192
0.796522204387373,0.834109616033616,1066,225,45,33,28,10,17,23,41.9202832822525,43.5635025489192
0.76406208098686,0.81492358325904,1062,229,48,61,30,21,18,40,41.9202832822525,43.5635025489192
0.677909588656465,0.722672876409141,1089,202,34,129,11,17,23,112,41.9202832822525,43.5635025489192
0.69786076326774,0.740096415470119,1053,238,43,67,19,18,24,49,41.9202832822525,43.5635025489192
0.709633757961783,0.771257720882219,1072,219,35,51,16,13,19,38,41.9202832822525,43.5635025489192
0.737113284804368,0.774627541186886,1056,235,35,49,14,14,21,35,41.9202832822525,43.5635025489192
0.771262611324723,0.802413150445925,1056,235,49,59,25,22,24,37,41.9202832822525,43.5635025489192
0.7200864422202,0.760527095503069,1070,221,35,58,13,13,22,45,41.9202832822525,43.5635025489192
0.732873701039169,0.77318317145605,1074,217,40,53,21,17,19,36,41.9202832822525,43.5635025489192
0.825240090797974,0.848276642661261,1074,217,46,72,29,20,17,52,41.9202832822525,43.5635025489192
0.718661150397317,0.751510799242016,1044,247,44,52,19,13,25,39,41.9202832822525,43.5635025489192
0.735429936305732,0.778342812995636,1062,229,35,75,15,16,20,59,41.9202832822525,43.5635025489192
0.747391080537227,0.790671102364959,1066,225,34,42,17,12,17,30,41.9202832822525,43.5635025489192
0.75568407466243,0.784326301699922,1069,222,32,69,19,18,13,51,41.9202832822525,43.5635025489192
0.769367875252583,0.795590509299952,1064,227,42,25,25,11,17,14,41.9202832822525,43.5635025489192
0.739866425841139,0.792655039149897,1073,218,38,104,16,21,22,83,41.9202832822525,43.5635025489192
0.741124391323595,0.760410243765186,1072,219,36,47,14,12,22,35,41.9202832822525,43.5635025489192
0.685144065556437,0.710393672180692,1073,218,30,22,11,4,19,18,41.9202832822525,43.5635025489192
0.747038686100727,0.781380480811125,1076,215,38,50,19,14,19,36,41.9202832822525,43.5635025489192
0.729780801209373,0.759491270595044,1037,254,49,56,25,25,24,31,41.9202832822525,43.5635025489192
0.753834146341463,0.791064557683523,1076,215,41,72,19,22,22,50,41.9202832822525,43.5635025489192
0.744569679140727,0.800352405320648,1064,227,47,98,21,24,26,74,41.9202832822525,43.5635025489192
0.741187050359712,0.785096574957607,1081,210,40,72,18,19,22,53,41.9202832822525,43.5635025489192
0.783908094257991,0.816168317566596,1072,219,38,43,23,17,15,26,41.9202832822525,43.5635025489192
0.751864997206612,0.779404386305387,1074,217,49,67,21,18,28,49,41.9202832822525,43.5635025489192
0.763559361692171,0.792439546235314,1071,220,34,39,19,12,15,27,41.9202832822525,43.5635025489192
0.724512574752191,0.757551964571801,1062,229,39,62,16,18,23,44,41.9202832822525,43.5635025489192
0.794919127988748,0.84060039331736,1060,231,27,36,18,13,9,23,41.9202832822525,43.5635025489192
0.707789604140847,0.754635688088544,1067,224,44,91,16,21,28,70,41.9202832822525,43.5635025489192
0.717734421586166,0.757348948983323,1046,245,43,36,18,13,25,23,41.9202832822525,43.5635025489192
0.664240218380346,0.721412828385145,1059,232,35,111,16,29,19,82,41.9202832822525,43.5635025489192
0.677418065547562,0.735817229329958,1086,205,40,45,19,9,21,36,41.9202832822525,43.5635025489192
0.703708791208791,0.746626178668909,1069,222,56,92,26,25,30,67,41.9202832822525,43.5635025489192
0.71162070343725,0.743976028748727,1057,234,40,36,17,10,23,26,41.9202832822525,43.5635025489192
0.737883605530664,0.765548650591178,1070,221,33,28,15,8,18,20,41.9202832822525,43.5635025489192
0.748684471803018,0.781892000705232,1082,209,32,48,15,13,17,35,41.9202832822525,43.5635025489192
0.718755686988171,0.794363391586479,1064,227,35,83,15,21,20,62,41.9202832822525,43.5635025489192
0.768768173407349,0.785391995295408,1077,214,30,62,13,19,17,43,41.9202832822525,43.5635025489192
0.793958976705174,0.830322527970971,1049,242,42,36,27,11,15,25,41.9202832822525,43.5635025489192
0.750312513470408,0.799102607645124,1052,239,37,89,19,22,18,67,41.9202832822525,43.5635025489192
0.703364556643004,0.737835416713978,1070,221,38,41,18,12,20,29,41.9202832822525,43.5635025489192
0.700644424328635,0.727169181498656,1076,215,37,30,15,8,22,22,41.9202832822525,43.5635025489192
0.741420590582602,0.776774359612435,1067,224,38,53,17,9,21,44,41.9202832822525,43.5635025489192
0.75578905630452,0.799960739911468,1058,233,30,66,17,21,13,45,41.9202832822525,43.5635025489192
0.707279344858963,0.754800386980613,1069,222,35,39,16,12,19,27,41.9202832822525,43.5635025489192
0.699769585253456,0.712517986347195,1072,219,31,19,10,5,21,14,41.9202832822525,43.5635025489192
0.695982024848004,0.721634320989593,1081,210,30,37,11,11,19,26,41.9202832822525,43.5635025489192
0.769572745566007,0.79762326900217,1070,221,34,54,19,21,15,33,41.9202832822525,43.5635025489192
0.759881891460839,0.811014105564928,1038,253,37,41,21,14,16,27,41.9202832822525,43.5635025489192
0.737853450896929,0.768484419436739,1076,215,26,49,13,16,13,33,41.9202832822525,43.5635025489192
0.72201239008793,0.770563678474009,1080,211,40,69,16,19,24,50,41.9202832822525,43.5635025489192
0.731410836673995,0.771869814474711,1073,218,37,78,13,19,24,59,41.9202832822525,43.5635025489192
0.745683966470483,0.785354777171845,1062,229,45,46,22,12,23,34,41.9202832822525,43.5635025489192
0.725384024577573,0.776221919616671,1057,234,31,47,12,12,19,35,41.9202832822525,43.5635025489192
0.821086261980831,0.847145805194986,1054,237,39,93,21,25,18,68,41.9202832822525,43.5635025489192
0.779036770583533,0.831692426252532,1074,217,40,94,25,31,15,63,41.9202832822525,43.5635025489192
0.783588375684403,0.81888452323648,1077,214,34,48,18,15,16,33,41.9202832822525,43.5635025489192
0.678752937318979,0.722482630144559,1068,223,29,39,9,8,20,31,41.9202832822525,43.5635025489192
0.717895676897281,0.760900962990519,1073,218,44,58,19,15,25,43,41.9202832822525,43.5635025489192
0.771184950773558,0.84103196840068,1063,228,27,57,16,21,11,36,41.9202832822525,43.5635025489192
0.666907317073171,0.699020539654663,1061,230,41,76,15,18,26,58,41.9202832822525,43.5635025489192
0.715871382366531,0.785008289176748,1070,221,38,92,16,24,22,68,41.9202832822525,43.5635025489192
0.725580844001897,0.744316653864098,1068,223,37,62,15,16,22,46,41.9202832822525,43.5635025489192
0.702647881694644,0.756154891707452,1065,226,40,80,20,19,20,61,41.9202832822525,43.5635025489192
0.756062095518965,0.786709408145235,1043,248,39,59,19,15,20,44,41.9202832822525,43.5635025489192
0.797414234511009,0.834144031686459,1078,213,31,68,16,13,15,55,41.9202832822525,43.5635025489192
0.725763702934587,0.762765704393211,1052,239,29,13,15,6,14,7,41.9202832822525,43.5635025489192
0.712142740040439,0.802387973579321,1070,221,29,113,15,24,14,89,41.9202832822525,43.5635025489192
0.787711522965351,0.827471556952712,1054,237,50,55,27,16,23,39,41.9202832822525,43.5635025489192
0.759684044233807,0.808889041837395,1072,219,25,27,13,7,12,20,41.9202832822525,43.5635025489192
0.702715448768864,0.740493291176238,1072,219,32,87,13,18,19,69,41.9202832822525,43.5635025489192
0.726250335210512,0.760950368642594,1045,246,48,76,21,23,27,53,41.9202832822525,43.5635025489192
0.794381255686988,0.821481837252365,1070,221,35,31,24,14,11,17,41.9202832822525,43.5635025489192
0.758048780487805,0.811865787442388,1048,243,41,123,23,39,18,84,41.9202832822525,43.5635025489192
0.82993364463013,0.867959391293616,1079,212,39,124,25,39,14,85,41.9202832822525,43.5635025489192
0.751249632461041,0.775842958872945,1085,206,38,25,18,9,20,16,41.9202832822525,43.5635025489192
0.726719995311767,0.768766191225358,1071,220,27,68,13,20,14,48,41.9202832822525,43.5635025489192
0.720363709032774,0.761393351333376,1044,247,40,78,21,21,19,57,41.9202832822525,43.5635025489192
0.777695159274107,0.834101575379226,1048,243,37,109,23,29,14,80,41.9202832822525,43.5635025489192
0.664514015630119,0.708204060548679,1064,227,34,57,10,12,24,45,41.9202832822525,43.5635025489192
0.750163943384884,0.780905698303845,1046,245,29,38,16,9,13,29,41.9202832822525,43.5635025489192
0.677838029218843,0.737154613922645,1055,236,43,46,22,17,21,29,41.9202832822525,43.5635025489192
0.70078150591979,0.736070363700702,1080,211,34,49,16,15,18,34,41.9202832822525,43.5635025489192
0.7381850675139,0.77374496575101,1060,231,32,72,17,16,15,56,41.9202832822525,43.5635025489192
0.741893140672911,0.797344216306153,1060,231,38,50,23,18,15,32,41.9202832822525,43.5635025489192
0.797609516184376,0.819660152129869,1049,242,42,44,26,21,16,23,41.9202832822525,43.5635025489192
0.774661893396977,0.811215502382731,1076,215,34,64,16,13,18,51,41.9202832822525,43.5635025489192
0.796586059743954,0.832098345988041,1060,231,37,37,25,15,12,22,41.9202832822525,43.5635025489192
0.746558211598052,0.796934257490733,1057,234,36,58,16,12,20,46,41.9202832822525,43.5635025489192
0.692346123101519,0.734123717342527,1075,216,40,51,17,12,23,39,41.9202832822525,43.5635025489192
0.702629978005522,0.731921242062158,1057,234,34,38,13,9,21,29,41.9202832822525,43.5635025489192
0.766006777242732,0.804686469313007,1075,216,45,34,27,14,18,20,41.9202832822525,43.5635025489192
0.730347694633409,0.774634946853661,1078,213,49,51,23,15,26,36,41.9202832822525,43.5635025489192
0.71562980030722,0.787274901967236,1049,242,31,66,13,14,18,52,41.9202832822525,43.5635025489192
0.706533419299377,0.751920442536125,1071,220,22,31,9,3,13,28,41.9202832822525,43.5635025489192
0.723298164474635,0.761559703071623,1058,233,33,24,16,4,17,20,41.9202832822525,43.5635025489192
0.66978417266187,0.699037587538406,1064,227,40,68,13,14,27,54,41.9202832822525,43.5635025489192
0.763998448208975,0.79026563620995,1046,245,37,60,21,14,16,46,41.9202832822525,43.5635025489192
0.777630331753555,0.828673095665373,1069,222,25,64,12,20,13,44,41.9202832822525,43.5635025489192
0.747543170012635,0.815392450779348,1062,229,34,55,18,14,16,41,41.9202832822525,43.5635025489192
0.78670840316803,0.846257664931134,1069,222,49,101,27,30,22,71,41.9202832822525,43.5635025489192
0.757424286974419,0.786853903639363,1082,209,38,32,17,10,21,22,41.9202832822525,43.5635025489192
0.743745035742653,0.787926654271544,1067,224,32,63,16,16,16,47,41.9202832822525,43.5635025489192
0.752547961630695,0.81762306634992,1052,239,40,46,21,16,19,30,41.9202832822525,43.5635025489192
0.724578667571542,0.787064606370059,1077,214,28,44,16,13,12,31,41.9202832822525,43.5635025489192
0.802965645070908,0.858411699490852,1077,214,37,102,26,36,11,66,41.9202832822525,43.5635025489192
0.740349477044567,0.764273165230851,1102,189,38,39,16,14,22,25,41.9202832822525,43.5635025489192
0.723931707317073,0.753434350785083,1077,214,41,53,13,11,28,42,41.9202832822525,43.5635025489192
0.714312195121951,0.779329295507741,1050,241,41,61,20,20,21,41,41.9202832822525,43.5635025489192
0.645535475999848,0.687562981631356,1064,227,42,67,17,25,25,42,41.9202832822525,43.5635025489192
0.746442687747036,0.779964620760033,1086,205,26,10,13,3,13,7,41.9202832822525,43.5635025489192
0.769081932212437,0.802756078965209,1063,228,42,53,25,22,17,31,41.9202832822525,43.5635025489192
0.754096262160778,0.785517697411462,1059,232,31,81,17,20,14,61,41.9202832822525,43.5635025489192
0.708199679230152,0.763658658927595,1049,242,44,77,22,27,22,50,41.9202832822525,43.5635025489192
0.713078335980937,0.754406892019051,1064,227,32,46,14,13,18,33,41.9202832822525,43.5635025489192
0.808621071270474,0.841322938503967,1100,191,36,23,21,7,15,16,41.9202832822525,43.5635025489192
0.698621103117506,0.75032603556398,1053,238,40,59,20,19,20,40,41.9202832822525,43.5635025489192
0.657379368546466,0.702975448068721,1083,208,32,94,11,20,21,74,41.9202832822525,43.5635025489192
0.786750599520384,0.817533026178203,1070,221,40,31,25,10,15,21,41.9202832822525,43.5635025489192
0.721980487804878,0.765861314357205,1047,244,41,57,17,17,24,40,41.9202832822525,43.5635025489192
0.741500789889415,0.797727977676519,1063,228,25,63,12,18,13,45,41.9202832822525,43.5635025489192
0.754467485919099,0.807535399636031,1053,238,31,36,16,13,15,23,41.9202832822525,43.5635025489192
0.746639687816159,0.781100309259045,1070,221,33,25,17,7,16,18,41.9202832822525,43.5635025489192
0.734199639551077,0.775540692486694,1091,200,39,30,17,8,22,22,41.9202832822525,43.5635025489192
0.749638676109264,0.78617148723548,1081,210,33,71,16,19,17,52,41.9202832822525,43.5635025489192
0.725329845313922,0.787027749234183,1087,204,35,85,16,20,19,65,41.9202832822525,43.5635025489192
0.737113402061856,0.779554949417853,1075,216,30,42,13,14,17,28,41.9202832822525,43.5635025489192
0.75932215638098,0.797021256925175,1079,212,33,60,15,15,18,45,41.9202832822525,43.5635025489192
0.73013923013923,0.772466779400994,1055,236,37,50,16,17,21,33,41.9202832822525,43.5635025489192
0.737689848121503,0.798500894488579,1043,248,40,82,22,26,18,56,41.9202832822525,43.5635025489192
0.781445661896243,0.811480631504858,1056,235,43,40,23,14,20,26,41.9202832822525,43.5635025489192
0.837879765687053,0.849407059218905,1051,240,32,35,18,13,14,22,41.9202832822525,43.5635025489192
0.802873729344318,0.838808338263639,1075,216,33,94,19,21,14,73,41.9202832822525,43.5635025489192
0.681151219512195,0.728186771604269,1045,246,41,70,18,22,23,48,41.9202832822525,43.5635025489192
0.753033794162826,0.806956303099281,1064,227,31,71,19,19,12,52,41.9202832822525,43.5635025489192
0.759754765687053,0.798240568564761,1072,219,32,42,15,8,17,34,41.9202832822525,43.5635025489192
0.740887290167866,0.781515338844493,1058,233,40,50,19,15,21,35,41.9202832822525,43.5635025489192
0.751366916964351,0.796164172637847,1070,221,44,34,23,15,21,19,41.9202832822525,43.5635025489192
0.725416336241078,0.769479335252783,1068,223,30,46,15,11,15,35,41.9202832822525,43.5635025489192
0.695823325326928,0.750970826941656,1044,247,42,110,22,32,20,78,41.9202832822525,43.5635025489192
0.725354541144015,0.765339224908396,1096,195,37,42,16,10,21,32,41.9202832822525,43.5635025489192
0.772619047619048,0.834543180543519,1069,222,31,73,15,18,16,55,41.9202832822525,43.5635025489192
0.776706096451319,0.817827331911807,1054,237,35,38,21,12,14,26,41.9202832822525,43.5635025489192
0.751357106088259,0.788538013600769,1064,227,34,59,16,17,18,42,41.9202832822525,43.5635025489192
0.823737774253238,0.865613718469925,1087,204,30,77,19,21,11,56,41.9202832822525,43.5635025489192
0.825099920063949,0.870675527100043,1064,227,40,81,28,27,12,54,41.9202832822525,43.5635025489192
0.688844621513944,0.732436341364174,1076,215,36,63,13,15,23,48,41.9202832822525,43.5635025489192
0.711229150119142,0.751446465792389,1058,233,32,40,15,12,17,28,41.9202832822525,43.5635025489192
0.742106314948041,0.765458382476782,1068,223,40,33,17,9,23,24,41.9202832822525,43.5635025489192
0.757973157415833,0.797621034615664,1068,223,35,71,19,16,16,55,41.9202832822525,43.5635025489192
0.736339805029901,0.771746842898749,1048,243,39,69,20,25,19,44,41.9202832822525,43.5635025489192
0.773339399454049,0.818190408866611,1099,192,35,67,15,16,20,51,41.9202832822525,43.5635025489192
0.701804915514593,0.754640967665977,1065,226,31,33,14,9,17,24,41.9202832822525,43.5635025489192
0.762454320157937,0.803757336670461,1077,214,38,109,17,22,21,87,41.9202832822525,43.5635025489192
0.744213886671987,0.771963093877509,1059,232,38,34,17,13,21,21,41.9202832822525,43.5635025489192
0.753110507861102,0.832306325604666,1050,241,28,78,17,25,11,53,41.9202832822525,43.5635025489192
0.755081925243216,0.797577034918187,1061,230,31,50,19,17,12,33,41.9202832822525,43.5635025489192
0.732484143319192,0.778865071249055,1057,234,38,107,15,23,23,84,41.9202832822525,43.5635025489192
0.739392873886545,0.784870675689427,1042,249,27,44,13,13,14,31,41.9202832822525,43.5635025489192
0.739778177458034,0.791776455626993,1055,236,40,28,23,16,17,12,41.9202832822525,43.5635025489192
0.787151394422311,0.811705146320857,1079,212,36,46,17,15,19,31,41.9202832822525,43.5635025489192
0.785223367697594,0.833883600958711,1077,214,30,44,20,13,10,31,41.9202832822525,43.5635025489192
0.695540061974325,0.739451725995462,1071,220,36,37,15,15,21,22,41.9202832822525,43.5635025489192
0.728272972339428,0.78473380336713,1076,215,27,58,12,15,15,43,41.9202832822525,43.5635025489192
0.7569007587022,0.791873536077094,1085,206,42,72,16,17,26,55,41.9202832822525,43.5635025489192
0.72594726062468,0.776827101611306,1042,249,31,73,14,19,17,54,41.9202832822525,43.5635025489192
0.72023578602526,0.7827982310868,1053,238,37,42,22,16,15,26,41.9202832822525,43.5635025489192
0.721041205865487,0.798446714302893,1082,209,39,149,20,41,19,108,41.9202832822525,43.5635025489192
0.707044364508393,0.78047142826933,1075,216,40,153,18,33,22,120,41.9202832822525,43.5635025489192
0.768334943504012,0.820281561356429,1050,241,38,46,21,14,17,32,41.9202832822525,43.5635025489192
0.690343494085533,0.731046734632616,1082,209,35,32,15,8,20,24,41.9202832822525,43.5635025489192
0.78837929656275,0.8235599493777,1072,219,40,44,23,17,17,27,41.9202832822525,43.5635025489192
0.72046178343949,0.781890574275084,1092,199,35,46,16,12,19,34,41.9202832822525,43.5635025489192
0.760857592446892,0.808032423391289,1063,228,20,59,10,19,10,40,41.9202832822525,43.5635025489192
0.729848269321954,0.805377108541161,1063,228,37,62,20,22,17,40,41.9202832822525,43.5635025489192
0.847091581262577,0.866986328400456,1066,225,34,40,23,13,11,27,41.9202832822525,43.5635025489192
0.758444001770695,0.799865249884457,1078,213,36,40,18,11,18,29,41.9202832822525,43.5635025489192
0.776736228933379,0.816534677606199,1096,195,28,39,15,11,13,28,41.9202832822525,43.5635025489192
0.672395058904266,0.700808057976511,1074,217,42,41,11,9,31,32,41.9202832822525,43.5635025489192
0.750829587936321,0.799537674574041,1097,194,38,67,18,19,20,48,41.9202832822525,43.5635025489192
0.79850978396109,0.837380264266028,1063,228,28,50,16,15,12,35,41.9202832822525,43.5635025489192
0.769300400879348,0.83225765177681,1064,227,37,115,19,38,18,77,41.9202832822525,43.5635025489192
0.69679031833728,0.743863468354771,1067,224,24,108,12,25,12,83,41.9202832822525,43.5635025489192
0.758433253397282,0.811099834216114,1084,207,40,81,20,26,20,55,41.9202832822525,43.5635025489192
0.723285168227832,0.767768288590362,1072,219,38,48,17,17,21,31,41.9202832822525,43.5635025489192
0.767507746790615,0.812141202294351,1056,235,36,55,20,20,16,35,41.9202832822525,43.5635025489192
0.730505004549591,0.775807037063247,1071,220,35,66,16,15,19,51,41.9202832822525,43.5635025489192
0.649089058776807,0.68275490723274,1062,229,32,48,11,10,21,38,41.9202832822525,43.5635025489192
0.728594176524113,0.769814672066166,1062,229,35,32,18,13,17,19,41.9202832822525,43.5635025489192
0.758687450357426,0.788707325285096,1105,186,32,21,10,4,22,17,41.9202832822525,43.5635025489192
0.719873842877038,0.776627526318971,1081,210,39,67,16,13,23,54,41.9202832822525,43.5635025489192
0.753299171697319,0.80580837272405,1077,214,34,99,16,16,18,83,41.9202832822525,43.5635025489192
0.763223246287763,0.803068116970807,1078,213,31,60,11,13,20,47,41.9202832822525,43.5635025489192
0.778600393217007,0.817738080016044,1054,237,39,56,24,22,15,34,41.9202832822525,43.5635025489192
0.65525714853058,0.706025864995015,1076,215,32,80,12,13,20,67,41.9202832822525,43.5635025489192
0.644290263876251,0.700127405621713,1070,221,35,23,14,8,21,15,41.9202832822525,43.5635025489192
0.744539316918189,0.791336126510439,1077,214,32,54,15,16,17,38,41.9202832822525,43.5635025489192
0.722706846418187,0.807946634396994,1066,225,30,72,13,15,17,57,41.9202832822525,43.5635025489192
0.776777419531122,0.82478994881644,1093,198,29,58,14,10,15,48,41.9202832822525,43.5635025489192
0.712934739537294,0.750010561837961,1071,220,53,61,21,23,32,38,41.9202832822525,43.5635025489192
0.722914803220036,0.760886154254375,1060,231,43,59,22,15,21,44,41.9202832822525,43.5635025489192
0.839630367419212,0.86219491954437,1076,215,36,58,23,17,13,41,41.9202832822525,43.5635025489192
0.726625017548786,0.761693700134348,1067,224,34,47,14,8,20,39,41.9202832822525,43.5635025489192
0.739630004335887,0.799904026435257,1081,210,33,68,17,19,16,49,41.9202832822525,43.5635025489192
0.663271306758517,0.71195271281514,1042,249,38,33,16,7,22,26,41.9202832822525,43.5635025489192
0.760081894643648,0.785705803372949,1076,215,36,49,15,17,21,32,41.9202832822525,43.5635025489192
0.723427131973458,0.763023625075209,1053,238,39,29,20,8,19,21,41.9202832822525,43.5635025489192
0.800284349408553,0.847572916904601,1068,223,35,30,22,15,13,15,41.9202832822525,43.5635025489192
0.763217023526302,0.824451380098159,1075,216,30,49,18,12,12,37,41.9202832822525,43.5635025489192
0.754258739823493,0.790029013123483,1031,260,47,42,28,14,19,28,41.9202832822525,43.5635025489192
0.721929924892295,0.759806665075758,1052,239,42,29,17,9,25,20,41.9202832822525,43.5635025489192
0.677328137490008,0.738998048186372,1073,218,40,98,14,20,26,78,41.9202832822525,43.5635025489192
0.702606699819662,0.754657674344536,1060,231,29,35,11,12,18,23,41.9202832822525,43.5635025489192
0.761950110592283,0.804583839942202,1072,219,39,63,21,19,18,44,41.9202832822525,43.5635025489192
0.717231916113705,0.764347861651139,1069,222,39,44,18,12,21,32,41.9202832822525,43.5635025489192
0.750443585077343,0.786187122113562,1056,235,35,28,18,7,17,21,41.9202832822525,43.5635025489192
0.732511801327222,0.796453799607502,1053,238,47,110,24,30,23,80,41.9202832822525,43.5635025489192
0.805868971792539,0.83699821484948,1082,209,35,66,21,19,14,47,41.9202832822525,43.5635025489192
0.706418448431228,0.749164598042512,1064,227,39,102,15,28,24,74,41.9202832822525,43.5635025489192
0.719814148681055,0.773842414332031,1039,252,40,102,18,30,22,72,41.9202832822525,43.5635025489192
0.718305171530978,0.762976131871724,1082,209,31,95,15,22,16,73,41.9202832822525,43.5635025489192
0.681739707835325,0.717138919969189,1048,243,36,55,14,15,22,40,41.9202832822525,43.5635025489192
0.738991665462254,0.80492168961933,1081,210,33,69,18,22,15,47,41.9202832822525,43.5635025489192
0.68659793814433,0.706831327737388,1055,236,30,17,12,5,18,12,41.9202832822525,43.5635025489192
0.73819382825594,0.782832377669688,1056,235,49,61,24,20,25,41,41.9202832822525,43.5635025489192
0.734908657664813,0.781658064845692,1053,238,32,38,17,13,15,25,41.9202832822525,43.5635025489192
0.682765001321702,0.735969017057499,1069,222,30,22,11,6,19,16,41.9202832822525,43.5635025489192
0.74534800688873,0.812615710416889,1071,220,38,49,21,16,17,33,41.9202832822525,43.5635025489192
0.769624300559552,0.805269629960408,1066,225,40,49,16,20,24,29,41.9202832822525,43.5635025489192
0.714578337330136,0.757173309679526,1056,235,40,35,18,8,22,27,41.9202832822525,43.5635025489192
0.703922067639407,0.788007110709618,1050,241,28,96,10,24,18,72,41.9202832822525,43.5635025489192
0.728587130295763,0.766648198577673,1048,243,40,54,16,15,24,39,41.9202832822525,43.5635025489192
0.776099120703437,0.809027309669881,1057,234,40,33,21,8,19,25,41.9202832822525,43.5635025489192
0.723315444245677,0.751444020128363,1043,248,43,36,22,12,21,24,41.9202832822525,43.5635025489192
0.730963791267306,0.785057302308767,1040,251,39,72,19,19,20,53,41.9202832822525,43.5635025489192
0.748317839752103,0.784556529780299,1060,231,36,81,16,21,20,60,41.9202832822525,43.5635025489192
0.822254765687053,0.857677001277775,1069,222,32,68,20,23,12,45,41.9202832822525,43.5635025489192
0.78154543964151,0.807697067046837,1047,244,29,57,15,17,14,40,41.9202832822525,43.5635025489192
0.733983676207513,0.789609672777852,1068,223,43,70,18,22,25,48,41.9202832822525,43.5635025489192
0.695660522273426,0.728865983553805,1037,254,31,51,16,19,15,32,41.9202832822525,43.5635025489192
0.752194025905366,0.784329671671193,1072,219,30,46,14,9,16,37,41.9202832822525,43.5635025489192
0.794346485522956,0.825460743067574,1059,232,33,49,18,16,15,33,41.9202832822525,43.5635025489192
0.790974129209423,0.827681214647143,1085,206,33,57,14,13,19,44,41.9202832822525,43.5635025489192
0.718171757414785,0.759057192972007,1056,235,36,42,18,13,18,29,41.9202832822525,43.5635025489192
0.749012895366909,0.780031113036141,1091,200,38,69,17,13,21,56,41.9202832822525,43.5635025489192
0.766199354434648,0.833052770634459,1063,228,33,52,22,16,11,36,41.9202832822525,43.5635025489192
0.79428811337757,0.827814925820325,1058,233,39,50,24,19,15,31,41.9202832822525,43.5635025489192
0.75965899775944,0.806473613671558,1054,237,29,50,15,16,14,34,41.9202832822525,43.5635025489192
0.657416775063834,0.701461740391984,1051,240,33,71,13,15,20,56,41.9202832822525,43.5635025489192
0.771817911040508,0.817661369112356,1065,226,32,31,19,12,13,19,41.9202832822525,43.5635025489192
0.773543495610535,0.794663684967064,1058,233,38,28,22,6,16,22,41.9202832822525,43.5635025489192
0.744990969042718,0.820666486486188,1077,214,38,116,18,27,20,89,41.9202832822525,43.5635025489192
0.632966740394856,0.671213445117354,1086,205,39,25,11,9,28,16,41.9202832822525,43.5635025489192
0.708561467546446,0.751778360418456,1075,216,34,33,13,6,21,27,41.9202832822525,43.5635025489192
0.775144420796595,0.806375101591789,1087,204,26,30,12,8,14,22,41.9202832822525,43.5635025489192
0.746920433518372,0.787018320913957,1087,204,30,21,15,6,15,15,41.9202832822525,43.5635025489192
0.726720039346412,0.797585558908048,1057,234,29,41,16,10,13,31,41.9202832822525,43.5635025489192
0.727365787079163,0.765230888046151,1092,199,35,34,15,8,20,26,41.9202832822525,43.5635025489192
0.683073541167066,0.736028862613059,1061,230,40,43,19,9,21,34,41.9202832822525,43.5635025489192
0.763919946332737,0.808541557135428,1056,235,43,66,25,22,18,44,41.9202832822525,43.5635025489192
0.819293404011148,0.871775361012621,1079,212,29,74,19,27,10,47,41.9202832822525,43.5635025489192
0.705787959274015,0.745726289640017,1070,221,36,62,18,19,18,43,41.9202832822525,43.5635025489192
0.795075456711676,0.828606497657434,1063,228,32,80,18,22,14,58,41.9202832822525,43.5635025489192
0.718979711849456,0.765004742962573,1075,216,38,51,15,14,23,37,41.9202832822525,43.5635025489192
0.710878048780488,0.77455873535633,1051,240,41,86,20,26,21,60,41.9202832822525,43.5635025489192
0.747626748435334,0.798906277371922,1062,229,38,88,18,28,20,60,41.9202832822525,43.5635025489192
0.838501189532117,0.852764963026242,1072,219,30,47,18,12,12,35,41.9202832822525,43.5635025489192
0.723550243470562,0.774744733716332,1065,226,36,84,17,22,19,62,41.9202832822525,43.5635025489192
0.738493217054264,0.814197375907088,1058,233,43,62,22,13,21,49,41.9202832822525,43.5635025489192
0.738125276671094,0.769673986527765,1070,221,36,28,13,7,23,21,41.9202832822525,43.5635025489192
0.648580249506448,0.704574861451557,1051,240,38,78,15,14,23,64,41.9202832822525,43.5635025489192
0.748923674481726,0.781215090255375,1050,241,34,60,16,17,18,43,41.9202832822525,43.5635025489192
0.688036122246648,0.731474417287566,1064,227,37,26,15,3,22,23,41.9202832822525,43.5635025489192
0.792845723421263,0.805354915637954,1065,226,40,59,19,21,21,38,41.9202832822525,43.5635025489192
0.721687959193224,0.795051931065389,1030,261,34,56,19,17,15,39,41.9202832822525,43.5635025489192
0.734562211981567,0.809878422242576,1067,224,31,78,15,19,16,59,41.9202832822525,43.5635025489192
0.671482926829268,0.714924134006522,1069,222,41,43,14,13,27,30,41.9202832822525,43.5635025489192
0.767561644957811,0.800541954187651,1071,220,39,63,18,18,21,45,41.9202832822525,43.5635025489192
0.724482295123283,0.762404502277521,1064,227,38,9,18,3,20,6,41.9202832822525,43.5635025489192
0.714078737010392,0.765374897084363,1050,241,40,79,18,23,22,56,41.9202832822525,43.5635025489192
0.720019322048137,0.759595154994089,1049,242,38,41,18,12,20,29,41.9202832822525,43.5635025489192
0.677044269149532,0.727332054071997,1076,215,37,39,15,9,22,30,41.9202832822525,43.5635025489192
0.835773556439446,0.863959861773348,1102,189,23,29,11,7,12,22,41.9202832822525,43.5635025489192
0.688357680389553,0.761418900003167,1061,230,36,45,16,14,20,31,41.9202832822525,43.5635025489192
0.814203805603394,0.840173743048658,1080,211,38,22,24,7,14,15,41.9202832822525,43.5635025489192
0.653427258193445,0.711284888688075,1070,221,40,63,16,13,24,50,41.9202832822525,43.5635025489192
0.730205401772588,0.778089738710877,1075,216,38,54,19,19,19,35,41.9202832822525,43.5635025489192
0.793404161133245,0.835722919506493,1058,233,36,78,19,21,17,57,41.9202832822525,43.5635025489192
0.744612928970471,0.774007095839675,1052,239,38,41,20,11,18,30,41.9202832822525,43.5635025489192
0.733551013716597,0.776647533364897,1050,241,29,39,13,15,16,24,41.9202832822525,43.5635025489192
0.782185911706641,0.821174282984211,1104,187,38,41,21,15,17,26,41.9202832822525,43.5635025489192
0.783089239849172,0.842676647166293,1103,188,29,69,15,21,14,48,41.9202832822525,43.5635025489192
0.673654591532498,0.719363146397925,1082,209,43,96,12,20,31,76,41.9202832822525,43.5635025489192
0.742313185197631,0.789646463532945,1061,230,38,23,20,5,18,18,41.9202832822525,43.5635025489192
0.689887748711278,0.720570053075109,1077,214,33,27,13,10,20,17,41.9202832822525,43.5635025489192
0.779363582208102,0.796338138854476,1073,218,32,42,16,9,16,33,41.9202832822525,43.5635025489192
0.745139876718824,0.794873427345618,1057,234,37,47,18,16,19,31,41.9202832822525,43.5635025489192
0.748937583001328,0.801807078036275,1081,210,36,65,16,16,20,49,41.9202832822525,43.5635025489192
0.767051238547676,0.806104986747248,1047,244,28,53,14,15,14,38,41.9202832822525,43.5635025489192
0.742675650308394,0.778964969316212,1041,250,48,60,27,20,21,40,41.9202832822525,43.5635025489192
0.753134796238245,0.788879639561577,1087,204,44,30,21,9,23,21,41.9202832822525,43.5635025489192
0.730936678305099,0.772999413484514,1059,232,37,70,18,21,19,49,41.9202832822525,43.5635025489192
0.685279057859703,0.72100339690425,1075,216,31,24,11,3,20,21,41.9202832822525,43.5635025489192
0.719780991155412,0.78627323308413,1072,219,34,89,16,27,18,62,41.9202832822525,43.5635025489192
0.719997737812465,0.772487122345748,1080,211,28,80,13,19,15,61,41.9202832822525,43.5635025489192
0.738685175484547,0.781068187269767,1060,231,46,51,22,9,24,42,41.9202832822525,43.5635025489192
0.715869853917663,0.772686163484668,1091,200,36,82,17,16,19,66,41.9202832822525,43.5635025489192
0.717613335260394,0.764156684684722,1060,231,33,36,19,14,14,22,41.9202832822525,43.5635025489192
0.74614587849882,0.806307196711132,1087,204,33,54,17,13,16,41,41.9202832822525,43.5635025489192
0.77412172598508,0.821818617511499,1067,224,49,106,23,29,26,77,41.9202832822525,43.5635025489192
0.768391719745223,0.812547586423455,1059,232,35,95,16,25,19,70,41.9202832822525,43.5635025489192
0.739084945141952,0.770856347598855,1081,210,28,26,13,7,15,19,41.9202832822525,43.5635025489192
0.722016826054093,0.754355205987849,1094,197,49,47,17,8,32,39,41.9202832822525,43.5635025489192
0.743278048780488,0.799223259743558,1051,240,41,33,21,11,20,22,41.9202832822525,43.5635025489192
0.676771954751626,0.734931220773946,1066,225,29,32,12,11,17,21,41.9202832822525,43.5635025489192
0.777953963120091,0.801959872296732,1080,211,38,30,19,10,19,20,41.9202832822525,43.5635025489192
0.748506476341528,0.788597458285358,1061,230,30,53,17,11,13,42,41.9202832822525,43.5635025489192
0.747899777376402,0.800495244098094,1066,225,38,40,21,11,17,29,41.9202832822525,43.5635025489192
0.772498893315626,0.82435242564342,1050,241,36,51,20,9,16,42,41.9202832822525,43.5635025489192
0.681310803891449,0.715592868110746,1059,232,31,42,11,4,20,38,41.9202832822525,43.5635025489192
0.708363086487168,0.769633058527352,1047,244,38,70,18,25,20,45,41.9202832822525,43.5635025489192
0.743254019569809,0.798633505602276,1066,225,37,73,17,22,20,51,41.9202832822525,43.5635025489192
0.743576526566217,0.816882727396877,1060,231,30,81,16,21,14,60,41.9202832822525,43.5635025489192
0.692104348689436,0.741508504426284,1058,233,32,70,15,16,17,54,41.9202832822525,43.5635025489192
0.721816736522619,0.778886255251203,1078,213,33,74,14,14,19,60,41.9202832822525,43.5635025489192
0.815926520420902,0.849850039087416,1076,215,45,46,23,20,22,26,41.9202832822525,43.5635025489192
0.713812705110173,0.754977712022966,1087,204,27,98,11,18,16,80,41.9202832822525,43.5635025489192
0.763315411433612,0.787138634260523,1060,231,38,46,21,15,17,31,41.9202832822525,43.5635025489192
0.738053145731574,0.777932290887222,1089,202,44,53,21,16,23,37,41.9202832822525,43.5635025489192
0.753107513988809,0.79081082016075,1064,227,40,39,21,11,19,28,41.9202832822525,43.5635025489192
0.701382677400119,0.757052930720419,1078,213,43,66,15,15,28,51,41.9202832822525,43.5635025489192
0.749120778532543,0.795285046250358,1081,210,33,27,16,11,17,16,41.9202832822525,43.5635025489192
0.68170076028059,0.72717558405436,1074,217,38,52,13,9,25,43,41.9202832822525,43.5635025489192
0.636708478813742,0.708785639698017,1066,225,37,76,15,18,22,58,41.9202832822525,43.5635025489192
0.712248498340824,0.75023669006604,1087,204,38,51,15,10,23,41,41.9202832822525,43.5635025489192
0.734623212867355,0.765482755103193,1096,195,32,38,13,11,19,27,41.9202832822525,43.5635025489192
0.765797362110312,0.810014288824802,1061,230,40,57,20,16,20,41,41.9202832822525,43.5635025489192
0.683604795837575,0.715341078177136,1058,233,28,26,11,7,17,19,41.9202832822525,43.5635025489192
0.772322620000762,0.822148660644305,1066,225,42,44,24,16,18,28,41.9202832822525,43.5635025489192
0.776583598093725,0.803971409943483,1085,206,32,44,14,16,18,28,41.9202832822525,43.5635025489192
0.680031083294829,0.726394496312502,1051,240,38,60,13,13,25,47,41.9202832822525,43.5635025489192
0.67678046110693,0.735348339163507,1081,210,47,69,21,17,26,52,41.9202832822525,43.5635025489192
0.767800588168759,0.794917082655154,1085,206,28,34,14,6,14,28,41.9202832822525,43.5635025489192
0.74524299575755,0.785733257229856,1069,222,38,57,18,17,20,40,41.9202832822525,43.5635025489192
0.740301371145117,0.76801335429113,1084,207,34,66,13,18,21,48,41.9202832822525,43.5635025489192
0.749900398406375,0.804612286452394,1073,218,36,63,16,12,20,51,41.9202832822525,43.5635025489192
0.776840520035076,0.836785404795775,1064,227,42,54,26,22,16,32,41.9202832822525,43.5635025489192
0.756657705716806,0.795615464727149,1050,241,38,32,21,14,17,18,41.9202832822525,43.5635025489192
0.747767929089444,0.781379319124458,1073,218,50,75,23,21,27,54,41.9202832822525,43.5635025489192
0.782654686078253,0.858110672275665,1092,199,35,84,21,23,14,61,41.9202832822525,43.5635025489192
0.754049135577798,0.77678996173553,1063,228,35,27,17,7,18,20,41.9202832822525,43.5635025489192
0.761141087130296,0.808232556642221,1053,238,40,64,19,21,21,43,41.9202832822525,43.5635025489192
0.760128928283642,0.82214355002415,1061,230,50,70,28,24,22,46,41.9202832822525,43.5635025489192
0.702727859412232,0.775585561540337,1052,239,32,40,14,11,18,29,41.9202832822525,43.5635025489192
0.727686982878676,0.789759007843853,1066,225,39,48,20,15,19,33,41.9202832822525,43.5635025489192
0.782500945100181,0.835027183025088,1064,227,38,102,22,25,16,77,41.9202832822525,43.5635025489192
0.712581991651759,0.768706422327218,1080,211,43,117,15,23,28,94,41.9202832822525,43.5635025489192
0.748855378670139,0.801153281411691,1067,224,38,80,19,24,19,56,41.9202832822525,43.5635025489192
0.726691642840711,0.761519127367464,1076,215,49,34,24,14,25,20,41.9202832822525,43.5635025489192
0.756051351657052,0.822815064345548,1076,215,28,90,15,24,13,66,41.9202832822525,43.5635025489192
0.682604853657485,0.721469215515941,1080,211,37,30,13,8,24,22,41.9202832822525,43.5635025489192
0.739493733103957,0.76826910575648,1074,217,39,56,19,17,20,39,41.9202832822525,43.5635025489192
0.717098795772917,0.742365792410782,1052,239,39,76,12,14,27,62,41.9202832822525,43.5635025489192
0.745226730310262,0.765648477806696,1073,218,34,28,13,9,21,19,41.9202832822525,43.5635025489192
0.739201355981629,0.793714716095029,1052,239,44,86,27,25,17,61,41.9202832822525,43.5635025489192
0.774535841938046,0.80168465764523,1073,218,32,50,16,13,16,37,41.9202832822525,43.5635025489192
0.690237904609402,0.72804991657584,1041,250,42,41,20,9,22,32,41.9202832822525,43.5635025489192
0.731545373312152,0.76380760600876,1080,211,32,104,10,20,22,84,41.9202832822525,43.5635025489192
0.707258536585366,0.745977749525061,1073,218,41,59,17,14,24,45,41.9202832822525,43.5635025489192
0.723385365853659,0.751375805051293,1050,241,41,22,15,9,26,13,41.9202832822525,43.5635025489192
0.768576469105725,0.810361025823161,1084,207,38,32,20,9,18,23,41.9202832822525,43.5635025489192
0.727369080310257,0.775285648645354,1065,226,33,45,15,15,18,30,41.9202832822525,43.5635025489192
0.756067071856546,0.801910432034231,1066,225,37,70,20,21,17,49,41.9202832822525,43.5635025489192
0.745814634146342,0.779938818754086,1062,229,41,26,16,8,25,18,41.9202832822525,43.5635025489192
0.755323868677906,0.774054112085386,1079,212,49,20,21,5,28,15,41.9202832822525,43.5635025489192
0.809584505391467,0.842203981067883,1062,229,27,18,16,6,11,12,41.9202832822525,43.5635025489192
0.683541004765687,0.725930131477288,1067,224,32,77,12,18,20,59,41.9202832822525,43.5635025489192
0.764525508855406,0.814715913723403,1066,225,30,45,13,9,17,36,41.9202832822525,43.5635025489192
0.694548826901768,0.739764599174953,1066,225,33,66,13,20,20,46,41.9202832822525,43.5635025489192
0.671657813191678,0.727618945223198,1055,236,36,75,14,17,22,58,41.9202832822525,43.5635025489192
0.731662230109435,0.773259002947035,1064,227,49,86,23,25,26,61,41.9202832822525,43.5635025489192
0.735130328981234,0.770943468235961,1082,209,34,33,15,8,19,25,41.9202832822525,43.5635025489192
0.739399947131906,0.795156632520322,1074,217,30,63,10,13,20,50,41.9202832822525,43.5635025489192
0.676212479403969,0.724828304876341,1093,198,22,64,4,7,18,57,41.9202832822525,43.5635025489192
0.815597446032229,0.857159611952557,1054,237,26,93,17,27,9,66,41.9202832822525,43.5635025489192
0.767794468622771,0.806663957386353,1049,242,34,71,17,19,17,52,41.9202832822525,43.5635025489192
0.729091390856097,0.770421729566516,1082,209,33,27,11,7,22,20,41.9202832822525,43.5635025489192
0.752655716224437,0.780446278797669,1073,218,34,27,16,6,18,21,41.9202832822525,43.5635025489192
0.747492657067125,0.775576038945289,1073,218,22,23,8,4,14,19,41.9202832822525,43.5635025489192
0.76712040725985,0.795180228104289,1087,204,36,60,19,15,17,45,41.9202832822525,43.5635025489192
0.690868232032596,0.718404648291171,1088,203,38,55,10,9,28,46,41.9202832822525,43.5635025489192
0.778212422949265,0.833484620493558,1079,212,37,135,18,29,19,106,41.9202832822525,43.5635025489192
0.724292889241343,0.764686244044648,1068,223,30,27,15,11,15,16,41.9202832822525,43.5635025489192
0.789051012328922,0.814390666625483,1070,221,28,81,15,21,13,60,41.9202832822525,43.5635025489192
0.786252830370478,0.825891258397609,1077,214,33,54,21,20,12,34,41.9202832822525,43.5635025489192
0.73851030110935,0.769253436316714,1075,216,29,17,12,5,17,12,41.9202832822525,43.5635025489192
0.751551791025475,0.772770045684507,1068,223,37,42,18,11,19,31,41.9202832822525,43.5635025489192
0.832188100893564,0.846017438724096,1070,221,28,46,18,15,10,31,41.9202832822525,43.5635025489192
0.676712731549544,0.763535065247805,1094,197,38,129,16,32,22,97,41.9202832822525,43.5635025489192
0.776489990900819,0.80069955077658,1054,237,35,26,21,10,14,16,41.9202832822525,43.5635025489192
0.717325577574025,0.756544968940521,1079,212,49,39,22,15,27,24,41.9202832822525,43.5635025489192
0.786363103609939,0.806747454639862,1051,240,27,54,17,19,10,35,41.9202832822525,43.5635025489192
0.727499503574265,0.796820089008242,1071,220,32,128,12,27,20,101,41.9202832822525,43.5635025489192
0.73365691816171,0.785397259236453,1093,198,39,82,17,18,22,64,41.9202832822525,43.5635025489192
0.718407578084997,0.79255549746219,1058,233,31,64,14,16,17,48,41.9202832822525,43.5635025489192
0.747023019034971,0.776722670121705,1094,197,36,42,13,12,23,30,41.9202832822525,43.5635025489192
0.74057859703021,0.778594368463152,1085,206,31,30,12,9,19,21,41.9202832822525,43.5635025489192
0.679892275615568,0.717468351197458,1087,204,32,53,11,11,21,42,41.9202832822525,43.5635025489192
0.781092682926829,0.812331589737355,1065,226,41,62,19,19,22,43,41.9202832822525,43.5635025489192
0.719098598995506,0.780459764328991,1054,237,30,47,13,10,17,37,41.9202832822525,43.5635025489192
0.740049182202905,0.776324159425318,1073,218,42,59,15,11,27,48,41.9202832822525,43.5635025489192
0.731444533120511,0.76767203615402,1061,230,38,34,18,10,20,24,41.9202832822525,43.5635025489192
0.763517665130568,0.816727585535866,1087,204,31,24,17,12,14,12,41.9202832822525,43.5635025489192
0.709734203066419,0.740850480873942,1056,235,53,43,22,9,31,34,41.9202832822525,43.5635025489192
0.784802158273381,0.82549983861087,1081,210,40,75,20,25,20,50,41.9202832822525,43.5635025489192
0.670933253397282,0.718248701323524,1072,219,40,82,17,19,23,63,41.9202832822525,43.5635025489192
0.727759942928482,0.800663326938648,1074,217,45,127,19,33,26,94,41.9202832822525,43.5635025489192
0.728481822836661,0.770854937276312,1085,206,31,52,12,11,19,41,41.9202832822525,43.5635025489192
0.746156097560976,0.801524955037899,1076,215,41,112,19,26,22,86,41.9202832822525,43.5635025489192
0.710854397803958,0.734824121176495,1090,201,42,46,17,14,25,32,41.9202832822525,43.5635025489192
0.747941646682654,0.779011446750494,1071,220,40,55,21,18,19,37,41.9202832822525,43.5635025489192
0.752024255395042,0.813185501036688,1067,224,45,94,21,26,24,68,41.9202832822525,43.5635025489192
0.755565589952535,0.792199641503879,1065,226,38,36,19,13,19,23,41.9202832822525,43.5635025489192
0.744171292624901,0.795396488661388,1093,198,30,60,15,16,15,44,41.9202832822525,43.5635025489192
0.746569278441788,0.796017234059881,1074,217,36,47,20,22,16,25,41.9202832822525,43.5635025489192
0.773052464228935,0.85011252494195,1070,221,33,65,19,22,14,43,41.9202832822525,43.5635025489192
0.753536162263144,0.816538413978297,1066,225,42,59,25,21,17,38,41.9202832822525,43.5635025489192
0.773417482253119,0.82280349872246,1043,248,38,71,22,23,16,48,41.9202832822525,43.5635025489192
0.739437298260828,0.781019241235603,1092,199,33,54,12,15,21,39,41.9202832822525,43.5635025489192
0.806041313732991,0.833883608749533,1082,209,29,47,15,14,14,33,41.9202832822525,43.5635025489192
0.698262856157593,0.727335821750059,1073,218,37,31,17,9,20,22,41.9202832822525,43.5635025489192
0.675280898876404,0.717280934603742,1065,226,45,47,16,13,29,34,41.9202832822525,43.5635025489192
0.771143213839843,0.812433885292758,1027,264,45,59,25,17,20,42,41.9202832822525,43.5635025489192
0.69722140546898,0.744854013865987,1080,211,38,38,17,9,21,29,41.9202832822525,43.5635025489192
0.748727312970341,0.78232312550122,1070,221,36,56,19,22,17,34,41.9202832822525,43.5635025489192
0.764877072080462,0.794131112771865,1051,240,52,71,26,22,26,49,41.9202832822525,43.5635025489192
0.733928216838761,0.776443066926874,1068,223,32,33,14,10,18,23,41.9202832822525,43.5635025489192
0.739853533094812,0.765277283024631,1061,230,43,29,19,9,24,20,41.9202832822525,43.5635025489192
0.771176020547571,0.81149615236679,1081,210,29,16,15,4,14,12,41.9202832822525,43.5635025489192
0.729128753412193,0.778843230399667,1066,225,35,60,15,14,20,46,41.9202832822525,43.5635025489192
0.787403993855607,0.813093372519234,1078,213,31,93,12,15,19,78,41.9202832822525,43.5635025489192
0.711454878188265,0.772265826044733,1067,224,42,91,20,23,22,68,41.9202832822525,43.5635025489192
0.801006519091625,0.836133826091177,1108,183,22,16,11,4,11,12,41.9202832822525,43.5635025489192
0.79566346922462,0.817635294070421,1058,233,40,52,20,19,20,33,41.9202832822525,43.5635025489192
0.759158195113251,0.796121820270084,1062,229,45,88,21,20,24,68,41.9202832822525,43.5635025489192
0.779797837989611,0.862767392584028,1058,233,34,117,21,24,13,93,41.9202832822525,43.5635025489192
0.649422462521504,0.692278295731047,1066,225,39,42,13,12,26,30,41.9202832822525,43.5635025489192
0.766444743142773,0.815954869166877,1081,210,38,38,20,11,18,27,41.9202832822525,43.5635025489192
0.737463851937536,0.772041362283421,1051,240,56,77,26,20,30,57,41.9202832822525,43.5635025489192
0.765910913465043,0.800656379318248,1065,226,44,44,22,13,22,31,41.9202832822525,43.5635025489192
0.742963165210484,0.786457643958011,1059,232,32,41,16,15,16,26,41.9202832822525,43.5635025489192
0.742704203013481,0.8130880463126,1046,245,30,59,18,15,12,44,41.9202832822525,43.5635025489192
0.744256217940429,0.78763414387857,1025,266,37,83,15,16,22,67,41.9202832822525,43.5635025489192
0.778400818926297,0.806442774453672,1065,226,35,32,17,7,18,25,41.9202832822525,43.5635025489192
0.726975945017182,0.77632284402792,1057,234,30,54,12,10,18,44,41.9202832822525,43.5635025489192
0.808093346573982,0.8287240044232,1100,191,19,54,9,8,10,46,41.9202832822525,43.5635025489192
0.711685151387524,0.768746660638493,1074,217,34,76,14,19,20,57,41.9202832822525,43.5635025489192
0.725384903364687,0.753158153955873,1064,227,34,58,15,16,19,42,41.9202832822525,43.5635025489192
0.71481974432285,0.760922779005397,1051,240,49,67,26,22,23,45,41.9202832822525,43.5635025489192
0.74900153609831,0.770321916961193,1055,236,31,28,10,7,21,21,41.9202832822525,43.5635025489192
0.757293050022134,0.806422592865002,1056,235,36,56,20,18,16,38,41.9202832822525,43.5635025489192
0.748262509928515,0.806308121948545,1077,214,32,38,16,11,16,27,41.9202832822525,43.5635025489192
0.733863281101071,0.777663456492316,1053,238,42,88,18,15,24,73,41.9202832822525,43.5635025489192
0.7607910906298,0.776528681748699,1065,226,31,31,14,9,17,22,41.9202832822525,43.5635025489192
0.68338480308056,0.723647922169598,1063,228,42,43,16,11,26,32,41.9202832822525,43.5635025489192
0.728970949559185,0.787756422193608,1086,205,33,57,17,14,16,43,41.9202832822525,43.5635025489192
0.803377233728619,0.849820651549008,1083,208,29,33,15,7,14,26,41.9202832822525,43.5635025489192
0.783171211541614,0.807660690490855,1070,221,29,37,17,12,12,25,41.9202832822525,43.5635025489192
0.759830637599625,0.824579750963818,1062,229,27,34,13,12,14,22,41.9202832822525,43.5635025489192
0.737032770097286,0.784920167423565,1054,237,31,46,14,9,17,37,41.9202832822525,43.5635025489192
0.769036116862204,0.810787270162733,1055,236,49,62,26,25,23,37,41.9202832822525,43.5635025489192
0.744415210484511,0.788991997557367,1079,212,32,30,16,8,16,22,41.9202832822525,43.5635025489192
0.731566820276498,0.790410503552235,1056,235,31,77,14,19,17,58,41.9202832822525,43.5635025489192
0.717384017162778,0.747834329890828,1058,233,48,76,19,21,29,55,41.9202832822525,43.5635025489192
0.727174981567953,0.766926724853685,1030,261,39,41,19,14,20,27,41.9202832822525,43.5635025489192
0.763099520383693,0.826739657186011,1059,232,40,63,20,22,20,41,41.9202832822525,43.5635025489192
0.68787534121929,0.727712650708582,1080,211,35,39,14,6,21,33,41.9202832822525,43.5635025489192
0.758199165175909,0.798468963316927,1080,211,43,49,20,9,23,40,41.9202832822525,43.5635025489192
0.752816180235535,0.78568220754517,1066,225,31,51,15,14,16,37,41.9202832822525,43.5635025489192
0.779419595314164,0.80140770260958,1075,216,39,31,19,11,20,20,41.9202832822525,43.5635025489192
0.672965746495158,0.71670096451921,1076,215,33,76,11,15,22,61,41.9202832822525,43.5635025489192
0.730582886106142,0.756477016225799,1089,202,43,43,15,11,28,32,41.9202832822525,43.5635025489192
0.734158230221222,0.806202550919086,1074,217,21,36,10,11,11,25,41.9202832822525,43.5635025489192
0.74452833389888,0.776427923880885,1063,228,28,24,12,4,16,20,41.9202832822525,43.5635025489192
0.752583290151492,0.80530191017534,1056,235,53,78,29,22,24,56,41.9202832822525,43.5635025489192
0.72281273040059,0.76275197109235,1082,209,39,35,17,9,22,26,41.9202832822525,43.5635025489192
0.682702523240372,0.708626563657617,1085,206,36,43,11,5,25,38,41.9202832822525,43.5635025489192
0.832159361955874,0.858672562586982,1077,214,43,45,26,15,17,30,41.9202832822525,43.5635025489192
0.729708826205641,0.788777053790284,1085,206,35,41,16,7,19,34,41.9202832822525,43.5635025489192
0.656319569874407,0.706604509774778,1098,193,38,66,15,13,23,53,41.9202832822525,43.5635025489192
0.753811904061831,0.790622774074251,1046,245,38,55,22,23,16,32,41.9202832822525,43.5635025489192
0.712160271782574,0.761484550879318,1084,207,40,42,17,7,23,35,41.9202832822525,43.5635025489192
0.786714944609681,0.817167506869526,1069,222,37,49,16,12,21,37,41.9202832822525,43.5635025489192
0.694436854472922,0.768889388501121,1055,236,29,84,12,22,17,62,41.9202832822525,43.5635025489192
0.764859437751004,0.814770154674226,1067,224,46,62,26,18,20,44,41.9202832822525,43.5635025489192
0.7591947947802,0.813148882499028,1053,238,44,54,24,23,20,31,41.9202832822525,43.5635025489192
0.770953237410072,0.808232618033435,1069,222,40,38,21,15,19,23,41.9202832822525,43.5635025489192
0.758466135458167,0.78569370191146,1041,250,36,54,18,19,18,35,41.9202832822525,43.5635025489192
0.740039731719764,0.773695456389207,1071,220,44,60,20,14,24,46,41.9202832822525,43.5635025489192
0.788212854002328,0.832036279398722,1052,239,37,40,19,12,18,28,41.9202832822525,43.5635025489192
0.785578359107771,0.822216145795009,1071,220,33,18,16,7,17,11,41.9202832822525,43.5635025489192
0.714195121951219,0.759000422065012,1043,248,41,46,20,14,21,32,41.9202832822525,43.5635025489192
0.767211118274948,0.802527716499443,1068,223,22,23,14,8,8,15,41.9202832822525,43.5635025489192
0.745122684299689,0.769482678753519,1097,194,29,50,12,7,17,43,41.9202832822525,43.5635025489192
0.784427666553557,0.807325576800965,1072,219,28,41,16,10,12,31,41.9202832822525,43.5635025489192
0.736968014803066,0.774815075791733,1045,246,30,18,16,5,14,13,41.9202832822525,43.5635025489192
0.75213590084108,0.801140274961752,1072,219,36,50,19,14,17,36,41.9202832822525,43.5635025489192
0.746033974448968,0.785384489796966,1065,226,34,35,16,10,18,25,41.9202832822525,43.5635025489192
0.637567196614434,0.694612028725355,1066,225,42,114,18,23,24,91,41.9202832822525,43.5635025489192
0.698595068403375,0.762624631272147,1066,225,39,106,19,21,20,85,41.9202832822525,43.5635025489192
0.749863482922955,0.789724225862303,1076,215,32,62,19,16,13,46,41.9202832822525,43.5635025489192
0.741501453872588,0.777583506208596,1064,227,30,57,14,13,16,44,41.9202832822525,43.5635025489192
0.740604249667995,0.798236632108375,1073,218,36,53,18,15,18,38,41.9202832822525,43.5635025489192
0.798271889400922,0.823013329736758,1083,208,31,48,13,10,18,38,41.9202832822525,43.5635025489192
0.757350779182593,0.802851110783212,1078,213,38,44,19,16,19,28,41.9202832822525,43.5635025489192
0.700348635874398,0.767742048292158,1057,234,34,74,17,17,17,57,41.9202832822525,43.5635025489192
0.795348130130739,0.817491926176833,1062,229,26,69,14,12,12,57,41.9202832822525,43.5635025489192
0.702335104028331,0.748176430426276,1070,221,36,47,11,8,25,39,41.9202832822525,43.5635025489192
0.736790567545963,0.77823397688364,1070,221,40,52,17,14,23,38,41.9202832822525,43.5635025489192
0.822276869114339,0.842555500282793,1049,242,42,62,26,15,16,47,41.9202832822525,43.5635025489192
0.782338072669826,0.840156358104252,1061,230,25,44,15,9,10,35,41.9202832822525,43.5635025489192
0.740681291243089,0.788262197321519,1048,243,45,25,27,9,18,16,41.9202832822525,43.5635025489192
0.71648591234347,0.768335604002975,1070,221,43,28,17,8,26,20,41.9202832822525,43.5635025489192
0.755394792024096,0.807257108813618,1083,208,42,54,16,15,26,39,41.9202832822525,43.5635025489192
0.752433521353747,0.804252798468152,1085,206,50,91,27,30,23,61,41.9202832822525,43.5635025489192
0.683654870156468,0.730177333186388,1069,222,39,52,16,15,23,37,41.9202832822525,43.5635025489192
0.773070803500398,0.815976055442572,1083,208,34,35,20,15,14,20,41.9202832822525,43.5635025489192
0.759362549800797,0.806147377559401,1067,224,36,85,15,21,21,64,41.9202832822525,43.5635025489192
0.801548875078287,0.828937744756584,1052,239,33,18,21,4,12,14,41.9202832822525,43.5635025489192
0.735954875100725,0.769882223592563,1061,230,50,46,23,14,27,32,41.9202832822525,43.5635025489192
0.749141463414634,0.776941183342201,1023,268,41,56,18,15,23,41,41.9202832822525,43.5635025489192
0.751852166044565,0.821910753325133,1064,227,28,58,15,14,13,44,41.9202832822525,43.5635025489192
0.776675268288687,0.820475008167057,1068,223,39,40,20,9,19,31,41.9202832822525,43.5635025489192
0.75376713931396,0.792578929477547,1061,230,34,29,20,13,14,16,41.9202832822525,43.5635025489192
0.74106435923538,0.787946811012685,1081,210,28,54,12,13,16,41,41.9202832822525,43.5635025489192
0.824921615424213,0.871971267201922,1070,221,34,95,22,33,12,62,41.9202832822525,43.5635025489192
0.748655913978495,0.824915832186685,1086,205,31,86,11,17,20,69,41.9202832822525,43.5635025489192
0.728468489076976,0.779967551903051,1055,236,42,39,22,10,20,29,41.9202832822525,43.5635025489192
0.714682149586303,0.743837696646338,1035,256,39,103,15,23,24,80,41.9202832822525,43.5635025489192
0.825517556902665,0.849451481510263,1078,213,42,35,25,14,17,21,41.9202832822525,43.5635025489192
0.732682841068917,0.774026022005754,1056,235,27,72,15,18,12,54,41.9202832822525,43.5635025489192
0.672448780487805,0.71967535005692,1074,217,41,64,14,17,27,47,41.9202832822525,43.5635025489192
0.793868272302777,0.842523965610056,1055,236,39,86,22,18,17,68,41.9202832822525,43.5635025489192
0.721034146341463,0.758147630354745,1070,221,41,42,20,11,21,31,41.9202832822525,43.5635025489192
0.731454478412443,0.781361490675516,1074,217,48,47,24,17,24,30,41.9202832822525,43.5635025489192
0.677462273091784,0.720647636111764,1059,232,44,72,15,15,29,57,41.9202832822525,43.5635025489192
0.734262589928057,0.78194941800863,1050,241,40,81,18,18,22,63,41.9202832822525,43.5635025489192
0.689289099526066,0.772687224521734,1065,226,25,34,12,12,13,22,41.9202832822525,43.5635025489192
0.792516588842467,0.833649453139126,1092,199,39,58,21,8,18,50,41.9202832822525,43.5635025489192
0.724752703013572,0.774051870438506,1068,223,49,36,24,10,25,26,41.9202832822525,43.5635025489192
0.770216201038888,0.810823839353216,1053,238,34,78,18,26,16,52,41.9202832822525,43.5635025489192
0.725189848121503,0.760213860005219,1080,211,40,34,18,10,22,24,41.9202832822525,43.5635025489192
0.7057137351255,0.753647414896244,1077,214,33,46,13,13,20,33,41.9202832822525,43.5635025489192
0.771592725819345,0.820229928188378,1049,242,40,64,22,17,18,47,41.9202832822525,43.5635025489192
0.720613148259468,0.763038084832868,1079,212,29,21,11,7,18,14,41.9202832822525,43.5635025489192
0.706252766710934,0.732288135048351,1085,206,36,62,12,11,24,51,41.9202832822525,43.5635025489192
0.732514386896857,0.781032000459255,1051,240,36,57,19,15,17,42,41.9202832822525,43.5635025489192
0.694101372288623,0.753528081910007,1077,214,36,77,14,16,22,61,41.9202832822525,43.5635025489192
0.762162110640894,0.81379344168859,1073,218,42,62,22,19,20,43,41.9202832822525,43.5635025489192
0.690634484752132,0.726737370950965,1053,238,33,25,16,9,17,16,41.9202832822525,43.5635025489192
0.686578688754738,0.742216035183416,1081,210,34,37,14,6,20,31,41.9202832822525,43.5635025489192
0.728216308884913,0.77339372674829,1068,223,43,47,18,9,25,38,41.9202832822525,43.5635025489192
0.723290442516585,0.762932371946413,1066,225,44,49,20,15,24,34,41.9202832822525,43.5635025489192
0.674571966904235,0.719304242362811,1084,207,39,38,14,5,25,33,41.9202832822525,43.5635025489192
0.826406202493159,0.87077127743969,1083,208,26,33,12,8,14,25,41.9202832822525,43.5635025489192
0.716193407466243,0.76620034746989,1059,232,32,44,13,12,19,32,41.9202832822525,43.5635025489192
0.755113185067514,0.808945580369368,1045,246,32,51,18,16,14,35,41.9202832822525,43.5635025489192
0.748176111299627,0.795025192817184,1060,231,28,45,13,10,15,35,41.9202832822525,43.5635025489192
0.715230006083579,0.763030971404185,1065,226,34,72,12,19,22,53,41.9202832822525,43.5635025489192
0.754227534307215,0.78643067247332,1069,222,36,47,17,15,19,32,41.9202832822525,43.5635025489192
0.756772935622905,0.807831827767719,1068,223,47,75,23,20,24,55,41.9202832822525,43.5635025489192
0.695201923602383,0.731330496725365,1103,188,29,78,10,14,19,64,41.9202832822525,43.5635025489192
0.77300428771017,0.808925177915639,1087,204,33,30,18,12,15,18,41.9202832822525,43.5635025489192
0.747638841759982,0.793809359017387,1066,225,28,72,11,15,17,57,41.9202832822525,43.5635025489192
0.735135799770479,0.778760710291547,1065,226,29,44,10,9,19,35,41.9202832822525,43.5635025489192
0.740047770700637,0.788565145570114,1060,231,35,85,17,24,18,61,41.9202832822525,43.5635025489192
0.70671149618518,0.749423206459915,1073,218,37,38,16,11,21,27,41.9202832822525,43.5635025489192
0.716826350277998,0.765748224488908,1081,210,32,98,13,22,19,76,41.9202832822525,43.5635025489192
0.690207373271889,0.741120661151445,1061,230,31,27,15,12,16,15,41.9202832822525,43.5635025489192
0.714466811544474,0.763644555557986,1082,209,42,44,18,10,24,34,41.9202832822525,43.5635025489192
0.74839626933576,0.788511288765288,1061,230,35,34,16,9,19,25,41.9202832822525,43.5635025489192
0.777798861480076,0.814671342490779,1064,227,51,51,28,14,23,37,41.9202832822525,43.5635025489192
0.746959158195113,0.807016264499726,1068,223,45,81,24,24,21,57,41.9202832822525,43.5635025489192
0.645480052428934,0.690668694038929,1056,235,39,51,15,17,24,34,41.9202832822525,43.5635025489192
0.724721215023603,0.758551490512842,1030,261,47,47,23,13,24,34,41.9202832822525,43.5635025489192
0.777901136664023,0.821751087214951,1077,214,30,26,16,8,14,18,41.9202832822525,43.5635025489192
0.726960213802319,0.760930546638906,1048,243,37,35,17,8,20,27,41.9202832822525,43.5635025489192
0.785696731383632,0.833726994374951,1079,212,39,65,19,13,20,52,41.9202832822525,43.5635025489192
0.663110112780195,0.70590061907479,1063,228,34,46,12,11,22,35,41.9202832822525,43.5635025489192
0.75642668122821,0.803091741395088,1059,232,38,42,22,19,16,23,41.9202832822525,43.5635025489192
0.805508883941698,0.84483304593526,1083,208,38,75,21,22,17,53,41.9202832822525,43.5635025489192
0.743614431164232,0.792680269973584,1070,221,36,76,15,24,21,52,41.9202832822525,43.5635025489192
0.729906075139888,0.776827712612633,1077,214,40,83,18,25,22,58,41.9202832822525,43.5635025489192
0.700359122271236,0.738102158412116,1083,208,28,50,11,12,17,38,41.9202832822525,43.5635025489192
0.745468831849136,0.769221952994296,1060,231,46,49,24,18,22,31,41.9202832822525,43.5635025489192
0.705251102816423,0.758359186675545,1073,218,28,76,12,18,16,58,41.9202832822525,43.5635025489192
0.762605472270009,0.810920276615876,1049,242,39,58,22,15,17,43,41.9202832822525,43.5635025489192
0.74335183716627,0.820591585733999,1074,217,30,53,16,18,14,35,41.9202832822525,43.5635025489192
0.717604066030999,0.757612495946836,1071,220,38,45,15,10,23,35,41.9202832822525,43.5635025489192
0.713535031847134,0.751693935868881,1076,215,35,78,11,19,24,59,41.9202832822525,43.5635025489192
0.777914268332632,0.828681720715164,1076,215,34,70,19,15,15,55,41.9202832822525,43.5635025489192
0.759727562522594,0.805685300592858,1069,222,49,48,29,19,20,29,41.9202832822525,43.5635025489192
0.66672322135505,0.717357069358286,1081,210,28,56,11,15,17,41,41.9202832822525,43.5635025489192
0.675768049155146,0.725246269051578,1044,247,31,52,14,16,17,36,41.9202832822525,43.5635025489192
0.784614634146341,0.817452031194892,1042,249,41,86,25,29,16,57,41.9202832822525,43.5635025489192
0.75107453907929,0.80621389504647,1100,191,28,94,11,23,17,71,41.9202832822525,43.5635025489192
0.758355861391005,0.793787959972815,1086,205,39,35,17,14,22,21,41.9202832822525,43.5635025489192
0.707675282802339,0.774228989633767,1070,221,29,71,14,17,15,54,41.9202832822525,43.5635025489192
0.704637007525454,0.740491522894416,1084,207,36,56,14,12,22,44,41.9202832822525,43.5635025489192
0.749888193202147,0.799192274912719,1068,223,43,51,22,14,21,37,41.9202832822525,43.5635025489192
0.757518796992481,0.792631300082832,1095,196,38,35,19,15,19,20,41.9202832822525,43.5635025489192
0.712328463922089,0.738980542227395,1082,209,36,45,12,8,24,37,41.9202832822525,43.5635025489192
0.752787037543035,0.808010657122945,1075,216,29,76,17,23,12,53,41.9202832822525,43.5635025489192
0.767213484066519,0.799873352996984,1072,219,39,35,18,10,21,25,41.9202832822525,43.5635025489192
0.684805223550243,0.732998010639684,1068,223,36,26,11,7,25,19,41.9202832822525,43.5635025489192
0.778277009728623,0.814660401602864,1074,217,31,43,17,13,14,30,41.9202832822525,43.5635025489192
0.750429268292683,0.797954130421607,1083,208,41,83,18,26,23,57,41.9202832822525,43.5635025489192
0.750045495905368,0.805709358139834,1036,255,35,47,21,15,14,32,41.9202832822525,43.5635025489192
0.74790308437226,0.803222517206699,1086,205,42,85,22,17,20,68,41.9202832822525,43.5635025489192
0.742910773528898,0.788895225962214,1046,245,46,94,26,26,20,68,41.9202832822525,43.5635025489192
0.738171064604185,0.822488519980691,1081,210,35,66,20,20,15,46,41.9202832822525,43.5635025489192
0.764737209708399,0.810818785593374,1058,233,46,60,24,19,22,41,41.9202832822525,43.5635025489192
0.745351028098632,0.801878444177779,1050,241,39,134,24,35,15,99,41.9202832822525,43.5635025489192
0.725741377897927,0.770802702639689,1067,224,39,40,15,11,24,29,41.9202832822525,43.5635025489192
0.754376498800959,0.811395573761372,1083,208,40,64,18,20,22,44,41.9202832822525,43.5635025489192
0.707168458781362,0.76878647077996,1053,238,31,67,15,16,16,51,41.9202832822525,43.5635025489192
0.749191037929057,0.802521943521713,1064,227,39,60,20,17,19,43,41.9202832822525,43.5635025489192
0.763079694885114,0.803373410862046,1077,214,34,81,18,17,16,64,41.9202832822525,43.5635025489192
0.775874742722729,0.817762025741779,1082,209,38,107,21,28,17,79,41.9202832822525,43.5635025489192
0.681878402466638,0.704560992775052,1076,215,33,16,11,3,22,13,41.9202832822525,43.5635025489192
0.698507071765322,0.737956611429177,1084,207,46,48,19,13,27,35,41.9202832822525,43.5635025489192
0.761360799001248,0.810301925955318,1064,227,45,86,22,24,23,62,41.9202832822525,43.5635025489192
0.720263390880921,0.774819633477757,1074,217,36,47,17,15,19,32,41.9202832822525,43.5635025489192
0.726888489208633,0.769419588772885,1080,211,40,82,19,20,21,62,41.9202832822525,43.5635025489192
0.684934873433276,0.760887334239631,1081,210,39,43,15,12,24,31,41.9202832822525,43.5635025489192
0.629381346810801,0.678709827070471,1067,224,34,31,12,12,22,19,41.9202832822525,43.5635025489192
0.688099583508821,0.721949849486443,1077,214,34,42,10,4,24,38,41.9202832822525,43.5635025489192
0.688682723027771,0.718060179113175,1050,241,39,56,15,14,24,42,41.9202832822525,43.5635025489192
0.694334532374101,0.72231300888098,1075,216,40,93,15,21,25,72,41.9202832822525,43.5635025489192
0.748197755386254,0.796926159070941,1076,215,39,50,19,11,20,39,41.9202832822525,43.5635025489192
0.752384737678855,0.814299593038713,1082,209,33,36,13,11,20,25,41.9202832822525,43.5635025489192
0.651073322125954,0.674505441079702,1062,229,37,51,10,12,27,39,41.9202832822525,43.5635025489192
0.704452938840349,0.735924252487276,1052,239,32,79,12,20,20,59,41.9202832822525,43.5635025489192
0.785321742605915,0.835311782298548,1066,225,40,62,19,16,21,46,41.9202832822525,43.5635025489192
0.765875184436308,0.817486969308836,1087,204,29,31,15,7,14,24,41.9202832822525,43.5635025489192
0.808238569890963,0.856175103458015,1055,236,34,51,21,15,13,36,41.9202832822525,43.5635025489192
0.704688488298545,0.760635250819803,1074,217,51,124,21,34,30,90,41.9202832822525,43.5635025489192
0.774858536585366,0.837639531067471,1066,225,41,78,23,28,18,50,41.9202832822525,43.5635025489192
0.715640357877935,0.742561742527,1047,244,38,30,17,13,21,17,41.9202832822525,43.5635025489192
0.75351617440225,0.789713115842993,1064,227,27,27,14,7,13,20,41.9202832822525,43.5635025489192
0.717805939580133,0.780721123139849,1071,220,31,45,10,3,21,42,41.9202832822525,43.5635025489192
0.755081194342588,0.805578963684227,1069,222,46,80,26,27,20,53,41.9202832822525,43.5635025489192
0.743141492265696,0.799464074821744,1086,205,35,88,16,19,19,69,41.9202832822525,43.5635025489192
0.727803379416283,0.781565012289432,1075,216,31,54,15,12,16,42,41.9202832822525,43.5635025489192
0.792571735049611,0.816519532641494,1071,220,48,36,27,12,21,24,41.9202832822525,43.5635025489192
0.743524378809189,0.761493542407164,1063,228,27,35,10,7,17,28,41.9202832822525,43.5635025489192
0.730936585365853,0.773197120715836,1071,220,41,64,18,16,23,48,41.9202832822525,43.5635025489192
0.739839250564992,0.77977976415125,1048,243,44,63,21,25,23,38,41.9202832822525,43.5635025489192
0.763967242948135,0.795576756637967,1081,210,35,55,18,16,17,39,41.9202832822525,43.5635025489192
0.762992831541219,0.79836847214165,1078,213,31,21,17,7,14,14,41.9202832822525,43.5635025489192
0.729806668305071,0.797506152541308,1075,216,39,88,16,17,23,71,41.9202832822525,43.5635025489192
0.722775983901914,0.760751276824715,1075,216,34,47,16,14,18,33,41.9202832822525,43.5635025489192
0.74273322972235,0.803483943694655,1050,241,38,110,16,24,22,86,41.9202832822525,43.5635025489192
0.748246314109296,0.768306741697152,1078,213,38,31,18,7,20,24,41.9202832822525,43.5635025489192
0.749436798558204,0.787383539846443,1057,234,39,37,15,13,24,24,41.9202832822525,43.5635025489192
0.732813268484617,0.774016957351207,1079,212,29,28,13,10,16,18,41.9202832822525,43.5635025489192
0.730861391005161,0.77285202435115,1067,224,39,60,16,16,23,44,41.9202832822525,43.5635025489192
0.780645483613109,0.808260962862002,1075,216,40,58,21,16,19,42,41.9202832822525,43.5635025489192
0.795685556587792,0.838019495457121,1069,222,29,46,16,15,13,31,41.9202832822525,43.5635025489192
0.779917671273155,0.82286960594961,1038,253,38,31,23,8,15,23,41.9202832822525,43.5635025489192
0.678328534551231,0.727902257795889,1074,217,32,83,10,14,22,69,41.9202832822525,43.5635025489192
0.7441224647107,0.774593411776684,1085,206,33,33,17,8,16,25,41.9202832822525,43.5635025489192
0.771519058929985,0.83650584965515,1055,236,28,102,17,28,11,74,41.9202832822525,43.5635025489192
0.768861107096401,0.778538995631573,1072,219,33,30,16,5,17,25,41.9202832822525,43.5635025489192
0.70110387482592,0.754118421611048,1075,216,39,122,15,25,24,97,41.9202832822525,43.5635025489192
0.780588756086764,0.826675303840179,1072,219,36,40,21,13,15,27,41.9202832822525,43.5635025489192
0.778815054395766,0.813958300467998,1053,238,38,79,19,23,19,56,41.9202832822525,43.5635025489192
0.771970731707317,0.795515687040671,1053,238,41,48,20,14,21,34,41.9202832822525,43.5635025489192
0.673761918763389,0.754165350880628,1070,221,38,54,15,13,23,41,41.9202832822525,43.5635025489192
0.747978160405486,0.800108936197399,1050,241,43,49,21,15,22,34,41.9202832822525,43.5635025489192
0.742753623188406,0.791217953954582,1069,222,49,62,22,18,27,44,41.9202832822525,43.5635025489192
0.719284572342126,0.766529630942853,1068,223,40,122,15,30,25,92,41.9202832822525,43.5635025489192
0.73008988952829,0.769182540092849,1058,233,38,83,18,27,20,56,41.9202832822525,43.5635025489192
0.762345333929636,0.811030541360568,1059,232,43,54,24,18,19,36,41.9202832822525,43.5635025489192
0.697412070343725,0.758825861546346,1060,231,40,73,19,25,21,48,41.9202832822525,43.5635025489192
0.76691702934157,0.817989859733062,1085,206,34,62,18,18,16,44,41.9202832822525,43.5635025489192
0.720447284345048,0.759954365496911,1073,218,39,40,17,11,22,29,41.9202832822525,43.5635025489192
0.737262091845643,0.768502929391059,1073,218,46,64,19,17,27,47,41.9202832822525,43.5635025489192
0.792760975609756,0.833327086892998,1064,227,41,62,24,18,17,44,41.9202832822525,43.5635025489192
0.76306627344966,0.799066273491887,1092,199,39,78,17,26,22,52,41.9202832822525,43.5635025489192
0.780669425406268,0.828286902424132,1048,243,37,77,19,28,18,49,41.9202832822525,43.5635025489192
0.689563365282215,0.73479298472461,1059,232,39,41,14,7,25,34,41.9202832822525,43.5635025489192
0.712868064014786,0.772388877038963,1070,221,38,62,20,17,18,45,41.9202832822525,43.5635025489192
0.758621071270474,0.813339668899919,1057,234,36,70,19,20,17,50,41.9202832822525,43.5635025489192
0.778668038812114,0.822239589129985,1057,234,38,29,24,13,14,16,41.9202832822525,43.5635025489192
0.715630772388315,0.759901874316116,1074,217,47,61,21,17,26,44,41.9202832822525,43.5635025489192
0.77701936405259,0.82013752304183,1071,220,38,56,19,16,19,40,41.9202832822525,43.5635025489192
0.72559541311379,0.784381825590264,1058,233,38,93,18,21,20,72,41.9202832822525,43.5635025489192
0.769072164948454,0.815514154992535,1079,212,30,81,16,26,14,55,41.9202832822525,43.5635025489192
0.737030375699441,0.796087370809505,1075,216,40,25,18,9,22,16,41.9202832822525,43.5635025489192
0.788075851139406,0.826600127703162,1079,212,29,18,16,12,13,6,41.9202832822525,43.5635025489192
0.779972556729745,0.82218440538309,1068,223,39,49,21,19,18,30,41.9202832822525,43.5635025489192
0.743720334355442,0.776509421086,1071,220,38,44,18,16,20,28,41.9202832822525,43.5635025489192
0.781562784349409,0.818815809234189,1067,224,35,45,18,12,17,33,41.9202832822525,43.5635025489192
0.797507942811756,0.838537693243975,1067,224,32,54,21,20,11,34,41.9202832822525,43.5635025489192
0.731173757489547,0.755526224965749,1068,223,37,46,18,14,19,32,41.9202832822525,43.5635025489192
0.775317073170732,0.814887220202444,1047,244,41,36,24,17,17,19,41.9202832822525,43.5635025489192
0.739220894200974,0.775393710228603,1049,242,36,76,15,19,21,57,41.9202832822525,43.5635025489192
0.698272438443209,0.737757402168329,1083,208,32,45,13,11,19,34,41.9202832822525,43.5635025489192
0.764858205953339,0.804422932246786,1044,247,48,72,28,26,20,46,41.9202832822525,43.5635025489192
0.769091463647108,0.810940843213298,1063,228,42,38,26,12,16,26,41.9202832822525,43.5635025489192
0.723900879296563,0.795047811431407,1089,202,40,79,18,18,22,61,41.9202832822525,43.5635025489192
0.799934961699667,0.839601866201869,1070,221,33,38,18,10,15,28,41.9202832822525,43.5635025489192
0.675187769263029,0.717405780627852,1067,224,42,46,15,11,27,35,41.9202832822525,43.5635025489192
0.765410146989094,0.806922592525548,1075,216,37,55,17,15,20,40,41.9202832822525,43.5635025489192
0.768992862807296,0.815735056189919,1062,229,30,50,18,20,12,30,41.9202832822525,43.5635025489192
0.740386017350733,0.785045911823751,1052,239,44,46,22,13,22,33,41.9202832822525,43.5635025489192
0.788853503184713,0.819895202764682,1048,243,35,69,21,17,14,52,41.9202832822525,43.5635025489192
0.71483177216785,0.730864816671274,1061,230,38,68,12,18,26,50,41.9202832822525,43.5635025489192
0.715192465192465,0.768977728076985,1059,232,33,34,13,12,20,22,41.9202832822525,43.5635025489192
0.735739887352791,0.79712556983365,1063,228,31,82,16,23,15,59,41.9202832822525,43.5635025489192
0.66687898089172,0.705079523303142,1072,219,35,32,12,7,23,25,41.9202832822525,43.5635025489192
0.772855738510691,0.817800389673042,1064,227,39,69,21,17,18,52,41.9202832822525,43.5635025489192
0.759130888491354,0.786138190964707,1044,247,43,57,21,16,22,41,41.9202832822525,43.5635025489192
0.739822710410946,0.770235615254418,1085,206,33,28,14,5,19,23,41.9202832822525,43.5635025489192
0.718103155751612,0.761918928822853,1088,203,28,27,10,7,18,20,41.9202832822525,43.5635025489192
0.762219299248923,0.792431658861718,1051,240,42,65,21,24,21,41,41.9202832822525,43.5635025489192
0.699200396568818,0.74996520688535,1081,210,37,65,14,22,23,43,41.9202832822525,43.5635025489192
0.80824604508815,0.851076396481576,1046,245,37,48,24,19,13,29,41.9202832822525,43.5635025489192
0.784627702161729,0.832634503682412,1069,222,42,44,27,17,15,27,41.9202832822525,43.5635025489192
0.691207419297307,0.768646244627761,1067,224,45,65,21,21,24,44,41.9202832822525,43.5635025489192
0.720165853658536,0.751934116004439,1059,232,41,40,15,12,26,28,41.9202832822525,43.5635025489192
0.744564138204924,0.79311403843711,1095,196,32,87,12,19,20,68,41.9202832822525,43.5635025489192
0.818868407578085,0.856340801491572,1085,206,31,53,19,14,12,39,41.9202832822525,43.5635025489192
0.76417941878422,0.80153146085131,1055,236,34,40,18,13,16,27,41.9202832822525,43.5635025489192
0.717163330300273,0.750315781322761,1044,247,35,52,15,14,20,38,41.9202832822525,43.5635025489192
0.77475105666595,0.79830005661646,1074,217,22,44,7,10,15,34,41.9202832822525,43.5635025489192
0.82801330420969,0.849802066132945,1065,226,32,45,20,15,12,30,41.9202832822525,43.5635025489192
0.773234619480626,0.80287282863814,1087,204,39,31,18,8,21,23,41.9202832822525,43.5635025489192
0.730903093721565,0.804407693315564,1055,236,35,59,19,18,16,41,41.9202832822525,43.5635025489192
0.756930734657874,0.796423423437005,1095,196,38,68,19,18,19,50,41.9202832822525,43.5635025489192
0.714848780487805,0.757112780692588,1055,236,41,26,19,8,22,18,41.9202832822525,43.5635025489192
0.696858536585366,0.739392106432344,1074,217,41,93,17,26,24,67,41.9202832822525,43.5635025489192
0.719830302012013,0.768008831007347,1064,227,38,71,19,19,19,52,41.9202832822525,43.5635025489192
0.638899955732625,0.669370900132775,1076,215,36,23,12,6,24,17,41.9202832822525,43.5635025489192
0.673410813256419,0.713632048456381,1070,221,28,36,10,8,18,28,41.9202832822525,43.5635025489192
0.800009992006395,0.826686558388346,1072,219,40,77,21,21,19,56,41.9202832822525,43.5635025489192
0.747188239936859,0.776499634071993,1064,227,24,49,10,11,14,38,41.9202832822525,43.5635025489192
0.785261489698891,0.827569562583705,1071,220,29,68,13,19,16,49,41.9202832822525,43.5635025489192
0.727556440903054,0.763756589626379,1095,196,36,43,16,9,20,34,41.9202832822525,43.5635025489192
0.751944949954504,0.809610927650989,1059,232,35,79,18,24,17,55,41.9202832822525,43.5635025489192
0.761320438282648,0.799424196910164,1073,218,43,63,18,15,25,48,41.9202832822525,43.5635025489192
0.741737727031845,0.801251891273058,1087,204,33,82,13,18,20,64,41.9202832822525,43.5635025489192
0.587444266095952,0.621101505626599,1077,214,45,54,12,11,33,43,41.9202832822525,43.5635025489192
0.759052183173589,0.78878235183785,1062,229,39,37,18,8,21,29,41.9202832822525,43.5635025489192
0.732872684504558,0.776761566896967,1082,209,38,42,17,16,21,26,41.9202832822525,43.5635025489192
0.705914048019311,0.735896326944704,1065,226,37,43,14,14,23,29,41.9202832822525,43.5635025489192
0.792543264336613,0.821741322634131,1054,237,28,58,14,10,14,48,41.9202832822525,43.5635025489192
0.707190060798308,0.716082932572445,1070,221,30,58,9,13,21,45,41.9202832822525,43.5635025489192
0.750640567900197,0.804426011587158,1080,211,38,66,21,20,17,46,41.9202832822525,43.5635025489192
0.579672217816548,0.629174620068051,1090,201,30,123,9,17,21,106,41.9202832822525,43.5635025489192
0.780394496700828,0.834562962402584,1033,258,34,35,23,13,11,22,41.9202832822525,43.5635025489192
0.699310551558753,0.74452020669895,1069,222,40,121,11,27,29,94,41.9202832822525,43.5635025489192
0.802636968766001,0.83853208703394,1071,220,31,74,18,20,13,54,41.9202832822525,43.5635025489192
0.747868735996503,0.800960827804297,1107,184,29,61,10,17,19,44,41.9202832822525,43.5635025489192
0.72713830755232,0.78461776297216,1080,211,35,36,16,6,19,30,41.9202832822525,43.5635025489192
0.791614020309795,0.817307701399146,1063,228,34,41,19,11,15,30,41.9202832822525,43.5635025489192
0.736044657097289,0.81175970640424,1040,251,37,89,23,30,14,59,41.9202832822525,43.5635025489192
0.738080072793449,0.795186892433528,1075,216,35,73,16,20,19,53,41.9202832822525,43.5635025489192
0.751142756680731,0.815548031238821,1081,210,27,66,14,16,13,50,41.9202832822525,43.5635025489192
0.761008938181478,0.800167372203745,1072,219,34,62,18,23,16,39,41.9202832822525,43.5635025489192
0.743530344133874,0.785322601551023,1070,221,53,48,28,16,25,32,41.9202832822525,43.5635025489192
0.727854582693292,0.757851970312143,1095,196,31,41,11,12,20,29,41.9202832822525,43.5635025489192
0.789398249924566,0.821205599781157,1064,227,37,18,22,8,15,10,41.9202832822525,43.5635025489192
0.755300836111263,0.804250780079343,1082,209,29,37,14,8,15,29,41.9202832822525,43.5635025489192
0.7004863703201,0.724786929293977,1078,213,28,69,8,15,20,54,41.9202832822525,43.5635025489192
0.679409444937395,0.721351242421788,1055,236,49,56,19,15,30,41,41.9202832822525,43.5635025489192
0.759850905218317,0.805758616399952,1078,213,39,52,19,17,20,35,41.9202832822525,43.5635025489192
0.748532757051865,0.827516928648033,1074,217,35,69,20,20,15,49,41.9202832822525,43.5635025489192
0.746659634317862,0.77347452794125,1078,213,27,48,9,7,18,41,41.9202832822525,43.5635025489192
0.731076770550455,0.811933465771559,1068,223,37,101,20,32,17,69,41.9202832822525,43.5635025489192
0.754440877474585,0.770431749747326,1053,238,45,38,20,10,25,28,41.9202832822525,43.5635025489192
0.720238095238095,0.746540994840073,1085,206,28,26,13,8,15,18,41.9202832822525,43.5635025489192
0.781984137247295,0.81714994224159,1054,237,37,53,20,18,17,35,41.9202832822525,43.5635025489192
0.738095238095238,0.785828807999251,1061,230,28,74,12,15,16,59,41.9202832822525,43.5635025489192
0.722202001819836,0.759602278318356,1052,239,35,50,15,9,20,41,41.9202832822525,43.5635025489192
0.735778482685699,0.787339518926036,1078,213,30,36,17,13,13,23,41.9202832822525,43.5635025489192
0.748860284258514,0.791747424928864,1074,217,48,72,27,22,21,50,41.9202832822525,43.5635025489192
0.729045058883768,0.758420827615281,1055,236,31,43,14,12,17,31,41.9202832822525,43.5635025489192
0.732413035044614,0.771368003170395,1060,231,37,28,18,9,19,19,41.9202832822525,43.5635025489192
0.789575530586766,0.815279068970036,1067,224,45,56,22,18,23,38,41.9202832822525,43.5635025489192
0.71088066676302,0.756841039526751,1076,215,33,43,15,9,18,34,41.9202832822525,43.5635025489192
0.719555112881806,0.761997802414871,1079,212,36,59,15,17,21,42,41.9202832822525,43.5635025489192
0.741726714705097,0.776381167047596,1045,246,42,39,18,11,24,28,41.9202832822525,43.5635025489192
0.800211976682565,0.848531246518358,1062,229,33,55,21,11,12,44,41.9202832822525,43.5635025489192
0.71061685917916,0.72869581715327,1037,254,39,43,16,15,23,28,41.9202832822525,43.5635025489192
0.711824390243902,0.771981486667144,1026,265,41,78,21,25,20,53,41.9202832822525,43.5635025489192
0.75059512195122,0.782068120773967,1060,231,41,19,22,9,19,10,41.9202832822525,43.5635025489192
0.782165039929015,0.826828892409982,1052,239,49,48,30,17,19,31,41.9202832822525,43.5635025489192
0.735897435897436,0.793233451873742,1054,237,30,84,13,20,17,64,41.9202832822525,43.5635025489192
0.801125462118021,0.845816664720758,1092,199,34,66,17,12,17,54,41.9202832822525,43.5635025489192
0.71872852233677,0.758321684512555,1081,210,30,14,12,5,18,9,41.9202832822525,43.5635025489192
0.711934972244251,0.76013460849791,1071,220,30,52,15,16,15,36,41.9202832822525,43.5635025489192
0.718550193999672,0.768286294748134,1082,209,29,105,10,29,19,76,41.9202832822525,43.5635025489192
0.744665434536061,0.770460142861773,1049,242,38,41,17,11,21,30,41.9202832822525,43.5635025489192
0.717669373594113,0.766901055888651,1085,206,42,49,16,16,26,33,41.9202832822525,43.5635025489192
0.804389536244092,0.840559357712886,1072,219,34,78,21,20,13,58,41.9202832822525,43.5635025489192
0.795583717357911,0.844361033074563,1067,224,31,25,17,8,14,17,41.9202832822525,43.5635025489192
0.752663414634146,0.794089588573175,1080,211,41,63,17,18,24,45,41.9202832822525,43.5635025489192
0.77422074480898,0.833349148250702,1074,217,33,92,18,24,15,68,41.9202832822525,43.5635025489192
0.744499778663125,0.80029719441124,1071,220,36,63,17,20,19,43,41.9202832822525,43.5635025489192
0.645688542494043,0.690332532729845,1077,214,32,85,9,21,23,64,41.9202832822525,43.5635025489192
0.731732835652076,0.781571936056836,1059,232,28,69,12,15,16,54,41.9202832822525,43.5635025489192
0.734325357426529,0.78017572003197,1049,242,32,46,17,10,15,36,41.9202832822525,43.5635025489192
0.771168987387913,0.794823223476954,1054,237,44,52,22,13,22,39,41.9202832822525,43.5635025489192
0.750061440157287,0.784957648334612,1055,236,39,52,19,18,20,34,41.9202832822525,43.5635025489192
0.724014336917563,0.769080228376041,1070,221,31,33,14,8,17,25,41.9202832822525,43.5635025489192
0.777817448649557,0.811120236319818,1058,233,38,47,17,14,21,33,41.9202832822525,43.5635025489192
0.696923417441346,0.71436932953758,1061,230,36,39,16,10,20,29,41.9202832822525,43.5635025489192
0.750952322437945,0.800504450626462,1056,235,39,58,21,16,18,42,41.9202832822525,43.5635025489192
0.751994644516094,0.793432591859577,1054,237,29,49,16,13,13,36,41.9202832822525,43.5635025489192
0.768859094950629,0.817861703709875,1079,212,34,31,19,7,15,24,41.9202832822525,43.5635025489192
0.67088467614534,0.691749903451414,1075,216,25,39,7,9,18,30,41.9202832822525,43.5635025489192
0.725599759549702,0.784364910888482,1073,218,29,53,13,17,16,36,41.9202832822525,43.5635025489192
0.753288820492454,0.793429545067033,1085,206,32,42,13,9,19,33,41.9202832822525,43.5635025489192
0.79492720655141,0.825933186461491,1067,224,35,40,21,10,14,30,41.9202832822525,43.5635025489192
0.723851228389445,0.75747543804363,1065,226,35,58,15,20,20,38,41.9202832822525,43.5635025489192
0.780732044198895,0.824679542767296,1093,198,24,27,13,3,11,24,41.9202832822525,43.5635025489192
0.725336585365854,0.766967051118201,1071,220,41,84,17,19,24,65,41.9202832822525,43.5635025489192
0.710243729165528,0.75521128995404,1065,226,29,101,11,17,18,84,41.9202832822525,43.5635025489192
0.713960942158616,0.785231896505274,1057,234,43,80,23,27,20,53,41.9202832822525,43.5635025489192
0.744519920990509,0.76915657488349,1058,233,33,48,16,12,17,36,41.9202832822525,43.5635025489192
0.776786144433203,0.813739698180958,1085,206,33,38,18,12,15,26,41.9202832822525,43.5635025489192
0.76479019126078,0.815172966107271,1069,222,33,51,17,17,16,34,41.9202832822525,43.5635025489192
0.692328767123287,0.727277764708684,1045,246,50,68,18,12,32,56,41.9202832822525,43.5635025489192
0.748916204070843,0.821469916011923,1077,214,30,93,15,27,15,66,41.9202832822525,43.5635025489192
0.671171643094116,0.732153616427279,1046,245,46,56,22,12,24,44,41.9202832822525,43.5635025489192
0.747101572220337,0.786819146700844,1034,257,28,63,14,15,14,48,41.9202832822525,43.5635025489192
0.764295076595396,0.790567442273588,1072,219,39,47,19,12,20,35,41.9202832822525,43.5635025489192
0.732015609093994,0.776684899225648,1037,254,28,107,15,29,13,78,41.9202832822525,43.5635025489192
0.738262739666108,0.787175089593366,1053,238,44,59,25,19,19,40,41.9202832822525,43.5635025489192
0.702290836653387,0.741066377614766,1072,219,36,76,11,15,25,61,41.9202832822525,43.5635025489192
0.771175534991325,0.823834927795051,1050,241,56,78,27,24,29,54,41.9202832822525,43.5635025489192
0.665468289085546,0.701518571860077,1065,226,48,58,15,9,33,49,41.9202832822525,43.5635025489192
0.731828242585215,0.77832717347055,1063,228,36,57,17,16,19,41,41.9202832822525,43.5635025489192
0.761113652827024,0.782817178627741,1054,237,42,39,25,15,17,24,41.9202832822525,43.5635025489192
0.726767275615568,0.78563939346492,1074,217,32,60,14,19,18,41,41.9202832822525,43.5635025489192
0.704138999557326,0.776025122412876,1065,226,36,59,18,15,18,44,41.9202832822525,43.5635025489192
0.695362939183164,0.761400222988671,1072,219,45,64,16,15,29,49,41.9202832822525,43.5635025489192
0.687855045941515,0.723925856782222,1077,214,42,57,17,15,25,42,41.9202832822525,43.5635025489192
0.742424242424242,0.794887589823159,1070,221,48,60,26,24,22,36,41.9202832822525,43.5635025489192
0.744367985582043,0.802088799933833,1107,184,39,35,20,10,19,25,41.9202832822525,43.5635025489192
0.773541167066347,0.820915873818955,1084,207,40,53,22,13,18,40,41.9202832822525,43.5635025489192
0.739201647246011,0.772841159751507,1072,219,34,70,18,20,16,50,41.9202832822525,43.5635025489192
0.75140466877755,0.798596433297024,1068,223,52,56,32,20,20,36,41.9202832822525,43.5635025489192
0.785425457102672,0.837748263239316,1084,207,27,119,15,23,12,96,41.9202832822525,43.5635025489192
0.686096383464805,0.715059786093613,1064,227,37,54,13,11,24,43,41.9202832822525,43.5635025489192
0.76097068130695,0.840540272761558,1088,203,42,88,23,27,19,61,41.9202832822525,43.5635025489192
0.776859229747676,0.804392603245083,1072,219,36,41,17,12,19,29,41.9202832822525,43.5635025489192
0.775863213811421,0.80804856725452,1067,224,36,32,15,10,21,22,41.9202832822525,43.5635025489192
0.746013393072216,0.790842400644813,1071,220,33,97,14,21,19,76,41.9202832822525,43.5635025489192
0.722375832053251,0.769578126851741,1054,237,31,53,13,14,18,39,41.9202832822525,43.5635025489192
0.765814519698982,0.811160122391335,1049,242,36,62,22,26,14,36,41.9202832822525,43.5635025489192
0.787980257229458,0.832448957584199,1067,224,39,52,22,21,17,31,41.9202832822525,43.5635025489192
0.760765550239234,0.79182163243506,1053,238,37,34,22,17,15,17,41.9202832822525,43.5635025489192
0.792370731707317,0.821301418225669,1058,233,41,60,23,19,18,41,41.9202832822525,43.5635025489192
0.720155365248725,0.764346280383963,1077,214,34,38,15,8,19,30,41.9202832822525,43.5635025489192
0.674587288878722,0.704943875039709,1058,233,42,61,16,15,26,46,41.9202832822525,43.5635025489192
0.777240285487708,0.831228248516212,1038,253,30,107,17,23,13,84,41.9202832822525,43.5635025489192
0.759130146082337,0.796973155776922,1096,195,36,41,16,10,20,31,41.9202832822525,43.5635025489192
0.797110055423595,0.845807746866769,1089,202,28,57,16,11,12,46,41.9202832822525,43.5635025489192
0.772466617514541,0.822575310839901,1084,207,39,40,20,12,19,28,41.9202832822525,43.5635025489192
0.734611405664037,0.757848779597975,1062,229,37,43,18,12,19,31,41.9202832822525,43.5635025489192
0.761571161691258,0.792990708109416,1040,251,42,24,24,11,18,13,41.9202832822525,43.5635025489192
0.731289808917197,0.785357753359182,1069,222,35,59,13,14,22,45,41.9202832822525,43.5635025489192
0.767522306995991,0.813902082989252,1064,227,37,40,17,7,20,33,41.9202832822525,43.5635025489192
0.755847054968461,0.810232995072431,1078,213,39,88,17,24,22,64,41.9202832822525,43.5635025489192
0.712618855761483,0.758082107489812,1054,237,50,93,24,23,26,70,41.9202832822525,43.5635025489192
0.779339499927735,0.81479536750553,1080,211,33,59,15,15,18,44,41.9202832822525,43.5635025489192
0.798715428892321,0.835554015898477,1054,237,34,34,19,12,15,22,41.9202832822525,43.5635025489192
0.735434956105347,0.770530810366447,1060,231,38,27,18,10,20,17,41.9202832822525,43.5635025489192
0.762611836854707,0.776342001335874,1068,223,38,24,18,8,20,16,41.9202832822525,43.5635025489192
0.701969912496228,0.7457907557741,1056,235,37,34,15,10,22,24,41.9202832822525,43.5635025489192
0.701241302972802,0.745990123906375,1070,221,51,78,18,17,33,61,41.9202832822525,43.5635025489192
0.707771378581322,0.729731046849595,1062,229,44,31,16,7,28,24,41.9202832822525,43.5635025489192
0.821413942819694,0.840173512727139,1084,207,39,29,24,10,15,19,41.9202832822525,43.5635025489192
0.699429284822543,0.748111882237655,1075,216,45,63,20,16,25,47,41.9202832822525,43.5635025489192
0.796292607348384,0.826403605870983,1079,212,36,61,18,21,18,40,41.9202832822525,43.5635025489192
0.80667652411283,0.825129884115951,1062,229,35,48,18,15,17,33,41.9202832822525,43.5635025489192
0.802099880857824,0.852461155143433,1077,214,32,46,16,10,16,36,41.9202832822525,43.5635025489192
0.70192220200182,0.754228631805039,1076,215,35,70,16,18,19,52,41.9202832822525,43.5635025489192
0.741202485798162,0.79290376156067,1065,226,42,59,19,13,23,46,41.9202832822525,43.5635025489192
0.657832278481013,0.709432032474389,1070,221,27,74,7,11,20,63,41.9202832822525,43.5635025489192
0.782386664739606,0.792845015931545,1105,186,33,34,14,11,19,23,41.9202832822525,43.5635025489192
0.755223550243471,0.787029966716856,1073,218,36,50,14,8,22,42,41.9202832822525,43.5635025489192
0.702291346646185,0.749913632240293,1066,225,31,30,15,6,16,24,41.9202832822525,43.5635025489192
0.716060054595086,0.76355463533841,1068,223,35,38,15,16,20,22,41.9202832822525,43.5635025489192
0.807393084622384,0.844058545371937,1069,222,35,32,20,10,15,22,41.9202832822525,43.5635025489192
0.661961406291303,0.703988754014618,1069,222,30,41,10,10,20,31,41.9202832822525,43.5635025489192
0.723618325611868,0.772880386927544,1048,243,34,53,17,18,17,35,41.9202832822525,43.5635025489192
0.7684242632201,0.80744094577438,1063,228,42,26,27,6,15,20,41.9202832822525,43.5635025489192
0.708453237410072,0.750990925476922,1069,222,40,84,17,21,23,63,41.9202832822525,43.5635025489192
0.761838240561645,0.785483205125452,1073,218,22,30,11,7,11,23,41.9202832822525,43.5635025489192
0.68937583001328,0.737772390088094,1067,224,36,44,17,9,19,35,41.9202832822525,43.5635025489192
0.768732939035487,0.821537134351166,1045,246,35,59,21,24,14,35,41.9202832822525,43.5635025489192
0.809297590770275,0.85592910756471,1083,208,28,41,17,8,11,33,41.9202832822525,43.5635025489192
0.731766455450666,0.787340271181478,1070,221,37,37,19,7,18,30,41.9202832822525,43.5635025489192
0.718351315885398,0.738886817448954,1059,232,44,33,17,12,27,21,41.9202832822525,43.5635025489192
0.656356891651009,0.720654936479571,1089,202,33,61,15,12,18,49,41.9202832822525,43.5635025489192
0.772906938641763,0.814386494143153,1054,237,39,37,22,11,17,26,41.9202832822525,43.5635025489192
0.741902978419832,0.781131592219118,1060,231,45,33,23,15,22,18,41.9202832822525,43.5635025489192
0.745068036504727,0.772699235014186,1088,203,29,55,11,12,18,43,41.9202832822525,43.5635025489192
0.730688452976015,0.771233734998257,1066,225,38,43,17,8,21,35,41.9202832822525,43.5635025489192
0.754141513407272,0.791845947801875,1059,232,34,38,18,10,16,28,41.9202832822525,43.5635025489192
0.702278177458034,0.777113868880338,1066,225,40,96,18,20,22,76,41.9202832822525,43.5635025489192
0.748666358634015,0.791174709150261,1068,223,38,53,20,15,18,38,41.9202832822525,43.5635025489192
0.746902171630193,0.799102701536098,1078,213,38,99,18,34,20,65,41.9202832822525,43.5635025489192
0.726406202493159,0.814722782183221,1084,207,26,89,14,23,12,66,41.9202832822525,43.5635025489192
0.755916443053071,0.802857447350081,1039,252,43,41,24,12,19,29,41.9202832822525,43.5635025489192
0.760345907404731,0.802419577126182,1057,234,33,40,21,14,12,26,41.9202832822525,43.5635025489192
0.721178343949045,0.764765996166422,1058,233,35,57,13,14,22,43,41.9202832822525,43.5635025489192
0.811763696671623,0.845756181766705,1060,231,42,74,28,26,14,48,41.9202832822525,43.5635025489192
0.793971792538672,0.821160957054194,1074,217,35,57,18,18,17,39,41.9202832822525,43.5635025489192
0.758893280632411,0.792289687576019,1062,229,26,72,12,17,14,55,41.9202832822525,43.5635025489192
0.705064463036621,0.754529797569799,1076,215,23,35,12,9,11,26,41.9202832822525,43.5635025489192
0.696702080566622,0.750152429266255,1072,219,36,52,13,13,23,39,41.9202832822525,43.5635025489192
0.726729533330533,0.803799945532805,1090,201,38,99,16,28,22,71,41.9202832822525,43.5635025489192
0.810268438884545,0.840453818709369,1066,225,12,19,7,6,5,13,41.9202832822525,43.5635025489192
0.790788396051554,0.82217454094691,1059,232,37,45,19,13,18,32,41.9202832822525,43.5635025489192
0.748935037273695,0.811402112757833,1064,227,39,81,20,24,19,57,41.9202832822525,43.5635025489192
0.697896900695762,0.734633184523473,1064,227,51,65,21,20,30,45,41.9202832822525,43.5635025489192
0.725812286240463,0.768394947629281,1093,198,24,29,10,5,14,24,41.9202832822525,43.5635025489192
0.785368754956384,0.825944399407347,1071,220,30,91,16,24,14,67,41.9202832822525,43.5635025489192
0.770609564206062,0.798870411773532,1035,256,47,52,23,17,24,35,41.9202832822525,43.5635025489192
0.741884802448221,0.790778692609698,1075,216,29,53,14,15,15,38,41.9202832822525,43.5635025489192
0.747452636968766,0.783981017728307,1059,232,31,39,17,14,14,25,41.9202832822525,43.5635025489192
0.75904044409199,0.797373860541566,1075,216,30,19,15,4,15,15,41.9202832822525,43.5635025489192
0.68300487804878,0.718831865599904,1076,215,41,50,17,12,24,38,41.9202832822525,43.5635025489192
0.729411443248265,0.773039981699421,1080,211,29,32,15,4,14,28,41.9202832822525,43.5635025489192
0.705285694229959,0.756997056954244,1080,211,34,75,16,18,18,57,41.9202832822525,43.5635025489192
0.74851072279587,0.790243795049178,1076,215,32,36,16,10,16,26,41.9202832822525,43.5635025489192
0.774085089874564,0.801528721625888,1053,238,37,33,21,14,16,19,41.9202832822525,43.5635025489192
0.75816346922462,0.799066698624745,1086,205,40,44,19,10,21,34,41.9202832822525,43.5635025489192
0.754946341463415,0.795528515475467,1045,246,41,34,23,15,18,19,41.9202832822525,43.5635025489192
0.735859883053719,0.779020557268776,1058,233,29,33,14,7,15,26,41.9202832822525,43.5635025489192
0.749229268292683,0.785658936153665,1050,241,41,56,19,14,22,42,41.9202832822525,43.5635025489192
0.755065947242206,0.805268412476648,1063,228,40,143,22,40,18,103,41.9202832822525,43.5635025489192
0.754145154884829,0.788573386727894,1039,252,32,30,15,9,17,21,41.9202832822525,43.5635025489192
0.75922580334345,0.79606760263475,1063,228,33,52,18,10,15,42,41.9202832822525,43.5635025489192
0.718939393939394,0.757180709064545,1082,209,55,46,25,18,30,28,41.9202832822525,43.5635025489192
0.791305659726712,0.842344024373296,1094,197,37,96,19,17,18,79,41.9202832822525,43.5635025489192
0.732962109575013,0.751171696130217,1078,213,31,12,12,4,19,8,41.9202832822525,43.5635025489192
0.815444796061885,0.843801135485471,1072,219,27,65,14,15,13,50,41.9202832822525,43.5635025489192
0.748666292292573,0.804920374935332,1055,236,34,88,15,18,19,70,41.9202832822525,43.5635025489192
0.737126619085382,0.779164854265313,1058,233,30,43,15,13,15,30,41.9202832822525,43.5635025489192
0.742696629213483,0.784120926652731,1065,226,45,35,22,13,23,22,41.9202832822525,43.5635025489192
0.779194333776007,0.814972316498938,1058,233,36,52,20,18,16,34,41.9202832822525,43.5635025489192
0.778797514091632,0.797374146127992,1064,227,33,25,17,8,16,17,41.9202832822525,43.5635025489192
0.702048638646577,0.746086153622492,1065,226,30,72,13,18,17,54,41.9202832822525,43.5635025489192
0.731351091505486,0.792281929885897,1063,228,28,47,15,11,13,36,41.9202832822525,43.5635025489192
0.732719508940486,0.759930739769511,1059,232,42,50,19,19,23,31,41.9202832822525,43.5635025489192
0.692385466034755,0.746999447247357,1078,213,25,68,6,12,19,56,41.9202832822525,43.5635025489192
0.740859639736044,0.783567624855526,1069,222,45,25,21,8,24,17,41.9202832822525,43.5635025489192
0.743170978465096,0.774538846726778,1085,206,33,26,12,4,21,22,41.9202832822525,43.5635025489192
0.747841412099022,0.771306078724284,1052,239,29,49,15,9,14,40,41.9202832822525,43.5635025489192
0.718365389115073,0.762359816274811,1056,235,34,33,11,9,23,24,41.9202832822525,43.5635025489192
0.774191267956114,0.816742460259768,1060,231,28,79,16,24,12,55,41.9202832822525,43.5635025489192
0.727414634146341,0.748518714379146,1107,184,41,39,13,10,28,29,41.9202832822525,43.5635025489192
0.713009592326139,0.750526758233027,1058,233,40,42,18,8,22,34,41.9202832822525,43.5635025489192
0.715545884224812,0.744806766986358,1064,227,34,25,16,7,18,18,41.9202832822525,43.5635025489192
0.726971058932247,0.762181445920088,1046,245,38,75,15,20,23,55,41.9202832822525,43.5635025489192
0.650292891183479,0.690200336640598,1079,212,32,27,11,3,21,24,41.9202832822525,43.5635025489192
0.773711432138398,0.813058409928081,1042,249,45,49,24,14,21,35,41.9202832822525,43.5635025489192
0.748904317195052,0.798429151659224,1059,232,39,48,18,15,21,33,41.9202832822525,43.5635025489192
0.727799333296901,0.788229763262854,1065,226,29,47,17,16,12,31,41.9202832822525,43.5635025489192
0.760413499543934,0.79464654615257,1075,216,26,50,13,15,13,35,41.9202832822525,43.5635025489192
0.667905709838617,0.7018429332896,1086,205,39,41,10,8,29,33,41.9202832822525,43.5635025489192
0.719746233148295,0.754832301927322,1077,214,30,37,10,7,20,30,41.9202832822525,43.5635025489192
0.719407910584381,0.760619137047028,1057,234,33,29,16,6,17,23,41.9202832822525,43.5635025489192
0.74077419665655,0.781884696944919,1075,216,33,61,14,15,19,46,41.9202832822525,43.5635025489192
0.734202637889688,0.802877089844068,1054,237,40,53,16,13,24,40,41.9202832822525,43.5635025489192
0.682615629984051,0.715323443889129,1063,228,37,50,12,11,25,39,41.9202832822525,43.5635025489192
0.739352989352989,0.781372682484313,1079,212,37,92,15,18,22,74,41.9202832822525,43.5635025489192
0.721888520183139,0.762252981024357,1051,240,38,55,19,19,19,36,41.9202832822525,43.5635025489192
0.722671869730693,0.761955027791511,1069,222,33,53,12,13,21,40,41.9202832822525,43.5635025489192
0.744384492406075,0.759521644163498,1084,207,40,56,13,12,27,44,41.9202832822525,43.5635025489192
0.652174527768352,0.711743687506906,1069,222,28,73,9,19,19,54,41.9202832822525,43.5635025489192
0.716868292682927,0.761982401784824,1076,215,41,101,17,21,24,80,41.9202832822525,43.5635025489192
0.773539537679655,0.805494016695847,1069,222,29,36,11,8,18,28,41.9202832822525,43.5635025489192
0.757392651615759,0.792727799611023,1070,221,36,39,19,14,17,25,41.9202832822525,43.5635025489192
0.71040175909362,0.740607036971841,1047,244,43,25,18,6,25,19,41.9202832822525,43.5635025489192
0.770837470214456,0.814612909009878,1092,199,32,51,19,12,13,39,41.9202832822525,43.5635025489192
0.720459952418715,0.787879806781858,1081,210,30,84,14,17,16,67,41.9202832822525,43.5635025489192
0.772107946554149,0.837344377047914,1087,204,27,48,17,14,10,34,41.9202832822525,43.5635025489192
0.760201377848437,0.77904518228555,1079,212,33,21,15,6,18,15,41.9202832822525,43.5635025489192
0.688647203353086,0.726542054545653,1082,209,33,46,14,15,19,31,41.9202832822525,43.5635025489192
0.658178397521027,0.726352869832108,1076,215,36,36,16,10,20,26,41.9202832822525,43.5635025489192
0.785964513193812,0.820721455478628,1053,238,35,29,20,9,15,20,41.9202832822525,43.5635025489192
0.700234923919135,0.746630233352182,1070,221,37,77,15,18,22,59,41.9202832822525,43.5635025489192
0.691814634146341,0.759010390895499,1066,225,41,40,21,14,20,26,41.9202832822525,43.5635025489192
0.726185365853658,0.778920326647089,1076,215,41,105,14,20,27,85,41.9202832822525,43.5635025489192
0.662714776632302,0.690675838229992,1087,204,30,46,11,14,19,32,41.9202832822525,43.5635025489192
0.741132137298272,0.769094710296192,1054,237,39,48,17,13,22,35,41.9202832822525,43.5635025489192
0.813652577135723,0.829630328833359,1056,235,45,33,27,10,18,23,41.9202832822525,43.5635025489192
0.694619278921803,0.726656711222899,1059,232,47,34,19,9,28,25,41.9202832822525,43.5635025489192
0.751753685890704,0.809735581249602,1054,237,38,119,21,37,17,82,41.9202832822525,43.5635025489192
0.748256820628012,0.804942164842501,1097,194,34,114,16,22,18,92,41.9202832822525,43.5635025489192
0.780092592592593,0.800062105306389,1060,231,27,17,14,5,13,12,41.9202832822525,43.5635025489192
0.696990968224999,0.742692745210426,1073,218,34,84,14,17,20,67,41.9202832822525,43.5635025489192
0.723068731055952,0.770206418523084,1067,224,39,46,20,18,19,28,41.9202832822525,43.5635025489192
0.75919166008945,0.800475610125729,1088,203,24,41,13,13,11,28,41.9202832822525,43.5635025489192
0.742605915267786,0.777920638456153,1054,237,40,56,18,21,22,35,41.9202832822525,43.5635025489192
0.787529785544083,0.816474070773474,1060,231,32,49,17,14,15,35,41.9202832822525,43.5635025489192
0.775858746446982,0.796202409430434,1074,217,33,52,15,16,18,36,41.9202832822525,43.5635025489192
0.797299826851982,0.827118226187388,1060,231,34,50,16,9,18,41,41.9202832822525,43.5635025489192
0.762920815552394,0.821908054224716,1047,244,37,70,20,18,17,52,41.9202832822525,43.5635025489192
0.73040058982551,0.76897832176472,1044,247,39,70,20,18,19,52,41.9202832822525,43.5635025489192
0.790248100989125,0.826189091487645,1061,230,29,93,15,25,14,68,41.9202832822525,43.5635025489192
0.724558181096108,0.755909902553981,1078,213,32,17,13,5,19,12,41.9202832822525,43.5635025489192
0.733738125321728,0.78089195516352,1089,202,34,26,15,7,19,19,41.9202832822525,43.5635025489192
0.736715195632393,0.771896782385158,1085,206,35,32,13,15,22,17,41.9202832822525,43.5635025489192
0.710719259441304,0.750288254983891,1056,235,39,55,18,12,21,43,41.9202832822525,43.5635025489192
0.82184323360794,0.867774878044254,1056,235,33,52,20,16,13,36,41.9202832822525,43.5635025489192
0.781165067945643,0.83654502359741,1052,239,40,83,24,27,16,56,41.9202832822525,43.5635025489192
0.753032952620362,0.79117431421884,1066,225,29,38,17,12,12,26,41.9202832822525,43.5635025489192
0.735027580772262,0.775698972538773,1077,214,22,24,8,3,14,21,41.9202832822525,43.5635025489192
0.722338489535942,0.779122348901532,1056,235,35,45,18,17,17,28,41.9202832822525,43.5635025489192
0.743327552151082,0.774189608853003,1081,210,33,38,18,10,15,28,41.9202832822525,43.5635025489192
0.779400513689273,0.819725386829951,1074,217,29,80,13,22,16,58,41.9202832822525,43.5635025489192
0.759277457999906,0.785557724200157,1106,185,34,52,13,11,21,41,41.9202832822525,43.5635025489192
0.750218591179846,0.790966340486545,1066,225,29,34,12,7,17,27,41.9202832822525,43.5635025489192
0.760695187165775,0.803574191184967,1083,208,33,65,15,12,18,53,41.9202832822525,43.5635025489192
0.705186533212011,0.756843631088448,1096,195,35,45,15,8,20,37,41.9202832822525,43.5635025489192
0.751160145586897,0.78435900493759,1061,230,35,81,15,19,20,62,41.9202832822525,43.5635025489192
0.725602396655028,0.76502604110501,1064,227,37,36,19,11,18,25,41.9202832822525,43.5635025489192
0.747924927306371,0.776075714151174,1092,199,30,68,14,13,16,55,41.9202832822525,43.5635025489192
0.72375042891456,0.766407530763414,1084,207,42,45,16,13,26,32,41.9202832822525,43.5635025489192
0.721880590339893,0.763846585181493,1058,233,43,36,20,12,23,24,41.9202832822525,43.5635025489192
0.750621200105736,0.770649444172706,1054,237,30,13,16,6,14,7,41.9202832822525,43.5635025489192
0.655002262187535,0.711153149018963,1078,213,28,42,13,9,15,33,41.9202832822525,43.5635025489192
0.766171068308181,0.801933046545135,1037,254,32,36,16,10,16,26,41.9202832822525,43.5635025489192
0.714222707607006,0.762011773388499,1076,215,38,35,18,9,20,26,41.9202832822525,43.5635025489192
0.778078151880069,0.815526357285977,1055,236,39,36,22,14,17,22,41.9202832822525,43.5635025489192
0.711380895283773,0.746775834135086,1077,214,40,47,16,15,24,32,41.9202832822525,43.5635025489192
0.719733848953594,0.759283074142222,1035,256,35,60,17,14,18,46,41.9202832822525,43.5635025489192
0.724657085086617,0.763949593447207,1069,222,29,37,15,10,14,27,41.9202832822525,43.5635025489192
0.71041205865487,0.757735736332139,1064,227,39,72,16,19,23,53,41.9202832822525,43.5635025489192
0.710001445295563,0.777611960957332,1088,203,33,37,17,10,16,27,41.9202832822525,43.5635025489192
0.691765794343114,0.740390128100284,1062,229,30,56,11,14,19,42,41.9202832822525,43.5635025489192
0.811652035115722,0.84977087764835,1063,228,38,57,24,21,14,36,41.9202832822525,43.5635025489192
0.738533988533989,0.762660286852546,1075,216,33,62,16,16,17,46,41.9202832822525,43.5635025489192
0.768054459352802,0.819907778570557,1053,238,24,85,16,21,8,64,41.9202832822525,43.5635025489192
0.798937100387999,0.839790154812001,1066,225,29,56,16,12,13,44,41.9202832822525,43.5635025489192
0.709111575325633,0.741915354860343,1080,211,39,48,15,11,24,37,41.9202832822525,43.5635025489192
0.666161500629075,0.722448379209206,1051,240,42,47,20,13,22,34,41.9202832822525,43.5635025489192
0.711769415532426,0.764376372436327,1064,227,42,83,21,19,21,64,41.9202832822525,43.5635025489192
0.701885807990459,0.786175497981676,1080,211,43,61,23,19,20,42,41.9202832822525,43.5635025489192
0.729546532178111,0.752642630550747,1084,207,37,47,16,15,21,32,41.9202832822525,43.5635025489192
0.755928975178176,0.785421704205841,1087,204,39,43,19,14,20,29,41.9202832822525,43.5635025489192
0.806788536076327,0.833754048170856,1074,217,43,25,25,10,18,15,41.9202832822525,43.5635025489192
0.745269107888916,0.754611972130115,1064,227,39,36,13,6,26,30,41.9202832822525,43.5635025489192
0.732544807899293,0.788855288477075,1071,220,34,86,16,26,18,60,41.9202832822525,43.5635025489192
0.763763403494837,0.829292439392015,1081,210,32,163,15,41,17,122,41.9202832822525,43.5635025489192
0.758321600965406,0.784740583441519,1066,225,48,25,26,10,22,15,41.9202832822525,43.5635025489192
0.750402576489533,0.792751982956603,1060,231,49,61,27,23,22,38,41.9202832822525,43.5635025489192
0.725333622392446,0.760519062168518,1084,207,33,59,12,14,21,45,41.9202832822525,43.5635025489192
0.767286943209156,0.796682819956083,1066,225,44,22,24,8,20,14,41.9202832822525,43.5635025489192
0.735527286135693,0.797937018755534,1076,215,48,108,25,27,23,81,41.9202832822525,43.5635025489192
0.749521951219512,0.772948609604467,1068,223,41,76,18,24,23,52,41.9202832822525,43.5635025489192
0.718530805687204,0.757064420843358,1068,223,25,36,11,10,14,26,41.9202832822525,43.5635025489192
0.706932076130609,0.758355398694739,1101,190,46,115,19,22,27,93,41.9202832822525,43.5635025489192
0.692407993436474,0.75703174789049,1046,245,27,33,15,6,12,27,41.9202832822525,43.5635025489192
0.768124921241652,0.791733749659856,1034,257,38,40,21,10,17,30,41.9202832822525,43.5635025489192
0.749343879857112,0.783848243557533,1045,246,44,50,21,10,23,40,41.9202832822525,43.5635025489192
0.717476250643456,0.762494766108769,1060,231,34,53,17,10,17,43,41.9202832822525,43.5635025489192
0.748635227571692,0.799200927910751,1071,220,24,39,15,11,9,28,41.9202832822525,43.5635025489192
0.721319003177125,0.752234421698312,1076,215,32,84,11,22,21,62,41.9202832822525,43.5635025489192
0.708040318799812,0.741027741131187,1078,213,27,39,12,8,15,31,41.9202832822525,43.5635025489192
0.763719024780176,0.827891566795132,1066,225,40,129,24,31,16,98,41.9202832822525,43.5635025489192
0.776116838487972,0.815562638798561,1056,235,30,26,18,9,12,17,41.9202832822525,43.5635025489192
0.775537634408602,0.81383439135668,1077,214,31,51,16,14,15,37,41.9202832822525,43.5635025489192
0.709761196603302,0.74473645964776,1075,216,37,32,16,9,21,23,41.9202832822525,43.5635025489192
0.739051252209147,0.787422419565198,1069,222,37,55,20,17,17,38,41.9202832822525,43.5635025489192
0.819163747417587,0.84642689308027,1076,215,54,63,32,24,22,39,41.9202832822525,43.5635025489192
0.741182119783482,0.782038243791465,1076,215,46,56,24,17,22,39,41.9202832822525,43.5635025489192
0.680436760691538,0.732602409916262,1075,216,35,34,13,9,22,25,41.9202832822525,43.5635025489192
0.771512789768185,0.77913148877038,1073,218,40,35,18,13,22,22,41.9202832822525,43.5635025489192
0.756544764188649,0.79902387840079,1048,243,40,82,20,21,20,61,41.9202832822525,43.5635025489192
0.755463414634146,0.805965148000612,1069,222,41,71,18,19,23,52,41.9202832822525,43.5635025489192
0.732976636347423,0.767999299914791,1056,235,45,58,18,16,27,42,41.9202832822525,43.5635025489192
0.682688808007279,0.710005789355285,1044,247,35,46,15,13,20,33,41.9202832822525,43.5635025489192
0.830564539841223,0.871330629749138,1071,220,38,63,23,16,15,47,41.9202832822525,43.5635025489192
0.754569162463899,0.794862158410638,1079,212,37,109,17,19,20,90,41.9202832822525,43.5635025489192
0.689044659632895,0.746255749572359,1056,235,33,58,16,16,17,42,41.9202832822525,43.5635025489192
0.74582338902148,0.783036559907942,1047,244,34,47,12,7,22,40,41.9202832822525,43.5635025489192
0.751675436854647,0.797275496016477,1088,203,32,108,15,32,17,76,41.9202832822525,43.5635025489192
0.733208399523431,0.797896425898935,1080,211,32,86,16,15,16,71,41.9202832822525,43.5635025489192
0.75385412150118,0.80512668392743,1077,214,33,65,19,19,14,46,41.9202832822525,43.5635025489192
0.762215650591447,0.819703553554611,1092,199,35,70,19,18,16,52,41.9202832822525,43.5635025489192
0.830092657588095,0.846704963277171,1068,223,34,46,19,14,15,32,41.9202832822525,43.5635025489192
0.763202744577246,0.784794860657031,1061,230,36,29,21,9,15,20,41.9202832822525,43.5635025489192
0.769664268585132,0.827112185145983,1068,223,40,80,20,23,20,57,41.9202832822525,43.5635025489192
0.796498928886462,0.839739888647394,1055,236,38,72,23,19,15,53,41.9202832822525,43.5635025489192
0.781950489026159,0.81522915871948,1073,218,34,30,19,9,15,21,41.9202832822525,43.5635025489192
0.741316457770132,0.778758879548494,1052,239,39,81,16,20,23,61,41.9202832822525,43.5635025489192
0.726488808952838,0.772329842942293,1042,249,40,67,16,16,24,51,41.9202832822525,43.5635025489192
0.733359957401491,0.782966949709115,1085,206,39,63,15,14,24,49,41.9202832822525,43.5635025489192
0.755644090305445,0.804749135060391,1060,231,36,95,21,27,15,68,41.9202832822525,43.5635025489192
0.695492380011378,0.726539972205601,1097,194,54,45,22,10,32,35,41.9202832822525,43.5635025489192
0.73459839158062,0.783149233396803,1080,211,32,53,14,14,18,39,41.9202832822525,43.5635025489192
0.732336214740673,0.782949143772222,1073,218,35,65,17,19,18,46,41.9202832822525,43.5635025489192
0.707187993680885,0.73102899558264,1079,212,25,37,11,5,14,32,41.9202832822525,43.5635025489192
0.768329646923896,0.82764123933284,1065,226,39,78,24,24,15,54,41.9202832822525,43.5635025489192
0.73693909220225,0.777291835335968,1073,218,37,43,15,8,22,35,41.9202832822525,43.5635025489192
0.711463414634146,0.732275731907116,1051,240,41,35,14,11,27,24,41.9202832822525,43.5635025489192
0.731055217897323,0.775027029062976,1065,226,37,43,19,17,18,26,41.9202832822525,43.5635025489192
0.80742720655141,0.837329707592182,1074,217,35,62,18,18,17,44,41.9202832822525,43.5635025489192
0.715782031044462,0.775035832848911,1061,230,24,16,13,7,11,9,41.9202832822525,43.5635025489192
0.749579459938026,0.798379894965803,1045,246,36,99,20,27,16,72,41.9202832822525,43.5635025489192
0.783025003613239,0.820483035719614,1066,225,33,45,20,17,13,28,41.9202832822525,43.5635025489192
0.733551231377318,0.773009849025413,1078,213,26,54,14,13,12,41,41.9202832822525,43.5635025489192
0.752507317073171,0.783878957635675,1075,216,41,59,18,14,23,45,41.9202832822525,43.5635025489192
0.813844621513944,0.822565652511543,1058,233,36,38,24,13,12,25,41.9202832822525,43.5635025489192
0.764272239872915,0.805189212535664,1063,228,32,72,17,20,15,52,41.9202832822525,43.5635025489192
0.795263390880921,0.838115937256357,1078,213,36,43,22,16,14,27,41.9202832822525,43.5635025489192
0.685704563364138,0.727068832280808,1049,242,22,62,9,19,13,43,41.9202832822525,43.5635025489192
0.755281997555439,0.826971386940814,1070,221,46,57,27,19,19,38,41.9202832822525,43.5635025489192
0.714816283372984,0.749076948947568,1063,228,30,26,12,5,18,21,41.9202832822525,43.5635025489192
0.788398430533262,0.81984437064517,1078,213,45,44,21,13,24,31,41.9202832822525,43.5635025489192
0.722418943007178,0.761740750057558,1071,220,33,29,12,8,21,21,41.9202832822525,43.5635025489192
0.76968744543391,0.808572459466874,1061,230,46,34,25,11,21,23,41.9202832822525,43.5635025489192
0.701775937105152,0.763974581593286,1069,222,34,96,15,21,19,75,41.9202832822525,43.5635025489192
0.806354515050167,0.833022279503316,1101,190,26,80,11,15,15,65,41.9202832822525,43.5635025489192
0.746759324254762,0.806747169713542,1090,201,34,68,16,20,18,48,41.9202832822525,43.5635025489192
0.776933575978162,0.803212981982312,1043,248,35,34,18,13,17,21,41.9202832822525,43.5635025489192
0.753973130171213,0.786927303063197,1070,221,39,88,19,22,20,66,41.9202832822525,43.5635025489192
0.81180618744313,0.84222055209277,1078,213,35,45,21,16,14,29,41.9202832822525,43.5635025489192
0.767707317073171,0.822687430574357,1052,239,41,86,23,32,18,54,41.9202832822525,43.5635025489192
0.682251770487064,0.732563212721309,1062,229,33,42,15,11,18,31,41.9202832822525,43.5635025489192
0.737916467127318,0.786556124919351,1061,230,47,113,19,25,28,88,41.9202832822525,43.5635025489192
0.790280312602368,0.841311487483486,1075,216,34,47,17,19,17,28,41.9202832822525,43.5635025489192
0.776808553157474,0.811668609676411,1058,233,40,78,21,24,19,54,41.9202832822525,43.5635025489192
0.712146444620671,0.744482593256512,1090,201,30,47,11,12,19,35,41.9202832822525,43.5635025489192
0.71017006311124,0.749705982611576,1080,211,33,12,15,4,18,8,41.9202832822525,43.5635025489192
0.717983910938274,0.763541440622788,1070,221,42,87,17,18,25,69,41.9202832822525,43.5635025489192
0.745229268292683,0.779017219577426,1073,218,41,37,19,7,22,30,41.9202832822525,43.5635025489192
0.782530786533989,0.808952795104068,1065,226,42,70,21,22,21,48,41.9202832822525,43.5635025489192
0.781744864955685,0.819031506003125,1065,226,38,40,21,14,17,26,41.9202832822525,43.5635025489192
0.767052223987292,0.789207589443333,1097,194,32,18,12,1,20,17,41.9202832822525,43.5635025489192
0.7263675158412,0.763959064362458,1080,211,37,62,16,12,21,50,41.9202832822525,43.5635025489192
0.754981801637853,0.809677551762746,1071,220,35,64,21,14,14,50,41.9202832822525,43.5635025489192
0.679183266932271,0.717988162582537,1054,237,36,52,14,14,22,38,41.9202832822525,43.5635025489192
0.745320412083115,0.780329337710674,1046,245,46,35,20,10,26,25,41.9202832822525,43.5635025489192
0.748428508189464,0.780533693367584,1050,241,36,84,16,24,20,60,41.9202832822525,43.5635025489192
0.792228390166535,0.834223761834399,1079,212,30,33,17,11,13,22,41.9202832822525,43.5635025489192
0.764990900818926,0.815968872371136,1066,225,35,131,16,22,19,109,41.9202832822525,43.5635025489192
0.729780876494024,0.760072944933396,1083,208,36,50,18,12,18,38,41.9202832822525,43.5635025489192
0.757779799818016,0.800498255247923,1071,220,35,40,18,12,17,28,41.9202832822525,43.5635025489192
0.617801763453937,0.650885418584325,1055,236,26,15,9,4,17,11,41.9202832822525,43.5635025489192
0.729185623293904,0.787282676438662,1051,240,35,72,18,20,17,52,41.9202832822525,43.5635025489192
0.765457233848954,0.813931251203375,1080,211,35,55,14,13,21,42,41.9202832822525,43.5635025489192
0.688567315329627,0.7201013871625,1089,202,32,43,7,7,25,36,41.9202832822525,43.5635025489192
0.742316147082334,0.80492942383464,1079,212,40,53,19,17,21,36,41.9202832822525,43.5635025489192
0.826726427622842,0.867280155895078,1101,190,36,65,22,20,14,45,41.9202832822525,43.5635025489192
0.769943676395289,0.812130303667358,1077,214,31,36,18,9,13,27,41.9202832822525,43.5635025489192
0.706935280078618,0.746260630052824,1046,245,34,54,15,15,19,39,41.9202832822525,43.5635025489192
0.751108059931589,0.786854655980932,1049,242,33,39,16,9,17,30,41.9202832822525,43.5635025489192
0.738081483733658,0.76453270922765,1071,220,26,41,12,15,14,26,41.9202832822525,43.5635025489192
0.784395750332005,0.827370267452964,1051,240,36,69,21,19,15,50,41.9202832822525,43.5635025489192
0.708629682313893,0.757026125177283,1079,212,37,37,18,11,19,26,41.9202832822525,43.5635025489192
0.724219215861658,0.761807930951064,1055,236,43,57,21,15,22,42,41.9202832822525,43.5635025489192
0.741942909760589,0.7833009177436,1083,208,24,63,9,12,15,51,41.9202832822525,43.5635025489192
0.835483738838371,0.870569100810276,1069,222,39,99,22,30,17,69,41.9202832822525,43.5635025489192
0.744532979194334,0.788814088442607,1059,232,36,49,19,19,17,30,41.9202832822525,43.5635025489192
0.759024577572965,0.806720685103541,1068,223,31,62,14,16,17,46,41.9202832822525,43.5635025489192
0.766144882774112,0.795897638095271,1060,231,34,62,15,11,19,51,41.9202832822525,43.5635025489192
0.74587326943557,0.788125763872604,1047,244,39,46,21,24,18,22,41.9202832822525,43.5635025489192
0.792510198635099,0.81462585129886,1078,213,42,59,19,14,23,45,41.9202832822525,43.5635025489192
0.765308056872038,0.792419956402224,1064,227,25,19,11,4,14,15,41.9202832822525,43.5635025489192
0.816838487972509,0.848159022910087,1074,217,30,31,17,8,13,23,41.9202832822525,43.5635025489192
0.819043924307082,0.848185934653225,1068,223,37,54,22,14,15,40,41.9202832822525,43.5635025489192
0.703013481363997,0.746392575522424,1062,229,30,70,12,18,18,52,41.9202832822525,43.5635025489192
0.728924265972193,0.773596380164734,1068,223,38,85,14,19,24,66,41.9202832822525,43.5635025489192
0.71586669699727,0.74335594875857,1055,236,35,54,14,14,21,40,41.9202832822525,43.5635025489192
0.674681676594349,0.703647756773625,1067,224,29,27,11,5,18,22,41.9202832822525,43.5635025489192
0.756143151174025,0.808215897081985,1055,236,38,52,21,14,17,38,41.9202832822525,43.5635025489192
0.749296425421095,0.793318930888078,1048,243,38,113,22,31,16,82,41.9202832822525,43.5635025489192
0.772112928437989,0.823531162451794,1047,244,42,40,24,16,18,24,41.9202832822525,43.5635025489192
0.710461657830079,0.742416914705278,1060,231,37,34,18,10,19,24,41.9202832822525,43.5635025489192
0.753614729253707,0.80480730483315,1066,225,39,61,23,18,16,43,41.9202832822525,43.5635025489192
0.742562724014337,0.775619775062698,1058,233,31,50,15,14,16,36,41.9202832822525,43.5635025489192
0.730853085867621,0.750014040451807,1073,218,43,33,19,11,24,22,41.9202832822525,43.5635025489192
0.759934053009619,0.79463070347541,1071,220,38,107,17,22,21,85,41.9202832822525,43.5635025489192
0.745053956834532,0.808220890358639,1090,201,40,58,20,19,20,39,41.9202832822525,43.5635025489192
0.812397634212921,0.859980128856992,1072,219,35,93,21,20,14,73,41.9202832822525,43.5635025489192
0.726669348350764,0.774398882850567,1077,214,48,65,21,19,27,46,41.9202832822525,43.5635025489192
0.768754988028731,0.804896576385898,1077,214,38,45,20,15,18,30,41.9202832822525,43.5635025489192
0.718637992831541,0.771930470073686,1065,226,31,74,14,18,17,56,41.9202832822525,43.5635025489192
0.721298838945898,0.766594964360557,1072,219,33,66,14,13,19,53,41.9202832822525,43.5635025489192
0.813591103064787,0.848981390489206,1036,255,37,58,25,17,12,41,41.9202832822525,43.5635025489192
0.748204309656824,0.788063391709413,1060,231,38,86,17,21,21,65,41.9202832822525,43.5635025489192
0.748817106460419,0.775220027538079,1043,248,35,25,17,12,18,13,41.9202832822525,43.5635025489192
0.743089709863129,0.794562447799335,1069,222,42,114,21,28,21,86,41.9202832822525,43.5635025489192
0.756304956035172,0.818921962347289,1071,220,40,88,25,25,15,63,41.9202832822525,43.5635025489192
0.713609112709832,0.744536933565271,1072,219,40,45,15,12,25,33,41.9202832822525,43.5635025489192
0.666040371922725,0.709507809751665,1063,228,33,42,11,10,22,32,41.9202832822525,43.5635025489192
0.738480878429226,0.779702681858844,1044,247,47,79,25,27,22,52,41.9202832822525,43.5635025489192
0.676892672544846,0.753737117302642,1046,245,26,32,13,11,13,21,41.9202832822525,43.5635025489192
0.665777378097522,0.745540182076126,1080,211,40,89,14,18,26,71,41.9202832822525,43.5635025489192
0.721070000481765,0.772318151933672,1080,211,33,51,13,10,20,41,41.9202832822525,43.5635025489192
0.778284430346286,0.795946234676868,1081,210,30,21,15,7,15,14,41.9202832822525,43.5635025489192
0.689643876643736,0.735769073826227,1065,226,34,47,13,12,21,35,41.9202832822525,43.5635025489192
0.741567606166254,0.793632410310286,1040,251,38,54,19,16,19,38,41.9202832822525,43.5635025489192
0.73437019969278,0.772227084131933,1063,228,31,33,15,11,16,22,41.9202832822525,43.5635025489192
0.739115910168542,0.776444812314417,1063,228,37,53,16,13,21,40,41.9202832822525,43.5635025489192
0.708895056833201,0.79575209989996,1081,210,30,122,13,21,17,101,41.9202832822525,43.5635025489192
0.750498007968127,0.786069606550603,1057,234,36,34,19,12,17,22,41.9202832822525,43.5635025489192
0.775497665274023,0.803980885034753,1064,227,39,34,22,15,17,19,41.9202832822525,43.5635025489192
0.722638906849433,0.761976029126908,1069,222,37,21,16,7,21,14,41.9202832822525,43.5635025489192
0.711597849708338,0.759537475819889,1070,221,42,106,15,24,27,82,41.9202832822525,43.5635025489192
0.741956147351619,0.788962136820813,1077,214,38,49,19,18,19,31,41.9202832822525,43.5635025489192
0.694508448540707,0.725347864267407,1089,202,31,37,9,5,22,32,41.9202832822525,43.5635025489192
0.779806155075939,0.818181310233038,1062,229,40,80,24,19,16,61,41.9202832822525,43.5635025489192
0.732862480460559,0.775390429236021,1063,228,42,32,21,11,21,21,41.9202832822525,43.5635025489192
0.813151219512195,0.837397244183668,1058,233,41,34,22,13,19,21,41.9202832822525,43.5635025489192
0.788816328290012,0.827747295738464,1066,225,37,35,24,12,13,23,41.9202832822525,43.5635025489192
0.770562195661797,0.814124483018659,1055,236,36,49,19,18,17,31,41.9202832822525,43.5635025489192
0.747836661546339,0.775690550703293,1069,222,31,24,15,6,16,18,41.9202832822525,43.5635025489192
0.700963081861958,0.749968652920956,1072,219,45,61,20,16,25,45,41.9202832822525,43.5635025489192
0.767991577221228,0.818637313192469,1035,256,43,88,25,29,18,59,41.9202832822525,43.5635025489192
0.697055907582223,0.754125474051385,1083,208,37,83,12,23,25,60,41.9202832822525,43.5635025489192
0.734626740540935,0.802882576041119,1050,241,44,133,22,30,22,103,41.9202832822525,43.5635025489192
0.784542366107114,0.827103304861488,1040,251,40,45,23,12,17,33,41.9202832822525,43.5635025489192
0.732014848950333,0.773933673557343,1061,230,31,34,14,10,17,24,41.9202832822525,43.5635025489192
0.713540135254337,0.755694190762832,1066,225,38,89,15,21,23,68,41.9202832822525,43.5635025489192
0.717968955538016,0.753798214898286,1067,224,24,60,9,16,15,44,41.9202832822525,43.5635025489192
0.800212925265572,0.83748866347894,1054,237,34,67,20,23,14,44,41.9202832822525,43.5635025489192
0.75883143613223,0.813634216093277,1058,233,38,62,20,16,18,46,41.9202832822525,43.5635025489192
0.74436763952893,0.783152579506234,1066,225,31,22,16,5,15,17,41.9202832822525,43.5635025489192
0.74473871945782,0.794305477509337,1074,217,45,44,22,14,23,30,41.9202832822525,43.5635025489192
0.731532962668785,0.785375484665282,1075,216,32,53,15,13,17,40,41.9202832822525,43.5635025489192
0.72390205371248,0.752902217038396,1054,237,25,38,14,12,11,26,41.9202832822525,43.5635025489192
0.738578610853052,0.776046478816602,1083,208,29,74,14,12,15,62,41.9202832822525,43.5635025489192
0.788674369109152,0.818082914613861,1079,212,26,70,12,16,14,54,41.9202832822525,43.5635025489192
0.76930433357014,0.816370238632904,1073,218,29,50,15,12,14,38,41.9202832822525,43.5635025489192
0.797255422753431,0.836007792581238,1061,230,36,45,22,14,14,31,41.9202832822525,43.5635025489192
0.748109130199892,0.782628772785572,1035,256,57,54,28,21,29,33,41.9202832822525,43.5635025489192
0.687583205325141,0.725469774796891,1080,211,31,51,11,10,20,41,41.9202832822525,43.5635025489192
0.706493888352165,0.743140676645764,1087,204,38,40,14,10,24,30,41.9202832822525,43.5635025489192
0.763338453661034,0.794866745426755,1076,215,31,41,15,14,16,27,41.9202832822525,43.5635025489192
0.750349279761045,0.793529906339735,1033,258,33,55,17,16,16,39,41.9202832822525,43.5635025489192
0.655581608143658,0.728118532927554,1070,221,42,179,14,30,28,149,41.9202832822525,43.5635025489192
0.716252981514609,0.776018669844677,1064,227,43,63,23,20,20,43,41.9202832822525,43.5635025489192
0.711922596754057,0.758772580327542,1070,221,45,50,18,15,27,35,41.9202832822525,43.5635025489192
0.766918832708306,0.810670122586106,1076,215,37,51,18,15,19,36,41.9202832822525,43.5635025489192
0.723918653231752,0.765369407355694,1063,228,39,46,18,14,21,32,41.9202832822525,43.5635025489192
0.731613874256003,0.75860749369854,1084,207,47,26,18,2,29,24,41.9202832822525,43.5635025489192
0.674890087929656,0.723691443728569,1052,239,40,44,17,12,23,32,41.9202832822525,43.5635025489192
0.727828981054788,0.759960357189999,1059,232,31,38,13,11,18,27,41.9202832822525,43.5635025489192
0.701551717564528,0.763050163452764,1045,246,42,82,19,19,23,63,41.9202832822525,43.5635025489192
0.718426294820717,0.777204517214767,1062,229,36,68,18,20,18,48,41.9202832822525,43.5635025489192
0.701871525019857,0.759861947545644,1064,227,32,53,12,13,20,40,41.9202832822525,43.5635025489192
0.733924329826943,0.77549500590257,1114,177,28,57,9,13,19,44,41.9202832822525,43.5635025489192
0.770075068243858,0.808972138331087,1081,210,35,51,18,16,17,35,41.9202832822525,43.5635025489192
0.793160690571049,0.845791542536389,1075,216,36,63,20,19,16,44,41.9202832822525,43.5635025489192
0.774534788260245,0.807216322381031,1036,255,47,41,24,14,23,27,41.9202832822525,43.5635025489192
0.677627897681854,0.716827242820125,1066,225,40,47,15,15,25,32,41.9202832822525,43.5635025489192
0.784580568526255,0.824305884123918,1071,220,39,50,23,13,16,37,41.9202832822525,43.5635025489192
0.758718048191733,0.816045673531748,1079,212,37,91,20,29,17,62,41.9202832822525,43.5635025489192
0.664918065547562,0.744163111202752,1079,212,40,148,18,37,22,111,41.9202832822525,43.5635025489192
0.773996840442338,0.80295065356846,1088,203,25,39,11,10,14,29,41.9202832822525,43.5635025489192
0.69587206728641,0.733622042110458,1065,226,36,60,13,16,23,44,41.9202832822525,43.5635025489192
0.738749000799361,0.767937078376705,1063,228,40,75,17,23,23,52,41.9202832822525,43.5635025489192
0.737329390354868,0.776401012603268,1063,228,35,33,17,12,18,21,41.9202832822525,43.5635025489192
0.759553944458098,0.799244627111785,1089,202,39,75,18,20,21,55,41.9202832822525,43.5635025489192
0.772824259666365,0.810009697966171,1067,224,37,34,19,12,18,22,41.9202832822525,43.5635025489192
0.708319194661237,0.742727181379843,1091,200,28,66,9,14,19,52,41.9202832822525,43.5635025489192
0.749759642574369,0.790894044671871,1078,213,28,29,14,9,14,20,41.9202832822525,43.5635025489192
0.769389110225764,0.805722143835979,1069,222,36,30,18,13,18,17,41.9202832822525,43.5635025489192
0.716069301032565,0.769019853087584,1049,242,32,88,18,28,14,60,41.9202832822525,43.5635025489192
0.742611434108527,0.786297923018358,1080,211,43,50,23,13,20,37,41.9202832822525,43.5635025489192
0.797171000126013,0.845244732275861,1077,214,38,65,19,17,19,48,41.9202832822525,43.5635025489192
0.760985365853659,0.813600529817605,1051,240,41,44,23,19,18,25,41.9202832822525,43.5635025489192
0.732536520584329,0.769231859462393,1060,231,36,47,16,15,20,32,41.9202832822525,43.5635025489192
0.741706795077582,0.786674373397112,1066,225,45,51,22,17,23,34,41.9202832822525,43.5635025489192
0.690682926829268,0.715489296905988,1060,231,41,39,12,5,29,34,41.9202832822525,43.5635025489192
0.755770949166005,0.789154567374685,1059,232,32,40,17,10,15,30,41.9202832822525,43.5635025489192
0.739728110814732,0.771647695432312,1055,236,34,32,16,11,18,21,41.9202832822525,43.5635025489192
0.680354719453414,0.729047616648822,1055,236,34,37,15,11,19,26,41.9202832822525,43.5635025489192
0.758881754949171,0.806480662987854,1064,227,45,43,24,11,21,32,41.9202832822525,43.5635025489192
0.773923444976077,0.805122584540926,1074,217,37,71,18,21,19,50,41.9202832822525,43.5635025489192
0.711232846392209,0.744450220534947,1068,223,36,50,17,13,19,37,41.9202832822525,43.5635025489192
0.776338928856914,0.815969220697751,1094,197,40,44,21,12,19,32,41.9202832822525,43.5635025489192
0.757213508934915,0.787573788300836,1077,214,29,80,12,17,17,63,41.9202832822525,43.5635025489192
0.719354516386891,0.74864497750519,1066,225,40,69,16,15,24,54,41.9202832822525,43.5635025489192
0.80284178187404,0.840641469818637,1076,215,31,41,17,14,14,27,41.9202832822525,43.5635025489192
0.759820248480042,0.798464085286252,1052,239,30,50,20,22,10,28,41.9202832822525,43.5635025489192
0.731059010716459,0.778207791288727,1073,218,34,49,15,16,19,33,41.9202832822525,43.5635025489192
0.743706625285573,0.77300652339967,1065,226,37,34,16,9,21,25,41.9202832822525,43.5635025489192
0.782923661071143,0.835764491128511,1063,228,40,97,19,27,21,70,41.9202832822525,43.5635025489192
0.726335186861503,0.768274060706602,1077,214,37,60,18,17,19,43,41.9202832822525,43.5635025489192
0.733901406839758,0.787379660554061,1071,220,42,59,20,19,22,40,41.9202832822525,43.5635025489192
0.722727272727273,0.782103234726346,1085,206,26,76,9,22,17,54,41.9202832822525,43.5635025489192
0.74959032773781,0.785117616732178,1046,245,40,58,18,16,22,42,41.9202832822525,43.5635025489192
0.766909851826716,0.797392562191347,1083,208,28,40,14,8,14,32,41.9202832822525,43.5635025489192
0.754736609119079,0.817530991684825,1054,237,36,105,18,23,18,82,41.9202832822525,43.5635025489192
0.739028213166144,0.788948990852589,1061,230,44,46,22,12,22,34,41.9202832822525,43.5635025489192
0.771093064928133,0.806306953813746,1057,234,42,50,22,17,20,33,41.9202832822525,43.5635025489192
0.756626202377452,0.781052505334906,1045,246,38,76,16,26,22,50,41.9202832822525,43.5635025489192
0.755987311657415,0.794681984551502,1097,194,30,135,16,30,14,105,41.9202832822525,43.5635025489192
0.74705621956618,0.800715098938883,1066,225,36,47,20,13,16,34,41.9202832822525,43.5635025489192
0.669687804878049,0.701085204503509,1041,250,41,80,16,21,25,59,41.9202832822525,43.5635025489192
0.777299909887769,0.811568281542972,1058,233,39,58,22,18,17,40,41.9202832822525,43.5635025489192
0.776926829268293,0.826821227445373,1054,237,41,56,21,19,20,37,41.9202832822525,43.5635025489192
0.74546178343949,0.808775033851528,1081,210,35,101,19,24,16,77,41.9202832822525,43.5635025489192
0.773772754925359,0.822982779911553,1049,242,34,43,19,15,15,28,41.9202832822525,43.5635025489192
0.732813921747043,0.78370266606172,1072,219,35,51,17,8,18,43,41.9202832822525,43.5635025489192
0.775019825535289,0.803597582143721,1062,229,30,54,15,12,15,42,41.9202832822525,43.5635025489192
0.812608806963646,0.833962571699579,1056,235,31,44,21,16,10,28,41.9202832822525,43.5635025489192
0.758486943164362,0.821782328817895,1091,200,31,52,16,16,15,36,41.9202832822525,43.5635025489192
0.723473433782712,0.76030642722462,1089,202,30,26,10,4,20,22,41.9202832822525,43.5635025489192
0.687842201319669,0.713894896908856,1065,226,34,28,12,8,22,20,41.9202832822525,43.5635025489192
0.73943442111144,0.787669665850564,1062,229,49,56,24,21,25,35,41.9202832822525,43.5635025489192
0.778496410849352,0.829536896478419,1042,249,33,119,21,39,12,80,41.9202832822525,43.5635025489192
0.766851576499295,0.811425193670426,1071,220,42,77,21,26,21,51,41.9202832822525,43.5635025489192
0.72430618744313,0.76019303834687,1069,222,35,44,17,17,18,27,41.9202832822525,43.5635025489192
0.7668,0.827512160392858,1084,207,41,43,22,13,19,30,41.9202832822525,43.5635025489192
0.698614634146341,0.727305242771248,1074,217,41,86,15,16,26,70,41.9202832822525,43.5635025489192
0.794495452390189,0.831440592376146,1055,236,37,31,22,11,15,20,41.9202832822525,43.5635025489192
0.719663999251252,0.746633073838328,1061,230,34,78,14,15,20,63,41.9202832822525,43.5635025489192
0.677211576648133,0.718232840656207,1089,202,32,56,14,9,18,47,41.9202832822525,43.5635025489192
0.7460931254996,0.782726971545817,1057,234,40,46,21,12,19,34,41.9202832822525,43.5635025489192
0.78541856232939,0.831656913440151,1079,212,35,20,18,6,17,14,41.9202832822525,43.5635025489192
0.79859915151006,0.841099477546773,1066,225,38,82,22,22,16,60,41.9202832822525,43.5635025489192
0.731518548171871,0.762865374992144,1045,246,42,64,21,24,21,40,41.9202832822525,43.5635025489192
0.67784178187404,0.698178741793291,1075,216,31,30,8,7,23,23,41.9202832822525,43.5635025489192
0.754208371246588,0.802034797378891,1066,225,35,79,21,24,14,55,41.9202832822525,43.5635025489192
0.720194171138938,0.752774575765888,1073,218,43,57,21,23,22,34,41.9202832822525,43.5635025489192
0.706449044585987,0.744267851129227,1068,223,35,70,15,12,20,58,41.9202832822525,43.5635025489192
0.741756626202377,0.779145549404249,1072,219,38,37,17,8,21,29,41.9202832822525,43.5635025489192
0.713194346951191,0.737602914112601,1071,220,34,36,16,8,18,28,41.9202832822525,43.5635025489192
0.691223896378536,0.732242075116505,1086,205,30,66,10,15,20,51,41.9202832822525,43.5635025489192
0.734412341715712,0.77268238467536,1063,228,45,66,20,25,25,41,41.9202832822525,43.5635025489192
0.730764257080046,0.784377925753972,1077,214,37,39,19,8,18,31,41.9202832822525,43.5635025489192
0.725972994440032,0.775786089540328,1077,214,32,23,16,9,16,14,41.9202832822525,43.5635025489192
0.719014700256845,0.777698490794102,1092,199,29,98,12,24,17,74,41.9202832822525,43.5635025489192
0.766224219767295,0.79967278317918,1066,225,38,58,16,15,22,43,41.9202832822525,43.5635025489192
0.765334712703134,0.811032998160112,1089,202,37,64,19,15,18,49,41.9202832822525,43.5635025489192
0.787951747418586,0.811165053983857,1064,227,32,55,17,18,15,37,41.9202832822525,43.5635025489192
0.738151792783622,0.763443933528822,1056,235,28,30,12,4,16,26,41.9202832822525,43.5635025489192
0.680425386715196,0.719022435088324,1069,222,35,64,13,15,22,49,41.9202832822525,43.5635025489192
0.727410502170886,0.782706352944007,1063,228,39,65,20,20,19,45,41.9202832822525,43.5635025489192
0.722109130048201,0.756459410526195,1067,224,34,44,13,14,21,30,41.9202832822525,43.5635025489192
0.785613103142984,0.810626460032362,1049,242,36,20,17,4,19,16,41.9202832822525,43.5635025489192
0.768815165876777,0.810063955120195,1090,201,25,48,13,11,12,37,41.9202832822525,43.5635025489192
0.738887199756765,0.794025212983377,1054,237,26,46,11,12,15,34,41.9202832822525,43.5635025489192
0.696953029509342,0.748427274165922,1031,260,46,71,21,20,25,51,41.9202832822525,43.5635025489192
0.746874865295918,0.787618744568499,1063,228,37,67,17,19,20,48,41.9202832822525,43.5635025489192
0.767405063291139,0.822792860208416,1086,205,27,50,16,17,11,33,41.9202832822525,43.5635025489192
0.719787980381201,0.766878219641059,1086,205,52,52,24,19,28,33,41.9202832822525,43.5635025489192
0.754096722621903,0.795397683091568,1050,241,40,84,24,34,16,50,41.9202832822525,43.5635025489192
0.693799699118848,0.739545809239835,1085,206,22,67,8,12,14,55,41.9202832822525,43.5635025489192
0.728672853309481,0.763040595691143,1066,225,43,44,21,8,22,36,41.9202832822525,43.5635025489192
0.737899622716442,0.783527000739398,1068,223,32,33,15,8,17,25,41.9202832822525,43.5635025489192
0.757045138035553,0.793886583693837,1058,233,39,36,20,11,19,25,41.9202832822525,43.5635025489192
0.803938673010838,0.819900550808116,1063,228,30,52,17,15,13,37,41.9202832822525,43.5635025489192
0.774532518321338,0.808380533689113,1042,249,49,51,25,17,24,34,41.9202832822525,43.5635025489192
0.763675610689109,0.803272983131091,1086,205,29,22,15,3,14,19,41.9202832822525,43.5635025489192
0.734302039813222,0.754981611158142,1066,225,39,43,15,13,24,30,41.9202832822525,43.5635025489192
0.684886088487783,0.709969316150506,1067,224,59,59,24,16,35,43,41.9202832822525,43.5635025489192
0.732825071060365,0.759708679165634,1070,221,33,46,14,13,19,33,41.9202832822525,43.5635025489192
0.717372831692452,0.767503834344184,1057,234,27,35,13,13,14,22,41.9202832822525,43.5635025489192
0.686581612390786,0.742295089559037,1072,219,32,83,13,19,19,64,41.9202832822525,43.5635025489192
0.667131707317073,0.699264346979571,1081,210,41,67,14,19,27,48,41.9202832822525,43.5635025489192
0.778924021838034,0.808433340763679,1069,222,35,43,18,10,17,33,41.9202832822525,43.5635025489192
0.719863602850823,0.766218487180458,1095,196,39,57,13,11,26,46,41.9202832822525,43.5635025489192
0.748151804091234,0.777808559256671,1067,224,38,43,18,11,20,32,41.9202832822525,43.5635025489192
0.644919082605242,0.698181389601948,1050,241,32,38,12,6,20,32,41.9202832822525,43.5635025489192
0.713385977375813,0.782575095496427,1088,203,29,92,9,16,20,76,41.9202832822525,43.5635025489192
0.700627757041059,0.760599164539195,1051,240,28,34,11,9,17,25,41.9202832822525,43.5635025489192
0.772609561752988,0.798758081629717,1074,217,36,116,15,30,21,86,41.9202832822525,43.5635025489192
0.751139272913466,0.78056004882141,1058,233,31,55,15,12,16,43,41.9202832822525,43.5635025489192
0.736633490483674,0.782021478990082,1051,240,46,60,26,25,20,35,41.9202832822525,43.5635025489192
0.742770541492586,0.784012168247547,1069,222,39,41,19,11,20,30,41.9202832822525,43.5635025489192
0.703143634466309,0.742155369750558,1060,231,43,61,17,18,26,43,41.9202832822525,43.5635025489192
0.764036478984933,0.804810542762596,1080,211,30,42,18,11,12,31,41.9202832822525,43.5635025489192
0.742163330300273,0.792960548473981,1081,210,35,49,18,10,17,39,41.9202832822525,43.5635025489192
0.707088667614983,0.767936546807791,1077,214,37,119,17,27,20,92,41.9202832822525,43.5635025489192
0.715903702745808,0.768086714988513,1072,219,37,44,11,12,26,32,41.9202832822525,43.5635025489192
0.792593328038125,0.828533460720064,1063,228,32,34,17,7,15,27,41.9202832822525,43.5635025489192
0.722997061232355,0.773583088307263,1061,230,33,19,14,8,19,11,41.9202832822525,43.5635025489192
0.717574033363507,0.747019104648082,1081,210,37,37,14,12,23,25,41.9202832822525,43.5635025489192
0.672755341821957,0.70878783327458,1046,245,29,55,10,18,19,37,41.9202832822525,43.5635025489192
0.758383293365308,0.796102539984338,1069,222,40,26,21,14,19,12,41.9202832822525,43.5635025489192
0.767288026211279,0.783324251968753,1066,225,32,40,14,6,18,34,41.9202832822525,43.5635025489192
0.752380952380952,0.84184614285559,1056,235,31,60,17,15,14,45,41.9202832822525,43.5635025489192
0.710343118237855,0.770544690558458,1077,214,37,66,18,19,19,47,41.9202832822525,43.5635025489192
0.703677058353317,0.739469310990102,1057,234,40,41,16,14,24,27,41.9202832822525,43.5635025489192
0.757737402474245,0.814670009792833,1073,218,37,79,20,23,17,56,41.9202832822525,43.5635025489192
0.771802557953637,0.797601292777435,1075,216,40,28,21,9,19,19,41.9202832822525,43.5635025489192
0.700233320095314,0.74231299295131,1076,215,32,30,13,7,19,23,41.9202832822525,43.5635025489192
0.764532863383638,0.842714296699687,1072,219,32,39,18,13,14,26,41.9202832822525,43.5635025489192
0.757990012484394,0.812499696592591,1061,230,45,89,27,30,18,59,41.9202832822525,43.5635025489192
0.70952889197776,0.759876686678815,1079,212,32,54,14,14,18,40,41.9202832822525,43.5635025489192
0.731675557609107,0.788710547826606,1061,230,38,40,22,12,16,28,41.9202832822525,43.5635025489192
0.724924121982946,0.761280337659255,1076,215,33,35,12,11,21,24,41.9202832822525,43.5635025489192
0.717557394156231,0.753313108640682,1047,244,43,39,18,11,25,28,41.9202832822525,43.5635025489192
0.701179278393935,0.752624061267755,1078,213,34,82,12,18,22,64,41.9202832822525,43.5635025489192
0.752936585365854,0.773729011377877,1059,232,41,41,18,13,23,28,41.9202832822525,43.5635025489192
0.692351219512195,0.730420612895461,1081,210,41,63,15,8,26,55,41.9202832822525,43.5635025489192
0.730822753440848,0.774655881690285,1052,239,42,53,19,12,23,41,41.9202832822525,43.5635025489192
0.64255201416556,0.688484014617855,1072,219,36,42,10,10,26,32,41.9202832822525,43.5635025489192
0.764442079659471,0.804142780650535,1056,235,26,53,13,16,13,37,41.9202832822525,43.5635025489192
0.756778897353977,0.805942379299939,1067,224,39,58,22,18,17,40,41.9202832822525,43.5635025489192
0.746073613720672,0.801785489843849,1081,210,33,57,18,15,15,42,41.9202832822525,43.5635025489192
0.758702199855122,0.786031184048958,1068,223,42,25,21,8,21,17,41.9202832822525,43.5635025489192
0.710772248974496,0.762482556055216,1058,233,45,73,23,22,22,51,41.9202832822525,43.5635025489192
0.692417061611374,0.753721322533715,1072,219,25,94,9,25,16,69,41.9202832822525,43.5635025489192
0.73193644999766,0.769315595319988,1093,198,34,77,14,15,20,62,41.9202832822525,43.5635025489192
0.713269025968706,0.746471888767429,1081,210,39,41,17,12,22,29,41.9202832822525,43.5635025489192
0.796493402347452,0.849225412331333,1071,220,44,71,26,22,18,49,41.9202832822525,43.5635025489192
0.768860988575953,0.836648584925237,1077,214,28,27,17,12,11,15,41.9202832822525,43.5635025489192
0.715908372827804,0.758358040383476,1078,213,25,55,9,7,16,48,41.9202832822525,43.5635025489192
0.763955342902711,0.843725703266253,1087,204,37,183,16,36,21,147,41.9202832822525,43.5635025489192
0.746781164695177,0.785773080617329,1072,219,35,56,16,14,19,42,41.9202832822525,43.5635025489192
0.794621513944223,0.836470573353658,1059,232,36,36,22,10,14,26,41.9202832822525,43.5635025489192
0.772491800834824,0.820779673707049,1073,218,43,54,23,19,20,35,41.9202832822525,43.5635025489192
0.743538626852166,0.783878545673525,1080,211,28,30,16,6,12,24,41.9202832822525,43.5635025489192
0.76339928057554,0.808557033984626,1096,195,40,127,18,28,22,99,41.9202832822525,43.5635025489192
0.773123293903549,0.830020708278919,1083,208,35,56,19,15,16,41,41.9202832822525,43.5635025489192
0.72817618415228,0.77481565103839,1056,235,36,49,18,16,18,33,41.9202832822525,43.5635025489192
0.795416257195002,0.811688166755507,1079,212,34,48,17,12,17,36,41.9202832822525,43.5635025489192
0.752560691113217,0.792584658146686,1080,211,44,50,20,14,24,36,41.9202832822525,43.5635025489192
0.797200039436064,0.83519974525021,1044,247,49,36,33,18,16,18,41.9202832822525,43.5635025489192
0.664511401353507,0.717043584015558,1053,238,37,46,13,17,24,29,41.9202832822525,43.5635025489192
0.757990243902439,0.813725266078841,1076,215,41,46,24,23,17,23,41.9202832822525,43.5635025489192
0.726223339577377,0.769364533483497,1070,221,49,45,21,9,28,36,41.9202832822525,43.5635025489192
0.708337124658781,0.760036784273834,1047,244,35,58,14,16,21,42,41.9202832822525,43.5635025489192
0.743412322274882,0.817294841844715,1059,232,25,80,14,21,11,59,41.9202832822525,43.5635025489192
0.742935651478817,0.824756047903822,1083,208,40,145,17,31,23,114,41.9202832822525,43.5635025489192
0.764386524971647,0.794515071171886,1074,217,38,45,20,16,18,29,41.9202832822525,43.5635025489192
0.709068801573856,0.764157903061967,1111,180,29,45,8,14,21,31,41.9202832822525,43.5635025489192
0.732818476022359,0.780787658355132,1074,217,55,94,25,27,30,67,41.9202832822525,43.5635025489192
0.768561201327048,0.806758589766837,1037,254,46,54,29,21,17,33,41.9202832822525,43.5635025489192
0.721045912222383,0.771918192849877,1082,209,33,34,14,13,19,21,41.9202832822525,43.5635025489192
0.765821812596006,0.793506417632538,1065,226,31,49,12,8,19,41,41.9202832822525,43.5635025489192
0.752263414634146,0.786196310475457,1067,224,41,43,22,13,19,30,41.9202832822525,43.5635025489192
0.741831560486484,0.797050948930824,1079,212,42,82,21,22,21,60,41.9202832822525,43.5635025489192
0.746812749003984,0.789546012225961,1083,208,36,38,19,13,17,25,41.9202832822525,43.5635025489192
0.782515885623511,0.821826290558502,1069,222,32,48,15,13,17,35,41.9202832822525,43.5635025489192
0.701568866299828,0.739523341357246,1075,216,38,37,14,11,24,26,41.9202832822525,43.5635025489192
0.789161392405063,0.819315718645554,1044,247,27,54,17,22,10,32,41.9202832822525,43.5635025489192
0.701883935663225,0.772187506062164,1082,209,32,80,17,15,15,65,41.9202832822525,43.5635025489192
0.659560975609756,0.72150013341875,1058,233,41,56,18,14,23,42,41.9202832822525,43.5635025489192
0.69483831718845,0.753869838962733,1054,237,34,100,16,27,18,73,41.9202832822525,43.5635025489192
0.763340317792911,0.794709383513925,1067,224,46,71,24,23,22,48,41.9202832822525,43.5635025489192
0.787986551144446,0.865003545363319,1068,223,37,87,21,23,16,64,41.9202832822525,43.5635025489192
0.735035913806864,0.774844149758825,1060,231,38,54,21,17,17,37,41.9202832822525,43.5635025489192
0.78230411686587,0.826747509033144,1071,220,36,87,20,27,16,60,41.9202832822525,43.5635025489192
0.702847232258997,0.760793455868654,1090,201,33,60,14,17,19,43,41.9202832822525,43.5635025489192
0.706397968378799,0.731431918226436,1043,248,39,36,16,9,23,27,41.9202832822525,43.5635025489192
0.796477949614733,0.840776804930778,1083,208,29,43,17,10,12,33,41.9202832822525,43.5635025489192
0.789574516756262,0.817504477723102,1057,234,42,58,24,18,18,40,41.9202832822525,43.5635025489192
0.776460481099656,0.812457868132395,1055,236,30,65,14,14,16,51,41.9202832822525,43.5635025489192
0.644783844864037,0.696548203419135,1033,258,44,50,20,16,24,34,41.9202832822525,43.5635025489192
0.74710244385985,0.778646443504631,1067,224,42,75,13,15,29,60,41.9202832822525,43.5635025489192
0.73860487804878,0.809950010171962,1068,223,41,121,20,23,21,98,41.9202832822525,43.5635025489192
0.77740487804878,0.812245845532624,1039,252,41,38,26,14,15,24,41.9202832822525,43.5635025489192
0.735725659690628,0.797000607346921,1049,242,35,66,18,18,17,48,41.9202832822525,43.5635025489192
0.780854430379747,0.823757872141315,1084,207,27,23,14,5,13,18,41.9202832822525,43.5635025489192
0.711610141721963,0.755137777591693,1072,219,39,46,20,15,19,31,41.9202832822525,43.5635025489192
0.767745803357314,0.805090397011313,1046,245,40,34,25,10,15,24,41.9202832822525,43.5635025489192
0.729011652393654,0.787905305297435,1075,216,34,81,16,23,18,58,41.9202832822525,43.5635025489192
0.796392885691447,0.826663336203018,1087,204,40,52,19,17,21,35,41.9202832822525,43.5635025489192
0.765636157432688,0.807517656354636,1070,221,38,78,22,25,16,53,41.9202832822525,43.5635025489192
0.744392405594993,0.791365626404604,1053,238,38,67,18,18,20,49,41.9202832822525,43.5635025489192
0.84635622204683,0.888715406200668,1091,200,24,41,19,17,5,24,41.9202832822525,43.5635025489192
0.765721419654004,0.822490281383237,1088,203,45,119,23,33,22,86,41.9202832822525,43.5635025489192
0.71474358974359,0.736024159051676,1059,232,39,31,13,6,26,25,41.9202832822525,43.5635025489192
0.765267785771383,0.804464125734228,1045,246,40,59,25,16,15,43,41.9202832822525,43.5635025489192
0.780476669648181,0.81770766902457,1082,209,43,29,21,13,22,16,41.9202832822525,43.5635025489192
0.753217277364406,0.802398821654045,1085,206,34,127,17,29,17,98,41.9202832822525,43.5635025489192
0.790104824746128,0.833984416485016,1076,215,34,33,19,8,15,25,41.9202832822525,43.5635025489192
0.762113284804368,0.794725646084283,1079,212,35,25,19,7,16,18,41.9202832822525,43.5635025489192
0.766208530805687,0.785557186541497,1059,232,25,37,12,9,13,28,41.9202832822525,43.5635025489192
0.658741463414634,0.688949618463517,1068,223,41,35,14,9,27,26,41.9202832822525,43.5635025489192
0.68458177278402,0.713487481466894,1071,220,45,23,19,6,26,17,41.9202832822525,43.5635025489192
0.738910917261433,0.770267561488306,1065,226,30,62,14,14,16,48,41.9202832822525,43.5635025489192
0.79110243902439,0.831808085307841,1060,231,41,58,22,19,19,39,41.9202832822525,43.5635025489192
0.787772503885412,0.850154223085805,1069,222,38,86,23,33,15,53,41.9202832822525,43.5635025489192
0.800526128054218,0.835902417727796,1066,225,45,24,27,13,18,11,41.9202832822525,43.5635025489192
0.757815776430668,0.804447581720831,1069,222,42,35,24,14,18,21,41.9202832822525,43.5635025489192
0.719446329600724,0.788929475710583,1080,211,28,58,11,11,17,47,41.9202832822525,43.5635025489192
0.770674940369708,0.810019361686561,1067,224,43,108,21,27,22,81,41.9202832822525,43.5635025489192
0.683939873417721,0.728359714476297,1084,207,27,33,9,5,18,28,41.9202832822525,43.5635025489192
0.68542817679558,0.724216148308503,1074,217,24,26,11,3,13,23,41.9202832822525,43.5635025489192
0.763978494623656,0.832027585894183,1078,213,31,57,20,17,11,40,41.9202832822525,43.5635025489192
0.695484868813357,0.731807360871891,1056,235,43,75,17,19,26,56,41.9202832822525,43.5635025489192
0.817535545023697,0.838737054437035,1068,223,25,49,16,18,9,31,41.9202832822525,43.5635025489192
0.721278048780488,0.773762413581385,1069,222,41,63,19,18,22,45,41.9202832822525,43.5635025489192
0.763742789277231,0.806263728172617,1076,215,28,45,16,18,12,27,41.9202832822525,43.5635025489192
0.718852518772326,0.788319919826892,1085,206,44,65,19,22,25,43,41.9202832822525,43.5635025489192
0.654071773636991,0.69090177984055,1078,213,49,32,18,10,31,22,41.9202832822525,43.5635025489192
0.768679704849918,0.81371717302569,1057,234,22,18,11,7,11,11,41.9202832822525,43.5635025489192
0.76326688193177,0.805642749518679,1063,228,34,33,16,13,18,20,41.9202832822525,43.5635025489192
0.702335104028331,0.743005994883121,1074,217,36,41,14,10,22,31,41.9202832822525,43.5635025489192
0.805140821174075,0.83841902903192,1046,245,28,46,18,16,10,30,41.9202832822525,43.5635025489192
0.73763478668542,0.788411617724298,1052,239,27,27,12,8,15,19,41.9202832822525,43.5635025489192
0.751323047107931,0.792511284366665,1069,222,43,79,23,24,20,55,41.9202832822525,43.5635025489192
0.740654337744599,0.788711023113576,1073,218,28,54,12,10,16,44,41.9202832822525,43.5635025489192
0.722138514406556,0.745477248159112,1061,230,30,43,10,9,20,34,41.9202832822525,43.5635025489192
0.760651478816947,0.791266941050548,1063,228,40,48,22,15,18,33,41.9202832822525,43.5635025489192
0.710483210483211,0.736116723994719,1040,251,33,36,13,16,20,20,41.9202832822525,43.5635025489192
0.755891719745223,0.789546504037911,1072,219,35,39,18,13,17,26,41.9202832822525,43.5635025489192
0.615229754322111,0.690079265966606,1088,203,35,180,11,36,24,144,41.9202832822525,43.5635025489192
0.747553240643508,0.796467422265805,1066,225,38,22,23,11,15,11,41.9202832822525,43.5635025489192
0.755603689814216,0.818206785521131,1069,222,37,66,20,22,17,44,41.9202832822525,43.5635025489192
0.682219662058372,0.726154453596862,1088,203,31,36,9,13,22,23,41.9202832822525,43.5635025489192
0.700159872102318,0.763163098548079,1076,215,40,47,18,14,22,33,41.9202832822525,43.5635025489192
0.70218079225285,0.732246603407557,1066,225,42,29,17,12,25,17,41.9202832822525,43.5635025489192
0.754601953779981,0.780864967525635,1069,222,44,37,20,13,24,24,41.9202832822525,43.5635025489192
0.778109783089863,0.814327737739518,1050,241,36,66,20,19,16,47,41.9202832822525,43.5635025489192
0.757696198872669,0.801186872743707,1067,224,33,46,18,14,15,32,41.9202832822525,43.5635025489192
0.722638649954944,0.772644542145772,1071,220,39,65,17,19,22,46,41.9202832822525,43.5635025489192
0.746543110394843,0.801794659616674,1063,228,50,61,27,18,23,43,41.9202832822525,43.5635025489192
0.740413559553944,0.795366554172937,1086,205,47,52,23,17,24,35,41.9202832822525,43.5635025489192
0.697949946751864,0.720616950788617,1049,242,39,34,14,9,25,25,41.9202832822525,43.5635025489192
0.757080046553731,0.798836239755868,1084,207,37,35,15,8,22,27,41.9202832822525,43.5635025489192
0.720325295723385,0.760888412400745,1055,236,35,30,17,11,18,19,41.9202832822525,43.5635025489192
0.803355494531965,0.841915083750857,1046,245,33,43,20,14,13,29,41.9202832822525,43.5635025489192
0.760733221259537,0.789081266761149,1069,222,37,33,17,11,20,22,41.9202832822525,43.5635025489192
0.725405742821473,0.755955943343647,1074,217,45,69,18,13,27,56,41.9202832822525,43.5635025489192
0.746776158272777,0.805942805220315,1074,217,38,67,20,18,18,49,41.9202832822525,43.5635025489192
0.695970034205328,0.733779731179855,1076,215,33,26,13,3,20,23,41.9202832822525,43.5635025489192
0.741957903097696,0.763163057754791,1052,239,32,20,12,4,20,16,41.9202832822525,43.5635025489192
0.720796404418868,0.73145942181876,1069,222,38,30,17,8,21,22,41.9202832822525,43.5635025489192
0.699320543565148,0.758064042730066,1043,248,40,36,17,13,23,23,41.9202832822525,43.5635025489192
0.799563838223632,0.839081551869644,1083,208,30,63,19,21,11,42,41.9202832822525,43.5635025489192
0.720617885495863,0.760277622992862,1057,234,38,49,15,13,23,36,41.9202832822525,43.5635025489192
0.675614591593973,0.746603746928479,1068,223,30,37,14,7,16,30,41.9202832822525,43.5635025489192
0.779006197432492,0.841782827104428,1050,241,36,99,22,25,14,74,41.9202832822525,43.5635025489192
0.774,0.816569435520631,1045,246,41,37,24,8,17,29,41.9202832822525,43.5635025489192
0.689388120839734,0.732134016236536,1087,204,31,21,12,8,19,13,41.9202832822525,43.5635025489192
0.771125174080446,0.807632132498397,1077,214,39,54,19,17,20,37,41.9202832822525,43.5635025489192
0.714328537170264,0.743024477751884,1066,225,40,56,20,18,20,38,41.9202832822525,43.5635025489192
0.67330135891287,0.709802124771919,1041,250,40,40,13,9,27,31,41.9202832822525,43.5635025489192
0.803436426116838,0.848981052448555,1053,238,30,62,18,16,12,46,41.9202832822525,43.5635025489192
0.753878525932666,0.796450098645548,1073,218,35,51,16,12,19,39,41.9202832822525,43.5635025489192
0.75451585156058,0.809645182441525,1051,240,39,76,22,25,17,51,41.9202832822525,43.5635025489192
0.706942259013478,0.758197799950546,1080,211,47,76,22,20,25,56,41.9202832822525,43.5635025489192
0.76388693902382,0.806818974804086,1095,196,34,57,15,21,19,36,41.9202832822525,43.5635025489192
0.819027887398053,0.851684870535314,1068,223,24,62,15,16,9,46,41.9202832822525,43.5635025489192
0.734885759529465,0.790251761855801,1079,212,28,65,12,10,16,55,41.9202832822525,43.5635025489192
0.67636529552155,0.738526499577903,1059,232,34,61,15,15,19,46,41.9202832822525,43.5635025489192
0.710760225466108,0.752051395253527,1059,232,33,53,15,13,18,40,41.9202832822525,43.5635025489192
0.775732383214568,0.814961521559404,1096,195,28,19,14,4,14,15,41.9202832822525,43.5635025489192
0.708171817705605,0.762610975761953,1081,210,46,60,21,16,25,44,41.9202832822525,43.5635025489192
0.776630822867224,0.811838695093896,1068,223,38,22,21,10,17,12,41.9202832822525,43.5635025489192
0.712757527733756,0.746399409060661,1064,227,29,46,14,17,15,29,41.9202832822525,43.5635025489192
0.7464915797915,0.789983523998436,1067,224,44,35,24,17,20,18,41.9202832822525,43.5635025489192
0.772005258847364,0.81868330916554,1086,205,37,91,18,21,19,70,41.9202832822525,43.5635025489192
0.665716308884914,0.702648683352165,1074,217,43,46,15,9,28,37,41.9202832822525,43.5635025489192
0.739298515104966,0.790896618514662,1066,225,31,46,17,8,14,38,41.9202832822525,43.5635025489192
0.694540018022446,0.750161911919651,1036,255,39,71,15,17,24,54,41.9202832822525,43.5635025489192
0.770404740608229,0.807357849498278,1075,216,43,84,20,17,23,67,41.9202832822525,43.5635025489192
0.725857654889913,0.776840757851714,1074,217,31,42,14,12,17,30,41.9202832822525,43.5635025489192
0.76837358378056,0.805806346405961,1070,221,43,74,19,18,24,56,41.9202832822525,43.5635025489192
0.736442205292045,0.765744109941189,1078,213,39,55,14,13,25,42,41.9202832822525,43.5635025489192
0.73794382617912,0.802537813110835,1082,209,33,73,14,14,19,59,41.9202832822525,43.5635025489192
0.728362824608831,0.756865152618204,1094,197,39,25,17,6,22,19,41.9202832822525,43.5635025489192
0.731843575418994,0.778423737600427,1050,241,38,31,18,9,20,22,41.9202832822525,43.5635025489192
0.69139023990382,0.753369066179019,1054,237,29,66,15,26,14,40,41.9202832822525,43.5635025489192
0.757069904128728,0.784530564071443,1073,218,33,42,11,10,22,32,41.9202832822525,43.5635025489192
0.719481443165654,0.753719088401517,1060,231,37,23,18,6,19,17,41.9202832822525,43.5635025489192
0.744460145817973,0.788860227592219,1066,225,39,37,19,7,20,30,41.9202832822525,43.5635025489192
0.670527575923048,0.710794797432833,1055,236,38,26,15,8,23,18,41.9202832822525,43.5635025489192
0.747324628776242,0.817086219806075,1091,200,31,76,12,17,19,59,41.9202832822525,43.5635025489192
0.702649769585253,0.742062252280228,1066,225,31,21,15,8,16,13,41.9202832822525,43.5635025489192
0.741906474820144,0.772610714392427,1047,244,40,55,20,14,20,41,41.9202832822525,43.5635025489192
0.680458536585366,0.71714716666462,1074,217,41,77,14,17,27,60,41.9202832822525,43.5635025489192
0.677365787079163,0.718134320898273,1056,235,35,64,12,10,23,54,41.9202832822525,43.5635025489192
0.790516452281158,0.85003763542925,1063,228,33,55,22,21,11,34,41.9202832822525,43.5635025489192
0.68099520383693,0.712957796086625,1065,226,40,91,13,22,27,69,41.9202832822525,43.5635025489192
0.789646975244549,0.831825075267601,1067,224,29,36,18,13,11,23,41.9202832822525,43.5635025489192
0.765193106866446,0.819131303635288,1056,235,42,102,23,37,19,65,41.9202832822525,43.5635025489192
0.714868105515588,0.7534289328681,1057,234,40,36,19,14,21,22,41.9202832822525,43.5635025489192
0.671050729874259,0.709580993769679,1099,192,33,106,8,11,25,95,41.9202832822525,43.5635025489192
0.668009478672986,0.713381189324023,1057,234,25,44,9,7,16,37,41.9202832822525,43.5635025489192
0.750130441264162,0.809941105077916,1060,231,43,63,23,16,20,47,41.9202832822525,43.5635025489192
0.661670631773724,0.731450088199346,1091,200,30,80,9,14,21,66,41.9202832822525,43.5635025489192
0.741424579659874,0.787622080097146,1084,207,33,71,14,16,19,55,41.9202832822525,43.5635025489192
0.750133120340788,0.811831804170973,1076,215,39,48,21,14,18,34,41.9202832822525,43.5635025489192
0.689117413075015,0.72852803364303,1067,224,34,48,17,12,17,36,41.9202832822525,43.5635025489192
0.727710484511517,0.775881633593559,1081,210,32,46,14,17,18,29,41.9202832822525,43.5635025489192
0.744241461477363,0.772854753239809,1078,213,32,60,14,12,18,48,41.9202832822525,43.5635025489192
0.781530217977692,0.834778326676499,1039,252,44,158,27,35,17,123,41.9202832822525,43.5635025489192
0.77419456462385,0.824784376319419,1063,228,38,56,22,18,16,38,41.9202832822525,43.5635025489192
0.776694722474977,0.814467675198698,1048,243,35,54,24,18,11,36,41.9202832822525,43.5635025489192
0.770613509192646,0.822269149822997,1072,219,40,88,20,22,20,66,41.9202832822525,43.5635025489192
0.682728198167628,0.708451676787863,1052,239,28,51,9,7,19,44,41.9202832822525,43.5635025489192
0.713392590936196,0.749179946912128,1068,223,43,50,23,15,20,35,41.9202832822525,43.5635025489192
0.746239113222486,0.785805420913211,1081,210,28,21,11,3,17,18,41.9202832822525,43.5635025489192
0.735961231015188,0.765133717763494,1075,216,40,46,16,11,24,35,41.9202832822525,43.5635025489192
0.705968832696266,0.744503911989492,1062,229,38,124,16,28,22,96,41.9202832822525,43.5635025489192
0.747237569060773,0.783591243350946,1067,224,24,83,13,22,11,61,41.9202832822525,43.5635025489192
0.775830300272975,0.808354409463109,1069,222,35,70,17,17,18,53,41.9202832822525,43.5635025489192
0.791436850519584,0.82671856898311,1078,213,40,50,22,15,18,35,41.9202832822525,43.5635025489192
0.765349799295486,0.814574124433397,1048,243,39,59,22,15,17,44,41.9202832822525,43.5635025489192
0.78192084078712,0.817449818139342,1040,251,43,70,24,23,19,47,41.9202832822525,43.5635025489192
0.754781682059129,0.786675414117148,1072,219,29,51,12,9,17,42,41.9202832822525,43.5635025489192
0.773541167066347,0.812955455337746,1067,224,40,91,21,29,19,62,41.9202832822525,43.5635025489192
0.708728320175572,0.773566135363222,1057,234,53,107,27,34,26,73,41.9202832822525,43.5635025489192
0.720790753593093,0.745254202322612,1076,215,29,25,9,6,20,19,41.9202832822525,43.5635025489192
0.681976676043132,0.716441236461621,1072,219,27,33,11,9,16,24,41.9202832822525,43.5635025489192
0.700161792414189,0.764455981464761,1065,226,39,57,18,16,21,41,41.9202832822525,43.5635025489192
0.733427277544925,0.785711210177775,1081,210,33,40,17,14,16,26,41.9202832822525,43.5635025489192
0.795500562429696,0.819497507549084,1079,212,21,47,10,9,11,38,41.9202832822525,43.5635025489192
0.751631187577459,0.792979747598918,1071,220,44,50,22,15,22,35,41.9202832822525,43.5635025489192
0.701666094780586,0.738633682705112,1045,246,42,43,20,14,22,29,41.9202832822525,43.5635025489192
0.748251270561233,0.779129883141809,1057,234,29,22,15,6,14,16,41.9202832822525,43.5635025489192
0.703364320495795,0.769831384027523,1050,241,36,78,17,18,19,60,41.9202832822525,43.5635025489192
0.737564119143066,0.770821389702304,1042,249,37,45,20,8,17,37,41.9202832822525,43.5635025489192
0.762224209898629,0.810008811351673,1053,238,43,97,22,29,21,68,41.9202832822525,43.5635025489192
0.760462617350978,0.79724157774065,1042,249,28,46,16,13,12,33,41.9202832822525,43.5635025489192
0.801815714352567,0.830977750594565,1055,236,34,42,20,16,14,26,41.9202832822525,43.5635025489192
0.72489756097561,0.766571408002989,1069,222,41,24,17,5,24,19,41.9202832822525,43.5635025489192
0.750351219512195,0.782439344018862,1077,214,41,60,19,17,22,43,41.9202832822525,43.5635025489192
0.796223839854413,0.821457810165357,1086,205,35,40,19,8,16,32,41.9202832822525,43.5635025489192
0.739576189823069,0.803011313618214,1060,231,23,49,13,16,10,33,41.9202832822525,43.5635025489192
0.762123367386525,0.788339402902332,1081,210,37,63,14,15,23,48,41.9202832822525,43.5635025489192
0.674705806284754,0.713782668869132,1078,213,37,66,14,13,23,53,41.9202832822525,43.5635025489192
0.793924307082202,0.824250997441602,1040,251,37,36,22,10,15,26,41.9202832822525,43.5635025489192
0.7523447329292,0.818226449510124,1043,248,42,74,23,24,19,50,41.9202832822525,43.5635025489192
0.708519108280255,0.741838611112391,1043,248,35,28,17,7,18,21,41.9202832822525,43.5635025489192
0.675905366111552,0.718639580444711,1089,202,30,34,10,11,20,23,41.9202832822525,43.5635025489192
0.766660522650938,0.792131967051938,1070,221,39,45,18,13,21,32,41.9202832822525,43.5635025489192
0.699581495305961,0.744237052451949,1085,206,28,81,11,17,17,64,41.9202832822525,43.5635025489192
0.738184843830005,0.758079483806082,1054,237,31,50,12,16,19,34,41.9202832822525,43.5635025489192
0.641633260054313,0.678422971665303,1092,199,37,44,10,7,27,37,41.9202832822525,43.5635025489192
0.731470909451946,0.774161214598812,1031,260,32,55,16,16,16,39,41.9202832822525,43.5635025489192
0.704346522781775,0.757779950155366,1093,198,40,69,17,16,23,53,41.9202832822525,43.5635025489192
0.746615599556776,0.798905293982643,1076,215,33,98,18,23,15,75,41.9202832822525,43.5635025489192
0.717743403093722,0.772945592061104,1074,217,35,77,17,21,18,56,41.9202832822525,43.5635025489192
0.734320528291767,0.803108861094996,1086,205,48,82,26,23,22,59,41.9202832822525,43.5635025489192
0.816850086109128,0.845134020767087,1052,239,38,47,23,17,15,30,41.9202832822525,43.5635025489192
0.769241513030333,0.807580884416839,1061,230,49,55,26,17,23,38,41.9202832822525,43.5635025489192
0.752854897852279,0.787524245826154,1060,231,46,46,22,13,24,33,41.9202832822525,43.5635025489192
0.632356029739153,0.674149742042032,1086,205,38,56,12,12,26,44,41.9202832822525,43.5635025489192
0.727824390243902,0.766913020602758,1076,215,41,58,18,14,23,44,41.9202832822525,43.5635025489192
0.791513602065131,0.838293408490084,1077,214,32,38,19,10,13,28,41.9202832822525,43.5635025489192
0.707605242255758,0.769292449682946,1074,217,32,40,16,6,16,34,41.9202832822525,43.5635025489192
0.727163577759871,0.763309323339546,1034,257,50,79,23,23,27,56,41.9202832822525,43.5635025489192
0.78999389988181,0.818507498127179,1080,211,42,30,24,6,18,24,41.9202832822525,43.5635025489192
0.698606141920095,0.736353275020564,1049,242,43,45,16,12,27,33,41.9202832822525,43.5635025489192
0.749317073170732,0.800751527736873,1059,232,41,37,22,12,19,25,41.9202832822525,43.5635025489192
0.725853658536585,0.765899122683752,1061,230,41,56,21,12,20,44,41.9202832822525,43.5635025489192
0.70790243902439,0.747642166953163,1076,215,41,42,14,11,27,31,41.9202832822525,43.5635025489192
0.759989654726497,0.78847505497275,1056,235,37,37,21,13,16,24,41.9202832822525,43.5635025489192
0.783832933653077,0.81560184033249,1072,219,40,35,20,13,20,22,41.9202832822525,43.5635025489192
0.725178713264496,0.778890402609387,1069,222,32,55,14,15,18,40,41.9202832822525,43.5635025489192
0.709709487659798,0.747595956000703,1069,222,49,73,22,21,27,52,41.9202832822525,43.5635025489192
0.727385672746498,0.767406348368942,1087,204,30,47,11,12,19,35,41.9202832822525,43.5635025489192
0.711765410138879,0.765930987160962,1058,233,47,51,24,20,23,31,41.9202832822525,43.5635025489192
0.678604314654038,0.728766916033821,1076,215,24,47,9,12,15,35,41.9202832822525,43.5635025489192
0.744376479873717,0.780274249021816,1045,246,24,67,13,17,11,50,41.9202832822525,43.5635025489192
0.820304388217935,0.835800740498753,1070,221,29,27,18,7,11,20,41.9202832822525,43.5635025489192
0.700559221301886,0.737718546948379,1077,214,34,61,14,19,20,42,41.9202832822525,43.5635025489192
0.75796178343949,0.782700946110317,1040,251,35,36,16,13,19,23,41.9202832822525,43.5635025489192
0.792353870458136,0.815818121321954,1068,223,25,70,9,17,16,53,41.9202832822525,43.5635025489192
0.762150019857029,0.79421305034436,1053,238,32,37,15,12,17,25,41.9202832822525,43.5635025489192
0.723057281880811,0.751448697630123,1042,249,33,30,11,6,22,24,41.9202832822525,43.5635025489192
0.741788129541731,0.800945775490197,1059,232,38,123,19,23,19,100,41.9202832822525,43.5635025489192
0.722022382094325,0.771643583563818,1061,230,40,71,17,19,23,52,41.9202832822525,43.5635025489192
0.691223193010326,0.731095641403333,1085,206,32,37,10,6,22,31,41.9202832822525,43.5635025489192
0.745711725550435,0.774124424164182,1078,213,31,64,13,18,18,46,41.9202832822525,43.5635025489192
0.809541542535584,0.857741070125245,1080,211,19,53,10,19,9,34,41.9202832822525,43.5635025489192
0.694916517590936,0.712681112775614,1039,252,43,37,17,13,26,24,41.9202832822525,43.5635025489192
0.73404603915786,0.795457572269725,1045,246,39,37,21,17,18,20,41.9202832822525,43.5635025489192
0.774774522957662,0.801821370111493,1062,229,43,76,20,27,23,49,41.9202832822525,43.5635025489192
0.758761134552274,0.805625413510121,1072,219,27,30,12,8,15,22,41.9202832822525,43.5635025489192
0.799789529071297,0.837763572296812,1075,216,24,30,13,7,11,23,41.9202832822525,43.5635025489192
0.769177901136664,0.814127975510641,1068,223,30,48,19,20,11,28,41.9202832822525,43.5635025489192
0.639349718381976,0.689607454421716,1100,191,31,32,10,9,21,23,41.9202832822525,43.5635025489192
0.732673163355316,0.779131967245798,1086,205,38,76,20,15,18,61,41.9202832822525,43.5635025489192
0.747605471079308,0.786585807826506,1040,251,43,63,20,19,23,44,41.9202832822525,43.5635025489192
0.731735638204994,0.758582958660936,1074,217,46,60,18,19,28,41,41.9202832822525,43.5635025489192
0.775103112110986,0.805707245777779,1061,230,21,45,11,12,10,33,41.9202832822525,43.5635025489192
0.764717926482632,0.794261179197937,1049,242,33,45,15,10,18,35,41.9202832822525,43.5635025489192
0.764093999062353,0.82723641388123,1063,228,27,38,17,11,10,27,41.9202832822525,43.5635025489192
0.66585606738223,0.698568156970085,1054,237,43,39,19,8,24,31,41.9202832822525,43.5635025489192
0.765994920946997,0.810666411346815,1049,242,39,54,23,13,16,41,41.9202832822525,43.5635025489192
0.764951356886841,0.792914106136824,1056,235,31,37,16,13,15,24,41.9202832822525,43.5635025489192
0.708006048641156,0.750198588333522,1044,247,38,43,17,12,21,31,41.9202832822525,43.5635025489192
0.755754558386137,0.801949895052837,1051,240,37,24,20,10,17,14,41.9202832822525,43.5635025489192
0.708363443657561,0.750933146963527,1064,227,33,27,17,9,16,18,41.9202832822525,43.5635025489192
0.715371845949535,0.800263984128981,1073,218,36,82,15,21,21,61,41.9202832822525,43.5635025489192
0.784377478191911,0.836337357803995,1073,218,30,50,15,13,15,37,41.9202832822525,43.5635025489192
0.810852844700826,0.855510615761115,1060,231,28,56,18,18,10,38,41.9202832822525,43.5635025489192
0.74369881710646,0.780840844873477,1066,225,35,38,18,8,17,30,41.9202832822525,43.5635025489192
0.634436575613046,0.69488314362114,1066,225,33,89,13,20,20,69,41.9202832822525,43.5635025489192
0.711467808097021,0.770060784891483,1071,220,45,40,22,11,23,29,41.9202832822525,43.5635025489192
0.733683628318584,0.780563039917377,1059,232,48,76,23,18,25,58,41.9202832822525,43.5635025489192
0.659811854646545,0.718168264730686,1081,210,32,49,11,13,21,36,41.9202832822525,43.5635025489192
0.732312094481301,0.791227677165398,1054,237,44,73,22,22,22,51,41.9202832822525,43.5635025489192
0.712007701399215,0.767652345165028,1060,231,42,91,16,24,26,67,41.9202832822525,43.5635025489192
0.775830013280212,0.801008573352184,1061,230,36,23,15,4,21,19,41.9202832822525,43.5635025489192
0.771725396602555,0.800912341899212,1044,247,34,26,18,6,16,20,41.9202832822525,43.5635025489192
0.701799335485984,0.748109096303715,1084,207,34,46,16,14,18,32,41.9202832822525,43.5635025489192
0.78132733408324,0.828324421782228,1076,215,21,51,11,10,10,41,41.9202832822525,43.5635025489192
0.732538224781573,0.772447296270012,1082,209,32,66,17,14,15,52,41.9202832822525,43.5635025489192
0.673261961406291,0.744926413334032,1077,214,30,51,13,13,17,38,41.9202832822525,43.5635025489192
0.70360791413423,0.745662371339368,1060,231,37,76,13,20,24,56,41.9202832822525,43.5635025489192
0.681954436450839,0.733234767232768,1097,194,40,41,15,11,25,30,41.9202832822525,43.5635025489192
0.742255758538523,0.777622971077533,1041,250,32,42,15,17,17,25,41.9202832822525,43.5635025489192
0.744736715324951,0.776932585621298,1049,242,33,59,15,20,18,39,41.9202832822525,43.5635025489192
0.727003098716246,0.768646763092712,1065,226,36,102,15,22,21,80,41.9202832822525,43.5635025489192
0.750592697961119,0.81152820711061,1055,236,37,69,20,18,17,51,41.9202832822525,43.5635025489192
0.654106005459508,0.699392786666144,1054,237,35,61,13,15,22,46,41.9202832822525,43.5635025489192
0.794073353921232,0.831211937996145,1047,244,42,49,18,15,24,34,41.9202832822525,43.5635025489192
0.704946416854997,0.758366281618213,1069,222,44,90,19,22,25,68,41.9202832822525,43.5635025489192
0.756359300476947,0.799503169795019,1060,231,33,45,16,12,17,33,41.9202832822525,43.5635025489192
0.698446053709212,0.73492991164093,1082,209,37,33,16,8,21,25,41.9202832822525,43.5635025489192
0.784376481744903,0.826441827494251,1060,231,37,42,18,12,19,30,41.9202832822525,43.5635025489192
0.753958995234313,0.787021437648023,1076,215,32,65,16,24,16,41,41.9202832822525,43.5635025489192
0.69007793764988,0.729765434702479,1063,228,40,34,18,8,22,26,41.9202832822525,43.5635025489192
0.733221259537049,0.786196073628366,1071,220,37,70,19,22,18,48,41.9202832822525,43.5635025489192
0.700932666060055,0.739643987777354,1074,217,35,26,16,6,19,20,41.9202832822525,43.5635025489192
0.725034816089129,0.780865834750989,1071,220,39,77,20,22,19,55,41.9202832822525,43.5635025489192
0.709594953519256,0.740815016589346,1064,227,36,55,14,15,22,40,41.9202832822525,43.5635025489192
0.806435622225096,0.835238338937792,1034,257,37,41,23,19,14,22,41.9202832822525,43.5635025489192
0.743922151816889,0.808773619623908,1094,197,37,54,21,13,16,41,41.9202832822525,43.5635025489192
0.686720142602496,0.728187067268736,1087,204,33,52,10,10,23,42,41.9202832822525,43.5635025489192
0.734702238209432,0.792345545964174,1068,223,40,89,24,29,16,60,41.9202832822525,43.5635025489192
0.76182923605604,0.812976102295112,1061,230,30,37,18,9,12,28,41.9202832822525,43.5635025489192
0.792768350434096,0.8407993887294,1076,215,24,42,13,9,11,33,41.9202832822525,43.5635025489192
0.64611248792372,0.700608906281866,1086,205,38,73,13,8,25,65,41.9202832822525,43.5635025489192
0.718050022133688,0.758952749509194,1073,218,36,58,15,15,21,43,41.9202832822525,43.5635025489192
0.783639254227489,0.822312984319317,1054,237,33,64,19,19,14,45,41.9202832822525,43.5635025489192
0.71259842519685,0.754629875850331,1091,200,21,26,8,9,13,17,41.9202832822525,43.5635025489192
0.689461082874785,0.748980039551611,1058,233,38,62,18,15,20,47,41.9202832822525,43.5635025489192
0.750794482276934,0.779346400763074,1070,221,46,27,24,8,22,19,41.9202832822525,43.5635025489192
0.793089786327122,0.806019578847225,1068,223,29,23,15,4,14,19,41.9202832822525,43.5635025489192
0.799236387782205,0.839166754402051,1069,222,36,31,23,10,13,21,41.9202832822525,43.5635025489192
0.680140488482923,0.778620496911058,1066,225,32,62,14,13,18,49,41.9202832822525,43.5635025489192
0.7149748876553,0.781799237314481,1088,203,30,41,16,14,14,27,41.9202832822525,43.5635025489192
0.736380765134759,0.754066575907914,1089,202,39,38,15,8,24,30,41.9202832822525,43.5635025489192
0.736941319550015,0.772743877422668,1069,222,26,34,11,7,15,27,41.9202832822525,43.5635025489192
0.725756097560975,0.742555997219436,1037,254,41,76,16,18,25,58,41.9202832822525,43.5635025489192
0.735196933650542,0.769900712853601,1060,231,30,79,14,21,16,58,41.9202832822525,43.5635025489192
0.756048481445084,0.800658598047773,1063,228,34,88,17,27,17,61,41.9202832822525,43.5635025489192
0.738663414634146,0.775583199772995,1073,218,41,35,22,10,19,25,41.9202832822525,43.5635025489192
0.716312527667109,0.751731598568651,1029,262,36,39,16,12,20,27,41.9202832822525,43.5635025489192
0.727945200793597,0.77454421621581,1071,220,47,76,23,23,24,53,41.9202832822525,43.5635025489192
0.774009603841537,0.810326186576022,1050,241,17,59,7,11,10,48,41.9202832822525,43.5635025489192
0.797731814548361,0.836535134684351,1073,218,40,80,22,16,18,64,41.9202832822525,43.5635025489192
0.687502924797604,0.713018350869078,1049,242,34,24,14,7,20,17,41.9202832822525,43.5635025489192
0.76423860911271,0.788853624115862,1059,232,40,28,22,7,18,21,41.9202832822525,43.5635025489192
0.720624367683191,0.763329683854457,1057,234,33,60,13,13,20,47,41.9202832822525,43.5635025489192
0.726241679467486,0.755931345579964,1090,201,31,41,13,8,18,33,41.9202832822525,43.5635025489192
0.688505481581048,0.728838987678756,1059,232,38,66,15,12,23,54,41.9202832822525,43.5635025489192
0.678061678131873,0.705608659681396,1084,207,34,16,12,3,22,13,41.9202832822525,43.5635025489192
0.794953519256308,0.823140882440223,1067,224,36,27,22,8,14,19,41.9202832822525,43.5635025489192
0.713973604423043,0.736341393372446,1073,218,45,39,16,11,29,28,41.9202832822525,43.5635025489192
0.710727086533538,0.739201811166053,1075,216,31,20,13,9,18,11,41.9202832822525,43.5635025489192
0.77716015598276,0.814902299407248,1075,216,47,41,27,14,20,27,41.9202832822525,43.5635025489192
0.647606246799795,0.700384428090791,1087,204,31,82,10,11,21,71,41.9202832822525,43.5635025489192
0.795263390880921,0.830731359585272,1039,252,36,60,27,25,9,35,41.9202832822525,43.5635025489192
0.716312527667109,0.765708730642023,1072,219,36,59,17,18,19,41,41.9202832822525,43.5635025489192
0.740437788018433,0.789974386059812,1076,215,31,46,14,11,17,35,41.9202832822525,43.5635025489192
0.721186888712662,0.750261014683487,1069,222,30,40,11,8,19,32,41.9202832822525,43.5635025489192
0.770045588629659,0.808297494256941,1063,228,48,60,26,21,22,39,41.9202832822525,43.5635025489192
0.685455508984921,0.753942040503307,1080,211,33,70,13,14,20,56,41.9202832822525,43.5635025489192
0.729492650545282,0.778086532527776,1018,273,37,37,23,11,14,26,41.9202832822525,43.5635025489192
0.7629583735876,0.837678528613071,1046,245,38,93,21,18,17,75,41.9202832822525,43.5635025489192
0.748335893497184,0.802326973628652,1031,260,31,81,15,23,16,58,41.9202832822525,43.5635025489192
0.745151219512195,0.784266519206258,1075,216,41,49,20,12,21,37,41.9202832822525,43.5635025489192
0.70400363967243,0.754138445907996,1070,221,35,70,14,17,21,53,41.9202832822525,43.5635025489192
0.751357106088258,0.783026435293647,1070,221,34,26,13,6,21,20,41.9202832822525,43.5635025489192
0.738631850675139,0.783125966731275,1088,203,32,65,16,21,16,44,41.9202832822525,43.5635025489192
0.789947538116837,0.833871789150615,1063,228,29,36,14,9,15,27,41.9202832822525,43.5635025489192
0.751868919610855,0.780481813148434,1055,236,31,39,13,15,18,24,41.9202832822525,43.5635025489192
0.753718566078117,0.795156956646526,1060,231,45,29,25,11,20,18,41.9202832822525,43.5635025489192
0.745461486257211,0.808147022981167,1079,212,28,57,15,18,13,39,41.9202832822525,43.5635025489192
0.713105185549275,0.763857124297081,1087,204,39,44,17,11,22,33,41.9202832822525,43.5635025489192
0.719587122143033,0.76167786444311,1072,219,39,57,18,17,21,40,41.9202832822525,43.5635025489192
0.741003035120682,0.790636025189367,1066,225,33,73,16,19,17,54,41.9202832822525,43.5635025489192
0.783438941333678,0.822726603327653,1069,222,37,61,26,19,11,42,41.9202832822525,43.5635025489192
0.713079536370903,0.774870957134395,1062,229,40,49,16,10,24,39,41.9202832822525,43.5635025489192
0.690232619614063,0.757590317593031,1069,222,30,38,14,15,16,23,41.9202832822525,43.5635025489192
0.778343023255814,0.847731361153191,1081,210,43,105,24,30,19,75,41.9202832822525,43.5635025489192
0.69774721482796,0.740389078229229,1034,257,49,44,22,12,27,32,41.9202832822525,43.5635025489192
0.769902311000948,0.799313595860068,1076,215,44,50,19,18,25,32,41.9202832822525,43.5635025489192
0.754413451298435,0.796177907608544,1077,214,39,44,17,12,22,32,41.9202832822525,43.5635025489192
0.746537430500397,0.773775800726955,1064,227,32,32,14,10,18,22,41.9202832822525,43.5635025489192
0.724092733677398,0.769858673958019,1075,216,39,31,18,9,21,22,41.9202832822525,43.5635025489192
0.716333030027298,0.770160326178069,1050,241,35,58,17,12,18,46,41.9202832822525,43.5635025489192
0.734088581669227,0.768919911274754,1040,251,31,72,15,25,16,47,41.9202832822525,43.5635025489192
0.752648475120385,0.79342021153784,1085,206,45,29,26,13,19,16,41.9202832822525,43.5635025489192
0.76394422310757,0.802548578272394,1078,213,36,79,18,24,18,55,41.9202832822525,43.5635025489192
0.704478784704034,0.74273358683,1045,246,46,51,19,15,27,36,41.9202832822525,43.5635025489192
0.674848447612026,0.717411720845781,1056,235,39,32,16,9,23,23,41.9202832822525,43.5635025489192
0.756902522345454,0.809169018084605,1047,244,34,61,21,19,13,42,41.9202832822525,43.5635025489192
0.758018653321201,0.804608914897987,1057,234,35,75,20,21,15,54,41.9202832822525,43.5635025489192
0.814360642287857,0.85408478194571,1074,217,27,53,14,17,13,36,41.9202832822525,43.5635025489192
0.703092682926829,0.743861539421474,1061,230,41,27,22,9,19,18,41.9202832822525,43.5635025489192
0.789248601119105,0.829021539587849,1053,238,40,63,23,19,17,44,41.9202832822525,43.5635025489192
0.685960975609756,0.740453862879328,1074,217,41,59,15,14,26,45,41.9202832822525,43.5635025489192
0.793033001571503,0.835637095935868,1090,201,46,45,24,14,22,31,41.9202832822525,43.5635025489192
0.708194825841885,0.741573275723563,1046,245,33,51,17,16,16,35,41.9202832822525,43.5635025489192
0.730515587529976,0.765344351091005,1065,226,40,61,19,18,21,43,41.9202832822525,43.5635025489192
0.729037761601456,0.766800649822842,1088,203,35,66,15,15,20,51,41.9202832822525,43.5635025489192
0.765273311897106,0.808622052381132,1044,247,47,33,28,11,19,22,41.9202832822525,43.5635025489192
0.76126632037063,0.819498787117571,1070,221,34,83,20,22,14,61,41.9202832822525,43.5635025489192
0.731591448931116,0.778090227474772,1066,225,28,41,14,10,14,31,41.9202832822525,43.5635025489192
0.69332347588717,0.7417448293449,1062,229,35,39,16,11,19,28,41.9202832822525,43.5635025489192
0.707190243902439,0.735679501604336,1082,209,41,43,15,11,26,32,41.9202832822525,43.5635025489192
0.767709281164695,0.794026625248797,1065,226,35,39,19,11,16,28,41.9202832822525,43.5635025489192
0.753120849933599,0.791813150540083,1080,211,36,43,18,10,18,33,41.9202832822525,43.5635025489192
0.793986657722123,0.829159384026668,1041,250,43,55,25,17,18,38,41.9202832822525,43.5635025489192
0.682692682926829,0.729938358709919,1069,222,41,49,15,20,26,29,41.9202832822525,43.5635025489192
0.693251265933298,0.743255906625697,1041,250,46,42,22,15,24,27,41.9202832822525,43.5635025489192
0.770858536585366,0.80579856156309,1049,242,41,55,22,17,19,38,41.9202832822525,43.5635025489192
0.76311511128989,0.807831905421768,1057,234,48,74,26,32,22,42,41.9202832822525,43.5635025489192
0.691591981938838,0.744069668935114,1069,222,47,48,19,19,28,29,41.9202832822525,43.5635025489192
0.753149001536098,0.796636287218577,1062,229,31,65,14,20,17,45,41.9202832822525,43.5635025489192
0.769323113860929,0.813826285208893,1062,229,17,57,10,14,7,43,41.9202832822525,43.5635025489192
0.713847795869738,0.754288802681832,1077,214,32,26,15,5,17,21,41.9202832822525,43.5635025489192
0.722242206235012,0.750353067321814,1048,243,40,19,21,8,19,11,41.9202832822525,43.5635025489192
0.715638097991039,0.767956697722306,1069,222,33,31,13,10,20,21,41.9202832822525,43.5635025489192
0.729668292682927,0.794091539824645,1062,229,41,85,21,20,20,65,41.9202832822525,43.5635025489192
0.763417160475984,0.80133388120578,1072,219,33,48,19,12,14,36,41.9202832822525,43.5635025489192
0.74703535712334,0.782221966046107,1072,219,29,69,14,21,15,48,41.9202832822525,43.5635025489192
0.762578774470367,0.802519100834133,1045,246,48,47,24,15,24,32,41.9202832822525,43.5635025489192
0.703844993318677,0.741724016579156,1064,227,37,47,13,12,24,35,41.9202832822525,43.5635025489192
0.783161512027491,0.803756477423363,1073,218,30,68,12,16,18,52,41.9202832822525,43.5635025489192
0.702305083482409,0.730577108082601,1060,231,43,17,22,6,21,11,41.9202832822525,43.5635025489192
0.787819744204636,0.817969677063658,1057,234,40,56,22,17,18,39,41.9202832822525,43.5635025489192
0.761312812417785,0.804542494163792,1079,212,24,17,12,3,12,14,41.9202832822525,43.5635025489192
0.716799763383614,0.76917296252258,1062,229,49,54,25,18,24,36,41.9202832822525,43.5635025489192
0.759707568531098,0.785694138157762,1068,223,33,31,17,9,16,22,41.9202832822525,43.5635025489192
0.789948041566747,0.833792977572423,1076,215,40,47,25,20,15,27,41.9202832822525,43.5635025489192
0.771327760742639,0.838139709935587,1085,206,38,103,20,29,18,74,41.9202832822525,43.5635025489192
0.706312772102246,0.741602542567738,1060,231,37,70,15,20,22,50,41.9202832822525,43.5635025489192
0.784004590414777,0.82299556508143,1078,213,29,45,13,10,16,35,41.9202832822525,43.5635025489192
0.737715850063176,0.782458531453423,1057,234,34,53,17,11,17,42,41.9202832822525,43.5635025489192
0.722134387351779,0.792478570328124,1085,206,26,75,11,13,15,62,41.9202832822525,43.5635025489192
0.759137792103143,0.803224166145293,1076,215,50,42,25,12,25,30,41.9202832822525,43.5635025489192
0.722290548598688,0.763389336798834,1077,214,43,43,17,10,26,33,41.9202832822525,43.5635025489192
0.798210043417711,0.823463084275823,1063,228,39,108,23,32,16,76,41.9202832822525,43.5635025489192
0.776288080864804,0.802736285189755,1069,222,34,74,13,18,21,56,41.9202832822525,43.5635025489192
0.745154686078253,0.794636149009142,1088,203,35,42,17,16,18,26,41.9202832822525,43.5635025489192
0.725940681717574,0.749564949835972,1062,229,36,29,15,10,21,19,41.9202832822525,43.5635025489192
0.763167966756579,0.803653935767543,1067,224,44,35,26,14,18,21,41.9202832822525,43.5635025489192
0.78321400159109,0.849048946924861,1071,220,34,63,16,20,18,43,41.9202832822525,43.5635025489192
0.738080484070861,0.789600630345757,1054,237,44,45,20,14,24,31,41.9202832822525,43.5635025489192
0.746882494004796,0.799952632762234,1083,208,40,67,19,10,21,57,41.9202832822525,43.5635025489192
0.737461670937119,0.782372464821406,1063,228,38,66,16,19,22,47,41.9202832822525,43.5635025489192
0.772760975609756,0.823264239259673,1078,213,41,108,21,27,20,81,41.9202832822525,43.5635025489192
0.770623501199041,0.80692921373054,1074,217,40,35,21,14,19,21,41.9202832822525,43.5635025489192
0.770764079587609,0.807897647171369,1068,223,33,35,19,14,14,21,41.9202832822525,43.5635025489192
0.779198668714798,0.812838874577078,1067,224,31,39,20,14,11,25,41.9202832822525,43.5635025489192
0.741932270916335,0.803557882151318,1038,253,36,70,20,22,16,48,41.9202832822525,43.5635025489192
0.725904133798871,0.759943397299325,1071,220,37,51,16,11,21,40,41.9202832822525,43.5635025489192
0.701486420022952,0.751422161375564,1074,217,29,67,12,15,17,52,41.9202832822525,43.5635025489192
0.677002379064235,0.700537945322063,1071,220,30,51,11,11,19,40,41.9202832822525,43.5635025489192
0.762079162875341,0.771967633148374,1091,200,35,27,12,9,23,18,41.9202832822525,43.5635025489192
0.713327370304115,0.7581686873806,1052,239,43,47,20,17,23,30,41.9202832822525,43.5635025489192
0.688672058134083,0.726711653739076,1058,233,27,59,9,13,18,46,41.9202832822525,43.5635025489192
0.686829268292683,0.740364587736742,1072,219,41,94,20,26,21,68,41.9202832822525,43.5635025489192
0.757190635451505,0.819398344332428,1078,213,26,59,14,20,12,39,41.9202832822525,43.5635025489192
0.650780487804878,0.711194929680161,1067,224,41,44,17,11,24,33,41.9202832822525,43.5635025489192
0.763778976818545,0.805133770692317,1078,213,40,52,20,19,20,33,41.9202832822525,43.5635025489192
0.695950730471079,0.724880749290662,1052,239,43,82,17,23,26,59,41.9202832822525,43.5635025489192
0.722369498685288,0.760826368489191,1056,235,37,58,18,18,19,40,41.9202832822525,43.5635025489192
0.756678707943042,0.800012831772987,1072,219,38,58,18,16,20,42,41.9202832822525,43.5635025489192
0.770889653477513,0.813044673119134,1068,223,39,43,22,13,17,30,41.9202832822525,43.5635025489192
0.723817007159071,0.775884644963452,1042,249,46,66,24,17,22,49,41.9202832822525,43.5635025489192
0.689998001598721,0.723492108856923,1066,225,40,44,15,10,25,34,41.9202832822525,43.5635025489192
0.743355315747402,0.78357054111062,1067,224,40,72,18,21,22,51,41.9202832822525,43.5635025489192
0.773031896844248,0.81161923284176,1080,211,28,22,12,7,16,15,41.9202832822525,43.5635025489192
0.646902836380684,0.676083758140439,1068,223,27,43,7,10,20,33,41.9202832822525,43.5635025489192
0.744964586100044,0.771595935530248,1065,226,36,55,19,17,17,38,41.9202832822525,43.5635025489192
0.715763086659804,0.766051146582674,1103,188,42,38,16,8,26,30,41.9202832822525,43.5635025489192
0.750232253128586,0.784314297963875,1078,213,29,88,11,21,18,67,41.9202832822525,43.5635025489192
0.673525552234454,0.730434961102563,1061,230,44,37,19,13,25,24,41.9202832822525,43.5635025489192
0.742266835135009,0.799463778209697,1067,224,34,57,20,15,14,42,41.9202832822525,43.5635025489192
0.747348218471636,0.789541522403958,1075,216,27,45,13,9,14,36,41.9202832822525,43.5635025489192
0.816816171049398,0.843272707304912,1046,245,39,53,22,24,17,29,41.9202832822525,43.5635025489192
0.797622838944495,0.834619800917799,1067,224,35,57,20,28,15,29,41.9202832822525,43.5635025489192
0.750508836378078,0.797813329697576,1091,200,32,96,13,20,19,76,41.9202832822525,43.5635025489192
0.726623062015504,0.762269663844166,1070,221,43,68,19,20,24,48,41.9202832822525,43.5635025489192
0.756083579016332,0.80551124524632,1073,218,34,46,17,15,17,31,41.9202832822525,43.5635025489192
0.73447935481161,0.789316904926523,1045,246,38,87,18,27,20,60,41.9202832822525,43.5635025489192
0.72425657409683,0.775188462229013,1074,217,39,36,17,10,22,26,41.9202832822525,43.5635025489192
0.767077045274027,0.79393695555916,1064,227,32,16,16,5,16,11,41.9202832822525,43.5635025489192
0.72504219618745,0.767306768669626,1074,217,32,41,16,11,16,30,41.9202832822525,43.5635025489192
0.691628264208909,0.741483392318225,1075,216,31,72,13,17,18,55,41.9202832822525,43.5635025489192
0.779109001486904,0.806308043952463,1059,232,42,44,23,12,19,32,41.9202832822525,43.5635025489192
0.782711555959964,0.80395975980576,1077,214,35,30,17,9,18,21,41.9202832822525,43.5635025489192
0.74827481032445,0.819418226211753,1065,226,42,74,21,21,21,53,41.9202832822525,43.5635025489192
0.733667593328038,0.776098682777775,1062,229,32,51,16,14,16,37,41.9202832822525,43.5635025489192
0.753876898481215,0.784786805200929,1073,218,40,52,16,10,24,42,41.9202832822525,43.5635025489192
0.705307262569832,0.745758784903001,1083,208,38,41,13,9,25,32,41.9202832822525,43.5635025489192
0.727318333840073,0.789783303156741,1056,235,26,31,14,9,12,22,41.9202832822525,43.5635025489192
0.731028207461328,0.81283753054404,1084,207,35,90,13,22,22,68,41.9202832822525,43.5635025489192
0.777208201892744,0.817167860518056,1084,207,23,22,12,4,11,18,41.9202832822525,43.5635025489192
0.776106661699882,0.810972435535172,1046,245,52,63,32,21,20,42,41.9202832822525,43.5635025489192
0.812441795492643,0.850916385069505,1048,243,52,93,34,36,18,57,41.9202832822525,43.5635025489192
0.643454459243933,0.685006093687754,1064,227,37,41,15,11,22,30,41.9202832822525,43.5635025489192
0.760379456149304,0.794121267470864,1047,244,44,27,24,12,20,15,41.9202832822525,43.5635025489192
0.767763509898342,0.810582132020533,1058,233,45,54,26,10,19,44,41.9202832822525,43.5635025489192
0.763848920863309,0.809933540134305,1074,217,40,39,21,15,19,24,41.9202832822525,43.5635025489192
0.762494466578132,0.804088897073842,1073,218,36,62,16,15,20,47,41.9202832822525,43.5635025489192
0.758425788249647,0.801359644364922,1078,213,42,50,22,14,20,36,41.9202832822525,43.5635025489192
0.707227138643068,0.742671922661001,1044,247,48,44,20,12,28,32,41.9202832822525,43.5635025489192
0.743953846895023,0.787108613649302,1051,240,33,32,16,6,17,26,41.9202832822525,43.5635025489192
0.741237306378399,0.784641514004172,1042,249,34,91,19,29,15,62,41.9202832822525,43.5635025489192
0.740548915449314,0.782566898689494,1043,248,36,40,17,17,19,23,41.9202832822525,43.5635025489192
0.733055775839281,0.765785818057204,1045,246,30,66,13,17,17,49,41.9202832822525,43.5635025489192
0.761629674673153,0.79718246339899,1078,213,26,66,12,12,14,54,41.9202832822525,43.5635025489192
0.77099703160468,0.811972711620228,1053,238,46,67,24,19,22,48,41.9202832822525,43.5635025489192
0.644692717066414,0.685252635222754,1075,216,44,59,14,9,30,50,41.9202832822525,43.5635025489192
0.691499535493743,0.74540022613142,1068,223,29,74,12,18,17,56,41.9202832822525,43.5635025489192
0.741753867151956,0.768033107844633,1089,202,35,34,14,5,21,29,41.9202832822525,43.5635025489192
0.805062120010574,0.854131063893628,1084,207,30,40,15,15,15,25,41.9202832822525,43.5635025489192
0.787997327471012,0.816573592292043,1068,223,37,75,18,20,19,55,41.9202832822525,43.5635025489192
0.764849778007673,0.811281285342828,1074,217,37,44,19,15,18,29,41.9202832822525,43.5635025489192
0.753049759229534,0.798239445439342,1065,226,45,36,26,16,19,20,41.9202832822525,43.5635025489192
0.693946620417208,0.743798852613161,1076,215,33,36,14,8,19,28,41.9202832822525,43.5635025489192
0.748145204027557,0.775991290564237,1062,229,33,49,15,14,18,35,41.9202832822525,43.5635025489192
0.719425996204934,0.747058080243762,1075,216,51,19,24,7,27,12,41.9202832822525,43.5635025489192
0.771502797761791,0.808967120330153,1061,230,40,53,22,12,18,41,41.9202832822525,43.5635025489192
0.699867829764737,0.755709534552605,1076,215,30,48,14,17,16,31,41.9202832822525,43.5635025489192
0.8219790201594,0.852633368704324,1077,214,27,68,16,15,11,53,41.9202832822525,43.5635025489192
0.801344086021505,0.837349984404885,1083,208,31,48,17,20,14,28,41.9202832822525,43.5635025489192
0.711730854360336,0.752797343300245,1080,211,36,51,14,16,22,35,41.9202832822525,43.5635025489192
0.668658698539177,0.712063525785784,1097,194,36,78,14,17,22,61,41.9202832822525,43.5635025489192
0.770302599249968,0.802203862938772,1084,207,37,33,18,11,19,22,41.9202832822525,43.5635025489192
0.715368231342672,0.75336424681472,1059,232,39,64,19,17,20,47,41.9202832822525,43.5635025489192
0.785599908498227,0.810158467941794,1058,233,42,35,24,10,18,25,41.9202832822525,43.5635025489192
0.749440966010733,0.786921023045808,1086,205,43,39,22,11,21,28,41.9202832822525,43.5635025489192
0.748087327176348,0.795861151399903,1064,227,29,62,12,18,17,44,41.9202832822525,43.5635025489192
0.7442048877197,0.778999212213978,1081,210,42,50,14,13,28,37,41.9202832822525,43.5635025489192
0.722622838944495,0.749397122390045,1048,243,35,32,13,13,22,19,41.9202832822525,43.5635025489192
0.744557955084271,0.772988315030184,1077,214,37,44,14,12,23,32,41.9202832822525,43.5635025489192
0.737715972880367,0.765566325174053,1081,210,44,44,20,10,24,34,41.9202832822525,43.5635025489192
0.720293683951831,0.774329900458409,1091,200,39,51,20,14,19,37,41.9202832822525,43.5635025489192
0.76291590621929,0.815199823221192,1088,203,34,38,20,13,14,25,41.9202832822525,43.5635025489192
0.710987206677157,0.763367836825948,1057,234,47,79,21,18,26,61,41.9202832822525,43.5635025489192
0.725716560509554,0.763213511234532,1079,212,35,38,16,8,19,30,41.9202832822525,43.5635025489192
0.674310877273247,0.70586788805974,1078,213,42,26,14,7,28,19,41.9202832822525,43.5635025489192
0.699793094529937,0.733790259485715,1089,202,37,31,12,12,25,19,41.9202832822525,43.5635025489192
0.699933914882369,0.740492868413234,1053,238,30,23,16,2,14,21,41.9202832822525,43.5635025489192
0.707508864234245,0.74575673468113,1050,241,42,31,18,8,24,23,41.9202832822525,43.5635025489192
0.716961091234347,0.742663491658987,1077,214,43,35,13,6,30,29,41.9202832822525,43.5635025489192
0.727252944188428,0.744225474201109,1079,212,31,43,12,10,19,33,41.9202832822525,43.5635025489192
0.752655877680699,0.780521745472714,1078,213,32,34,13,13,19,21,41.9202832822525,43.5635025489192
0.737328733121525,0.783393465852345,1050,241,32,30,16,9,16,21,41.9202832822525,43.5635025489192
0.740711439287389,0.778445518259066,1069,222,27,74,9,20,18,54,41.9202832822525,43.5635025489192
0.815129393046001,0.849807897121634,1064,227,34,45,22,17,12,28,41.9202832822525,43.5635025489192
0.760651078293483,0.803485549659877,1073,218,27,17,15,4,12,13,41.9202832822525,43.5635025489192
0.70318446789035,0.752385025574691,1082,209,33,75,13,21,20,54,41.9202832822525,43.5635025489192
0.846383464804518,0.8660342043958,1057,234,37,41,25,14,12,27,41.9202832822525,43.5635025489192
0.78712465878071,0.824454203195552,1047,244,35,52,22,18,13,34,41.9202832822525,43.5635025489192
0.714230194775505,0.794849290816048,1061,230,53,108,28,36,25,72,41.9202832822525,43.5635025489192
0.710013489425254,0.738951393386192,1075,216,33,36,15,8,18,28,41.9202832822525,43.5635025489192
0.780184331797235,0.822773347801404,1085,206,31,30,19,8,12,22,41.9202832822525,43.5635025489192
0.803005881687592,0.82732229708206,1075,216,28,68,13,18,15,50,41.9202832822525,43.5635025489192
0.768903088391906,0.797104928104592,1048,243,39,58,22,17,17,41,41.9202832822525,43.5635025489192
0.74326327135543,0.786004255998612,1057,234,54,66,27,20,27,46,41.9202832822525,43.5635025489192
0.791424390243902,0.849664892257924,1063,228,41,70,26,26,15,44,41.9202832822525,43.5635025489192
0.659985603653693,0.688131295313127,1067,224,32,56,10,12,22,44,41.9202832822525,43.5635025489192
0.724848352368982,0.775614179719094,1076,215,29,34,14,11,15,23,41.9202832822525,43.5635025489192
0.747344588550984,0.780227741473722,1043,248,43,42,19,15,24,27,41.9202832822525,43.5635025489192
0.715703001579779,0.761059249114643,1070,221,25,56,10,10,15,46,41.9202832822525,43.5635025489192
0.78488398544131,0.813776405380645,1060,231,35,71,20,20,15,51,41.9202832822525,43.5635025489192
0.846701525914233,0.846514399144222,1074,217,24,27,15,9,9,18,41.9202832822525,43.5635025489192
0.791672688731512,0.833291718414567,1067,224,33,44,21,19,12,25,41.9202832822525,43.5635025489192
0.746552757793765,0.791536507676167,1094,197,40,29,23,12,17,17,41.9202832822525,43.5635025489192
0.70743149324861,0.76389842936416,1048,243,32,89,16,26,16,63,41.9202832822525,43.5635025489192
0.779194333776007,0.809288755077505,1052,239,36,43,21,8,15,35,41.9202832822525,43.5635025489192
0.727175740333635,0.78083931372311,1055,236,37,69,18,23,19,46,41.9202832822525,43.5635025489192
0.7238918859809,0.749744156525817,1056,235,44,53,20,18,24,35,41.9202832822525,43.5635025489192
0.768370731707317,0.805078079479679,1093,198,41,50,18,13,23,37,41.9202832822525,43.5635025489192
0.680671651195027,0.725834495962896,1062,229,38,44,14,12,24,32,41.9202832822525,43.5635025489192
0.750698559522089,0.781897896962516,1075,216,33,25,17,8,16,17,41.9202832822525,43.5635025489192
0.720893141945774,0.75149509359361,1068,223,37,23,17,5,20,18,41.9202832822525,43.5635025489192
0.79095283225195,0.820795116807209,1052,239,44,37,22,14,22,23,41.9202832822525,43.5635025489192
0.750072264778147,0.788229581716003,1092,199,33,90,15,21,18,69,41.9202832822525,43.5635025489192
0.780171530977983,0.797261675345548,1073,218,31,56,16,19,15,37,41.9202832822525,43.5635025489192
0.770305971983288,0.816294745950777,1053,238,39,68,20,16,19,52,41.9202832822525,43.5635025489192
0.679028331119965,0.711487433616151,1070,221,36,36,14,6,22,30,41.9202832822525,43.5635025489192
0.723576447260658,0.771566670344773,1082,209,37,22,13,5,24,17,41.9202832822525,43.5635025489192
0.751428151384047,0.794448647542961,1078,213,38,45,17,13,21,32,41.9202832822525,43.5635025489192
0.778110998699234,0.806325869088533,1057,234,33,52,19,16,14,36,41.9202832822525,43.5635025489192
0.716500785751703,0.748849420421941,1069,222,46,65,22,23,24,42,41.9202832822525,43.5635025489192
0.752263414634146,0.784123088933965,1060,231,41,26,22,8,19,18,41.9202832822525,43.5635025489192
0.774215566850086,0.82226389770511,1081,210,38,27,22,6,16,21,41.9202832822525,43.5635025489192
0.727093061358237,0.763617663354646,1076,215,39,50,13,13,26,37,41.9202832822525,43.5635025489192
0.797212230215827,0.823598439752448,1047,244,40,49,24,15,16,34,41.9202832822525,43.5635025489192
0.740218044701896,0.783826119445729,1070,221,29,49,13,12,16,37,41.9202832822525,43.5635025489192
0.746068127608825,0.796288608184928,1076,215,43,45,24,13,19,32,41.9202832822525,43.5635025489192
0.672776019690577,0.711809340201195,1075,216,27,12,12,3,15,9,41.9202832822525,43.5635025489192
0.775887170154686,0.813900098611582,1059,232,35,65,18,17,17,48,41.9202832822525,43.5635025489192
0.760884895359418,0.800849371589025,1074,217,35,53,15,15,20,38,41.9202832822525,43.5635025489192
0.709707317073171,0.739180033055133,1052,239,41,55,20,16,21,39,41.9202832822525,43.5635025489192
0.839592434471803,0.872899799196096,1055,236,32,76,21,25,11,51,41.9202832822525,43.5635025489192
0.768293492695883,0.817140033680662,1062,229,36,67,20,23,16,44,41.9202832822525,43.5635025489192
0.724198765069097,0.763718930031914,1053,238,38,48,21,15,17,33,41.9202832822525,43.5635025489192
0.758388667552014,0.802165206764903,1057,234,36,34,23,11,13,23,41.9202832822525,43.5635025489192
0.766390565772848,0.801413195236008,1081,210,34,29,18,8,16,21,41.9202832822525,43.5635025489192
0.768377574057604,0.796280293192565,1047,244,47,43,25,18,22,25,41.9202832822525,43.5635025489192
0.776152073732719,0.804095373524577,1057,234,31,36,14,14,17,22,41.9202832822525,43.5635025489192
0.792275059194949,0.812396951063811,1070,221,24,33,13,9,11,24,41.9202832822525,43.5635025489192
0.675989535941765,0.727823192914005,1084,207,35,47,11,10,24,37,41.9202832822525,43.5635025489192
0.794956477214542,0.821134124542341,1054,237,31,45,19,16,12,29,41.9202832822525,43.5635025489192
0.741010437728838,0.771210450817623,1093,198,29,41,14,12,15,29,41.9202832822525,43.5635025489192
0.778288642425944,0.818007973714597,1064,227,34,22,22,8,12,14,41.9202832822525,43.5635025489192
0.795249205718825,0.822526693965123,1062,229,32,45,18,18,14,27,41.9202832822525,43.5635025489192
0.739014982110912,0.800681627917299,1043,248,43,112,20,27,23,85,41.9202832822525,43.5635025489192
0.690528196981732,0.738265086170011,1076,215,32,39,13,10,19,29,41.9202832822525,43.5635025489192
0.749359582542694,0.78076673458763,1050,241,51,45,24,16,27,29,41.9202832822525,43.5635025489192
0.772167606768735,0.812476648775223,1058,233,50,58,28,21,22,37,41.9202832822525,43.5635025489192
0.729292370608742,0.77596928554644,1048,243,48,59,26,15,22,44,41.9202832822525,43.5635025489192
0.809755662564651,0.845508963723799,1068,223,45,38,29,14,16,24,41.9202832822525,43.5635025489192
0.792745803357314,0.823418645001917,1075,216,40,63,24,21,16,42,41.9202832822525,43.5635025489192
0.808302122347066,0.831752165641408,1052,239,45,83,25,24,20,59,41.9202832822525,43.5635025489192
0.715178308900744,0.767363124652283,1067,224,38,75,17,22,21,53,41.9202832822525,43.5635025489192
0.760943695479778,0.818790783598169,1050,241,30,37,18,14,12,23,41.9202832822525,43.5635025489192
0.689638289368505,0.716861033874792,1072,219,40,39,11,11,29,28,41.9202832822525,43.5635025489192
0.735616064336775,0.801685485043803,1079,212,32,81,15,21,17,60,41.9202832822525,43.5635025489192
0.706624390243902,0.750126778364769,1037,254,41,61,16,17,25,44,41.9202832822525,43.5635025489192
0.693745537026925,0.738895623219084,1076,215,38,22,17,7,21,15,41.9202832822525,43.5635025489192
0.731404112394528,0.754552530105222,1073,218,39,49,18,16,21,33,41.9202832822525,43.5635025489192
0.715044319097502,0.766441137424374,1044,247,50,45,28,18,22,27,41.9202832822525,43.5635025489192
0.714517993929759,0.773172382894999,1091,200,33,85,18,18,15,67,41.9202832822525,43.5635025489192
0.784818228366615,0.843277728278602,1046,245,31,26,21,9,10,17,41.9202832822525,43.5635025489192
0.777596870647989,0.821941199367585,1055,236,39,22,24,7,15,15,41.9202832822525,43.5635025489192
0.805211514534555,0.832524217999395,1045,246,28,29,17,10,11,19,41.9202832822525,43.5635025489192
0.727940859519807,0.753862725483784,1090,201,37,28,13,10,24,18,41.9202832822525,43.5635025489192
0.738574788927626,0.788293730322245,1050,241,38,85,15,23,23,62,41.9202832822525,43.5635025489192
0.777247211489393,0.804098350195954,1053,238,44,40,27,19,17,21,41.9202832822525,43.5635025489192
0.724086293228508,0.757030499693105,1076,215,34,42,12,11,22,31,41.9202832822525,43.5635025489192
0.761590224560601,0.819255379022127,1055,236,42,64,23,18,19,46,41.9202832822525,43.5635025489192
0.753416163601479,0.821496634065035,1043,248,34,96,16,32,18,64,41.9202832822525,43.5635025489192
0.74354810546534,0.790919802229958,1060,231,46,88,22,24,24,64,41.9202832822525,43.5635025489192
0.789191598015127,0.838298541538943,1063,228,33,39,17,13,16,26,41.9202832822525,43.5635025489192
0.752198867024448,0.782802988941141,1080,211,43,27,18,9,25,18,41.9202832822525,43.5635025489192
0.682866388137954,0.721842685689924,1080,211,39,56,12,7,27,49,41.9202832822525,43.5635025489192
0.729575334985509,0.77602449733061,1072,219,38,35,19,11,19,24,41.9202832822525,43.5635025489192
0.752443374353487,0.775049298105106,1087,204,45,69,17,22,28,47,41.9202832822525,43.5635025489192
0.739738209432454,0.780632709776201,1065,226,40,85,17,24,23,61,41.9202832822525,43.5635025489192
0.691911162499398,0.735769526691303,1055,236,33,73,13,14,20,59,41.9202832822525,43.5635025489192
0.709219083010001,0.7372540441169,1088,203,29,20,10,5,19,15,41.9202832822525,43.5635025489192
0.713522596863216,0.762280915698418,1049,242,29,30,16,12,13,18,41.9202832822525,43.5635025489192
0.720046249458014,0.767535395300716,1072,219,33,32,16,13,17,19,41.9202832822525,43.5635025489192
0.778102628558938,0.824102922176348,1096,195,29,38,13,16,16,22,41.9202832822525,43.5635025489192
0.793227091633466,0.82353061634585,1074,217,36,57,22,15,14,42,41.9202832822525,43.5635025489192
0.788897784894582,0.832012491650016,1078,213,42,43,23,13,19,30,41.9202832822525,43.5635025489192
0.764043824701195,0.784897843258207,1075,216,36,32,16,10,20,22,41.9202832822525,43.5635025489192
0.728662420382166,0.775978828182938,1076,215,35,49,17,13,18,36,41.9202832822525,43.5635025489192
0.722945850741378,0.772950508578561,1042,249,39,41,19,13,20,28,41.9202832822525,43.5635025489192
0.792056958037552,0.832128595589117,1061,230,38,22,20,9,18,13,41.9202832822525,43.5635025489192
0.729178082191781,0.756421177819931,1075,216,50,37,23,13,27,24,41.9202832822525,43.5635025489192
0.779039397963701,0.829470146954897,1054,237,36,49,22,17,14,32,41.9202832822525,43.5635025489192
0.733203257550051,0.759101152045311,1081,210,28,39,11,10,17,29,41.9202832822525,43.5635025489192
0.764561352796647,0.809753187195985,1068,223,33,48,19,16,14,32,41.9202832822525,43.5635025489192
0.717509556012937,0.767037135284091,1047,244,38,51,19,17,19,34,41.9202832822525,43.5635025489192
0.725004096010486,0.771900955850285,1057,234,39,22,17,8,22,14,41.9202832822525,43.5635025489192
0.754625958234206,0.807107044621922,1073,218,30,39,15,16,15,23,41.9202832822525,43.5635025489192
0.798158369309798,0.850881217730706,1050,241,29,57,18,22,11,35,41.9202832822525,43.5635025489192
0.759796238244514,0.809867724661935,1083,208,44,73,22,23,22,50,41.9202832822525,43.5635025489192
0.816513056835637,0.849777887777049,1064,227,31,37,20,10,11,27,41.9202832822525,43.5635025489192
0.701524112829845,0.758129008814265,1066,225,35,41,17,13,18,28,41.9202832822525,43.5635025489192
0.651059152677858,0.707283169269186,1072,219,40,72,19,19,21,53,41.9202832822525,43.5635025489192
0.727111005692599,0.775459176545361,1091,200,51,95,22,27,29,68,41.9202832822525,43.5635025489192
0.740855323020928,0.785633491277627,1083,208,35,51,17,17,18,34,41.9202832822525,43.5635025489192
0.789922656960873,0.817859083455777,1049,242,35,41,20,12,15,29,41.9202832822525,43.5635025489192
0.715790480354118,0.745816537117503,1080,211,29,20,13,4,16,16,41.9202832822525,43.5635025489192
0.813515668778827,0.839905303810852,1074,217,37,49,22,22,15,27,41.9202832822525,43.5635025489192
0.703982185450209,0.749035459405373,1048,243,43,50,19,15,24,35,41.9202832822525,43.5635025489192
0.717106460418562,0.774063696527109,1077,214,35,37,15,7,20,30,41.9202832822525,43.5635025489192
0.684011776753712,0.745321083887706,1070,221,31,38,12,7,19,31,41.9202832822525,43.5635025489192
0.719452261939766,0.769763830482976,1062,229,38,57,18,15,20,42,41.9202832822525,43.5635025489192
0.765024390243902,0.787194864454227,1046,245,41,20,24,4,17,16,41.9202832822525,43.5635025489192
0.676863572433193,0.698437190407612,1063,228,27,41,10,8,17,33,41.9202832822525,43.5635025489192
0.717982256596906,0.74335575788957,1071,220,35,64,14,13,21,51,41.9202832822525,43.5635025489192
0.737326829268293,0.798199875298739,1049,242,41,78,21,22,20,56,41.9202832822525,43.5635025489192
0.857866350960274,0.871360901609164,1073,218,24,40,16,14,8,26,41.9202832822525,43.5635025489192
0.735131707317073,0.773553839997228,1065,226,41,26,20,9,21,17,41.9202832822525,43.5635025489192
0.716657307314334,0.759002914357978,1093,198,34,49,14,16,20,33,41.9202832822525,43.5635025489192
0.696990960122476,0.730569460550693,1090,201,44,65,16,17,28,48,41.9202832822525,43.5635025489192
0.758361204013378,0.828280638423824,1065,226,26,45,15,14,11,31,41.9202832822525,43.5635025489192
0.773930855315747,0.815377536111062,1025,266,40,54,19,16,21,38,41.9202832822525,43.5635025489192
0.776978417266187,0.829863514266975,1054,237,40,150,25,44,15,106,41.9202832822525,43.5635025489192
0.820651381497412,0.860770450022198,1045,246,44,66,28,23,16,43,41.9202832822525,43.5635025489192
0.665322734377979,0.70944364127254,1058,233,42,56,17,11,25,45,41.9202832822525,43.5635025489192
0.722554227534307,0.7627099049713,1066,225,36,42,15,11,21,31,41.9202832822525,43.5635025489192
0.751424390243902,0.81458460066499,1074,217,41,70,22,18,19,52,41.9202832822525,43.5635025489192
0.765092682926829,0.799437367518971,1065,226,41,34,21,11,20,23,41.9202832822525,43.5635025489192
0.697068612391193,0.733781634249635,1058,233,31,28,12,7,19,21,41.9202832822525,43.5635025489192
0.691794674859191,0.737716433135941,1066,225,31,78,12,13,19,65,41.9202832822525,43.5635025489192
0.733632848043676,0.759245611575272,1069,222,35,51,14,13,21,38,41.9202832822525,43.5635025489192
0.709529473962464,0.756738359572771,1051,240,30,43,14,13,16,30,41.9202832822525,43.5635025489192
0.729956032587612,0.77742466178071,1066,225,37,79,16,21,21,58,41.9202832822525,43.5635025489192
0.734210145974852,0.771881032059877,1060,231,33,39,13,11,20,28,41.9202832822525,43.5635025489192
0.818475055296142,0.853305502169208,1059,232,39,44,23,18,16,26,41.9202832822525,43.5635025489192
0.710746496720334,0.760304226203996,1056,235,43,67,19,19,24,48,41.9202832822525,43.5635025489192
0.792598466825271,0.827336751017067,1073,218,30,31,19,8,11,23,41.9202832822525,43.5635025489192
0.761904761904762,0.812990553650476,1056,235,42,57,21,24,21,33,41.9202832822525,43.5635025489192
0.793926156172554,0.851892778051134,1042,249,38,78,21,22,17,56,41.9202832822525,43.5635025489192
0.784245307956648,0.82775223938357,1052,239,30,31,19,13,11,18,41.9202832822525,43.5635025489192
0.672657450076805,0.717352110783518,1093,198,31,59,10,16,21,43,41.9202832822525,43.5635025489192
0.6932673673226,0.736316650037638,1085,206,43,38,13,8,30,30,41.9202832822525,43.5635025489192
0.762833729844039,0.7987357079207,1057,234,30,65,14,14,16,51,41.9202832822525,43.5635025489192
0.760573618821041,0.805040781517962,1060,231,30,64,17,21,13,43,41.9202832822525,43.5635025489192
0.710483210483211,0.742925689205917,1067,224,33,39,15,13,18,26,41.9202832822525,43.5635025489192
0.691361784349141,0.741218791016612,1061,230,38,73,15,21,23,52,41.9202832822525,43.5635025489192
0.73083222664896,0.777146680086707,1068,223,36,49,18,18,18,31,41.9202832822525,43.5635025489192
0.752677258017064,0.776251214454293,1059,232,55,44,30,15,25,29,41.9202832822525,43.5635025489192
0.70692784417884,0.738252751632136,1079,212,36,51,13,15,23,36,41.9202832822525,43.5635025489192
0.729604576624925,0.785714133715101,1086,205,43,22,22,9,21,13,41.9202832822525,43.5635025489192
0.767186808322266,0.840552102451778,1072,219,36,72,18,19,18,53,41.9202832822525,43.5635025489192
0.786450079239303,0.834747274655315,1079,212,29,73,12,14,17,59,41.9202832822525,43.5635025489192
0.79715821812596,0.822732131386332,1088,203,31,31,15,9,16,22,41.9202832822525,43.5635025489192
0.765835312747427,0.801260597925857,1069,222,28,53,13,11,15,42,41.9202832822525,43.5635025489192
0.748403780988051,0.816879573363285,1071,220,45,136,20,34,25,102,41.9202832822525,43.5635025489192
0.682572974583002,0.731649593493129,1065,226,32,19,15,7,17,12,41.9202832822525,43.5635025489192
0.740865766481334,0.790660704963436,1054,237,32,75,16,19,16,56,41.9202832822525,43.5635025489192
0.703980487804878,0.745694563254429,1084,207,41,30,15,4,26,26,41.9202832822525,43.5635025489192
0.775069675938576,0.834771774439524,1081,210,29,97,15,24,14,73,41.9202832822525,43.5635025489192
0.76710243902439,0.801368266940337,1077,214,41,62,23,17,18,45,41.9202832822525,43.5635025489192
0.733294792118322,0.768284297031392,1071,220,33,83,13,16,20,67,41.9202832822525,43.5635025489192
0.690956097560976,0.740067525630615,1078,213,41,91,16,20,25,71,41.9202832822525,43.5635025489192
0.687433439829606,0.720573743864389,1065,226,39,25,16,2,23,23,41.9202832822525,43.5635025489192
0.692275343072156,0.73968700266659,1068,223,36,88,16,27,20,61,41.9202832822525,43.5635025489192
0.702355350742447,0.738392848796857,1090,201,31,39,13,6,18,33,41.9202832822525,43.5635025489192
0.740722542000094,0.783979001734218,1042,249,34,100,15,31,19,69,41.9202832822525,43.5635025489192
0.768484720857317,0.802426044184986,1059,232,34,55,15,9,19,46,41.9202832822525,43.5635025489192
0.754061531651173,0.81072055426565,1060,231,36,47,21,21,15,26,41.9202832822525,43.5635025489192
0.802049698160887,0.831716406647358,1059,232,34,45,21,13,13,32,41.9202832822525,43.5635025489192
0.767466027178257,0.810819283285969,1061,230,40,107,19,27,21,80,41.9202832822525,43.5635025489192
0.789362063115032,0.790765834705858,1062,229,28,42,12,11,16,31,41.9202832822525,43.5635025489192
0.739978016293806,0.785230779302588,1047,244,37,48,20,17,17,31,41.9202832822525,43.5635025489192
0.803347322142286,0.812936792236822,1078,213,40,37,19,14,21,23,41.9202832822525,43.5635025489192
0.747638841759982,0.772453946722722,1078,213,28,48,12,12,16,36,41.9202832822525,43.5635025489192
0.769939639006095,0.804287717828859,1079,212,27,57,13,16,14,41,41.9202832822525,43.5635025489192
0.747675962815405,0.786054146747637,1043,248,36,30,17,8,19,22,41.9202832822525,43.5635025489192
0.775359712230216,0.828898064905599,1073,218,40,77,21,25,19,52,41.9202832822525,43.5635025489192
0.698819512195122,0.74627114280382,1093,198,41,51,18,14,23,37,41.9202832822525,43.5635025489192
0.792981055991935,0.829765809022169,1066,225,38,75,21,21,17,54,41.9202832822525,43.5635025489192
0.753444365102701,0.814788301309907,1077,214,38,76,20,21,18,55,41.9202832822525,43.5635025489192
0.700827621880253,0.751795487080612,1061,230,37,35,16,12,21,23,41.9202832822525,43.5635025489192
0.69159089047268,0.720328133355232,1082,209,39,53,12,14,27,39,41.9202832822525,43.5635025489192
0.689647041302621,0.716554059953672,1059,232,32,23,13,4,19,19,41.9202832822525,43.5635025489192
0.801828466193107,0.827119531919969,1089,202,24,61,10,11,14,50,41.9202832822525,43.5635025489192
0.734250468823254,0.779648565814155,1075,216,27,47,13,9,14,38,41.9202832822525,43.5635025489192
0.647927071218444,0.693175233732908,1082,209,47,50,16,15,31,35,41.9202832822525,43.5635025489192
0.701221581269087,0.738958179199778,1064,227,28,26,12,11,16,15,41.9202832822525,43.5635025489192
0.780220230613695,0.806099579199868,1075,216,29,30,13,8,16,22,41.9202832822525,43.5635025489192
0.741488428838309,0.785664849158799,1076,215,42,77,20,21,22,56,41.9202832822525,43.5635025489192
0.715139442231076,0.749325226265461,1061,230,36,24,17,5,19,19,41.9202832822525,43.5635025489192
0.725722717088365,0.769407288935005,1095,196,29,84,11,20,18,64,41.9202832822525,43.5635025489192
0.744267515923567,0.806477720268994,1048,243,35,76,18,21,17,55,41.9202832822525,43.5635025489192
0.686853558627752,0.739347840373353,1084,207,31,50,12,17,19,33,41.9202832822525,43.5635025489192
0.769892104159518,0.80608020377662,1052,239,42,42,23,9,19,33,41.9202832822525,43.5635025489192
0.666645114013535,0.737719548158129,1084,207,37,47,13,9,24,38,41.9202832822525,43.5635025489192
0.758882893685052,0.805845247176712,1064,227,40,64,21,20,19,44,41.9202832822525,43.5635025489192
0.780486227854649,0.82417722618297,1090,201,37,47,21,14,16,33,41.9202832822525,43.5635025489192
0.823828613302298,0.859084850884708,1071,220,37,41,26,15,11,26,41.9202832822525,43.5635025489192
0.75491461477363,0.793962334068373,1054,237,32,36,18,14,14,22,41.9202832822525,43.5635025489192
0.759288560712611,0.791252456621746,1069,222,27,26,12,5,15,21,41.9202832822525,43.5635025489192
0.749092682926829,0.77707225774138,1061,230,41,52,22,20,19,32,41.9202832822525,43.5635025489192
0.787260191846523,0.813477341126485,1054,237,40,38,21,14,19,24,41.9202832822525,43.5635025489192
0.714790880323306,0.751467234401837,1031,260,42,71,17,17,25,54,41.9202832822525,43.5635025489192
0.737637729231004,0.7994214843848,1027,264,42,110,22,28,20,82,41.9202832822525,43.5635025489192
0.734293394777266,0.76972549177941,1090,201,31,80,13,21,18,59,41.9202832822525,43.5635025489192
0.809079847408577,0.827805324018577,1077,214,24,88,14,23,10,65,41.9202832822525,43.5635025489192
0.757464083485423,0.806503230268415,1052,239,34,70,19,15,15,55,41.9202832822525,43.5635025489192
0.71256304151041,0.751733183847585,1081,210,37,61,18,15,19,46,41.9202832822525,43.5635025489192
0.810850773430391,0.837215423233202,1054,237,35,42,23,13,12,29,41.9202832822525,43.5635025489192
0.741335833441097,0.818821079765751,1073,218,37,77,20,24,17,53,41.9202832822525,43.5635025489192
0.790570095501932,0.823583366145997,1069,222,44,33,24,14,20,19,41.9202832822525,43.5635025489192
0.739792839903459,0.774615984504433,1077,214,48,51,22,11,26,40,41.9202832822525,43.5635025489192
0.691376783482047,0.744261666345568,1081,210,37,67,13,17,24,50,41.9202832822525,43.5635025489192
0.71894192763758,0.773784398181217,1066,225,26,49,14,16,12,33,41.9202832822525,43.5635025489192
0.668349168646081,0.709901897878537,1081,210,28,50,11,12,17,38,41.9202832822525,43.5635025489192
0.777534562211982,0.815527377023575,1077,214,31,30,14,9,17,21,41.9202832822525,43.5635025489192
0.697786106332432,0.741486431550718,1063,228,39,31,16,5,23,26,41.9202832822525,43.5635025489192
0.725236001551791,0.771593841184524,1055,236,37,39,17,9,20,30,41.9202832822525,43.5635025489192
0.725512032770097,0.779878442755766,1043,248,31,85,16,20,15,65,41.9202832822525,43.5635025489192
0.750782647584973,0.793544713975333,1063,228,43,53,24,17,19,36,41.9202832822525,43.5635025489192
0.677479312807158,0.73071873482876,1073,218,38,67,13,15,25,52,41.9202832822525,43.5635025489192
0.786203366696997,0.83238271575332,1056,235,35,95,20,24,15,71,41.9202832822525,43.5635025489192
0.750590948949636,0.79064439769056,1051,240,42,28,23,11,19,17,41.9202832822525,43.5635025489192
0.749210734017364,0.817360800719725,1073,218,24,98,12,22,12,76,41.9202832822525,43.5635025489192
0.736515658254789,0.773336963345482,1065,226,26,48,10,13,16,35,41.9202832822525,43.5635025489192
0.74129541864139,0.79632290369239,1071,220,25,87,11,22,14,65,41.9202832822525,43.5635025489192
0.770020481310804,0.803752833536929,1068,223,31,66,17,19,14,47,41.9202832822525,43.5635025489192
0.669574613284804,0.723164022644299,1063,228,35,49,12,16,23,33,41.9202832822525,43.5635025489192
0.784152196790318,0.808551818407083,1043,248,24,25,16,10,8,15,41.9202832822525,43.5635025489192
0.779954601012747,0.814650749789471,1059,232,46,50,29,16,17,34,41.9202832822525,43.5635025489192
0.767818740399385,0.795436802316309,1078,213,31,47,12,12,19,35,41.9202832822525,43.5635025489192
0.675101782956619,0.749181336633115,1066,225,34,66,17,12,17,54,41.9202832822525,43.5635025489192
0.717013375398468,0.753070150886926,1076,215,49,27,25,7,24,20,41.9202832822525,43.5635025489192
0.735101411572,0.796186961157859,1062,229,33,147,17,40,16,107,41.9202832822525,43.5635025489192
0.772814778405833,0.811907952252419,1047,244,39,46,26,19,13,27,41.9202832822525,43.5635025489192
0.785992930729773,0.826698775702185,1057,234,37,71,22,23,15,48,41.9202832822525,43.5635025489192
0.743721913825007,0.773983277438061,1036,255,30,63,12,14,18,49,41.9202832822525,43.5635025489192
0.713804999434453,0.740738415491632,1083,208,28,43,10,9,18,34,41.9202832822525,43.5635025489192
0.756589299763965,0.783346570029161,1077,214,20,51,10,16,10,35,41.9202832822525,43.5635025489192
0.734985365853659,0.772434767809395,1075,216,41,51,17,15,24,36,41.9202832822525,43.5635025489192
0.781003584229391,0.819302315405363,1095,196,31,59,17,16,14,43,41.9202832822525,43.5635025489192
0.693434146341463,0.731396724298909,1063,228,41,51,17,19,24,32,41.9202832822525,43.5635025489192
0.751332461786002,0.767623700957814,1055,236,48,57,20,16,28,41,41.9202832822525,43.5635025489192
0.820659917510311,0.866622240869173,1056,235,21,80,12,16,9,64,41.9202832822525,43.5635025489192
0.699763676353596,0.744077976791512,1075,216,34,38,10,10,24,28,41.9202832822525,43.5635025489192
0.730971983030201,0.788822184228578,1058,233,38,80,16,24,22,56,41.9202832822525,43.5635025489192
0.754161133244799,0.802642196534769,1049,242,36,52,19,14,17,38,41.9202832822525,43.5635025489192
0.780270896957358,0.832396387530227,1080,211,28,69,18,16,10,53,41.9202832822525,43.5635025489192
0.757206861239119,0.800142695205144,1070,221,31,26,16,10,15,16,41.9202832822525,43.5635025489192
0.767069118816978,0.801807055612709,1077,214,34,67,18,18,16,49,41.9202832822525,43.5635025489192
0.706568868333574,0.747989258016701,1061,230,33,57,15,15,18,42,41.9202832822525,43.5635025489192
0.705482800768291,0.750948964152332,1081,210,46,62,19,17,27,45,41.9202832822525,43.5635025489192
0.746820983663089,0.797833462542324,1070,221,37,72,18,19,19,53,41.9202832822525,43.5635025489192
0.784826856991805,0.802968389974478,1069,222,30,45,15,12,15,33,41.9202832822525,43.5635025489192
0.752675585284281,0.795160835765817,1077,214,26,27,13,8,13,19,41.9202832822525,43.5635025489192
0.772248974496165,0.82832535799113,1077,214,45,152,24,34,21,118,41.9202832822525,43.5635025489192
0.750449378799894,0.79749146605754,1064,227,30,25,16,7,14,18,41.9202832822525,43.5635025489192
0.596884309831182,0.622875263577698,1068,223,19,70,6,13,13,57,41.9202832822525,43.5635025489192
0.799483578337614,0.830465253004005,1081,210,29,80,15,22,14,58,41.9202832822525,43.5635025489192
0.707387869152575,0.765661483360271,1031,260,33,54,17,18,16,36,41.9202832822525,43.5635025489192
0.763800354139,0.796961833678304,1060,231,36,22,19,9,17,13,41.9202832822525,43.5635025489192
0.742119241461477,0.797466139495903,1072,219,32,31,15,9,17,22,41.9202832822525,43.5635025489192
0.7825864422202,0.80984043434112,1078,213,35,36,18,10,17,26,41.9202832822525,43.5635025489192
0.797270245677889,0.834445507691747,1071,220,35,35,21,12,14,23,41.9202832822525,43.5635025489192
0.714819097172038,0.78873680210978,1066,225,33,61,17,16,16,45,41.9202832822525,43.5635025489192
0.786556893585647,0.837110182742427,1046,245,39,84,21,25,18,59,41.9202832822525,43.5635025489192
0.714209827357238,0.768795839711269,1065,226,36,71,17,19,19,52,41.9202832822525,43.5635025489192
0.75229974377284,0.786335655557455,1061,230,38,37,16,9,22,28,41.9202832822525,43.5635025489192
0.767767537122376,0.7891311435608,1054,237,31,27,15,8,16,19,41.9202832822525,43.5635025489192
0.706026882497471,0.745820375144063,1063,228,33,43,14,11,19,32,41.9202832822525,43.5635025489192
0.734354675531146,0.806292339613902,1061,230,33,49,19,10,14,39,41.9202832822525,43.5635025489192
0.717804549099657,0.757319825037024,1067,224,44,38,20,11,24,27,41.9202832822525,43.5635025489192
0.738623330875727,0.768721150862689,1068,223,39,55,14,8,25,47,41.9202832822525,43.5635025489192
0.746019108280255,0.777298488049723,1085,206,35,42,14,9,21,33,41.9202832822525,43.5635025489192
0.746127567972296,0.778466431663129,1084,207,34,60,14,17,20,43,41.9202832822525,43.5635025489192
0.784946341463415,0.814298608793383,1088,203,41,62,22,17,19,45,41.9202832822525,43.5635025489192
0.833412635474491,0.847285183633739,1067,224,30,67,21,20,9,47,41.9202832822525,43.5635025489192
0.719021716301928,0.757777001564275,1068,223,38,78,15,23,23,55,41.9202832822525,43.5635025489192
0.753265846179695,0.804639896804823,1071,220,38,79,14,16,24,63,41.9202832822525,43.5635025489192
0.755263284675049,0.801775788377652,1055,236,33,60,16,14,17,46,41.9202832822525,43.5635025489192
0.809074811863657,0.836693321035654,1070,221,36,120,23,32,13,88,41.9202832822525,43.5635025489192
0.693068666752877,0.740437559338473,1088,203,37,60,13,22,24,38,41.9202832822525,43.5635025489192
0.695133613858681,0.727714901270128,1066,225,29,71,11,17,18,54,41.9202832822525,43.5635025489192
0.805427547363031,0.83513184754314,1056,235,31,47,19,15,12,32,41.9202832822525,43.5635025489192
0.678326652010863,0.711590664533329,1059,232,37,55,15,15,22,40,41.9202832822525,43.5635025489192
0.793870425449373,0.805019993800208,1057,234,37,41,19,9,18,32,41.9202832822525,43.5635025489192
0.721654090548054,0.754303278542501,1073,218,32,37,15,9,17,28,41.9202832822525,43.5635025489192
0.778864788312463,0.829633192937494,1044,247,43,45,28,20,15,25,41.9202832822525,43.5635025489192
0.787336576467011,0.825813656975227,1054,237,26,30,18,14,8,16,41.9202832822525,43.5635025489192
0.757463113347821,0.788646982713444,1083,208,42,48,20,14,22,34,41.9202832822525,43.5635025489192
0.753328852858403,0.788211765780652,1068,223,38,55,13,15,25,40,41.9202832822525,43.5635025489192
0.725765876565295,0.759071239195929,1052,239,43,41,22,15,21,26,41.9202832822525,43.5635025489192
0.75141169878012,0.801236515084301,1063,228,37,85,16,19,21,66,41.9202832822525,43.5635025489192
0.75649756097561,0.811759819462458,1078,213,41,72,20,16,21,56,41.9202832822525,43.5635025489192
0.759844836811129,0.78539305504475,1066,225,45,57,20,16,25,41,41.9202832822525,43.5635025489192
0.733264364843312,0.797505519916629,1091,200,37,39,20,9,17,30,41.9202832822525,43.5635025489192
0.697872059212265,0.724482531267347,1073,218,30,41,14,7,16,34,41.9202832822525,43.5635025489192
0.787170568940165,0.856893071267528,1062,229,28,70,18,17,10,53,41.9202832822525,43.5635025489192
0.728735245936069,0.794483803539918,1061,230,38,110,19,31,19,79,41.9202832822525,43.5635025489192
0.73923860911271,0.774950031039933,1070,221,40,67,16,20,24,47,41.9202832822525,43.5635025489192
0.765490351572826,0.801005940175538,1072,219,30,45,18,16,12,29,41.9202832822525,43.5635025489192
0.647554850647634,0.687862705517418,1077,214,30,94,10,19,20,75,41.9202832822525,43.5635025489192
0.765840703823295,0.822096882050518,1080,211,34,57,19,20,15,37,41.9202832822525,43.5635025489192
0.755251240545358,0.80219283271788,1053,238,33,22,19,9,14,13,41.9202832822525,43.5635025489192
0.80973003989289,0.842110570266576,1059,232,29,55,15,20,14,35,41.9202832822525,43.5635025489192
0.713792763482205,0.77113669127009,1067,224,49,87,21,25,28,62,41.9202832822525,43.5635025489192
0.743090267568362,0.799167121481262,1081,210,38,42,16,11,22,31,41.9202832822525,43.5635025489192
0.718456690801824,0.755463955099811,1058,233,48,37,20,12,28,25,41.9202832822525,43.5635025489192
0.744180009836603,0.782705529252131,1080,211,29,29,14,8,15,21,41.9202832822525,43.5635025489192
0.720605700712589,0.767695431700317,1081,210,28,41,11,9,17,32,41.9202832822525,43.5635025489192
0.787242975342017,0.831688088114696,1058,233,39,34,24,10,15,24,41.9202832822525,43.5635025489192
0.774955436720143,0.814123294802537,1082,209,33,31,18,8,15,23,41.9202832822525,43.5635025489192
0.674581005586592,0.708205492618266,1086,205,38,22,13,3,25,19,41.9202832822525,43.5635025489192
0.706115848279918,0.756217019269672,1090,201,38,89,18,25,20,64,41.9202832822525,43.5635025489192
0.782689965136304,0.818035497214483,1055,236,38,57,21,17,17,40,41.9202832822525,43.5635025489192
0.725139220365951,0.760355151971539,1053,238,34,41,15,14,19,27,41.9202832822525,43.5635025489192
0.766190792386012,0.804339345907514,1091,200,36,45,18,13,18,32,41.9202832822525,43.5635025489192
0.771073170731707,0.798411014075781,1076,215,41,30,23,9,18,21,41.9202832822525,43.5635025489192
0.698363403332347,0.743076912961955,1077,214,49,27,23,7,26,20,41.9202832822525,43.5635025489192
0.730719734194394,0.775174610281614,1056,235,34,94,16,22,18,72,41.9202832822525,43.5635025489192
0.777605145252204,0.831140245953656,1069,222,33,99,16,20,17,79,41.9202832822525,43.5635025489192
0.762363512283895,0.804933956929561,1060,231,35,44,21,13,14,31,41.9202832822525,43.5635025489192
0.770153876898481,0.821672702523911,1074,217,40,36,24,12,16,24,41.9202832822525,43.5635025489192
0.791584746456951,0.819533863938311,1059,232,39,76,22,27,17,49,41.9202832822525,43.5635025489192
0.73023898698056,0.761670031661417,1046,245,45,17,22,7,23,10,41.9202832822525,43.5635025489192
0.718107819589005,0.765715258765323,1081,210,42,68,20,15,22,53,41.9202832822525,43.5635025489192
0.739733742959549,0.798646719030533,1070,221,31,59,17,22,14,37,41.9202832822525,43.5635025489192
0.785036373271667,0.814268039661783,1048,243,33,26,20,11,13,15,41.9202832822525,43.5635025489192
0.704887719699569,0.762808018338667,1053,238,42,59,19,14,23,45,41.9202832822525,43.5635025489192
0.758273703041145,0.783119421749859,1079,212,43,29,21,5,22,24,41.9202832822525,43.5635025489192
0.720447284345048,0.80380255056939,1042,249,39,88,20,22,19,66,41.9202832822525,43.5635025489192
0.708842188739096,0.770859801468789,1083,208,30,129,13,31,17,98,41.9202832822525,43.5635025489192
0.76290393979637,0.811314020665158,1079,212,36,60,20,17,16,43,41.9202832822525,43.5635025489192
0.736243913235945,0.763718306868463,1068,223,36,27,17,10,19,17,41.9202832822525,43.5635025489192
0.755696485305798,0.799064813573112,1054,237,32,38,16,13,16,25,41.9202832822525,43.5635025489192
0.711431527221001,0.756398319459019,1092,199,37,47,16,12,21,35,41.9202832822525,43.5635025489192
0.724945040734514,0.770574351549842,1081,210,37,40,17,11,20,29,41.9202832822525,43.5635025489192
0.747374721720502,0.783331720584693,1072,219,38,22,17,4,21,18,41.9202832822525,43.5635025489192
0.765569096601073,0.811538452945717,1066,225,43,69,22,18,21,51,41.9202832822525,43.5635025489192
0.731464084405261,0.78049107555501,1048,243,33,28,18,6,15,22,41.9202832822525,43.5635025489192
0.739760360763268,0.793198941161186,1045,246,43,54,23,19,20,35,41.9202832822525,43.5635025489192
0.669944044764188,0.698317935857458,1073,218,40,36,12,8,28,28,41.9202832822525,43.5635025489192
0.707239467383543,0.740023901423914,1072,219,38,37,14,8,24,29,41.9202832822525,43.5635025489192
0.75192512492832,0.794981815766843,1067,224,39,67,19,19,20,48,41.9202832822525,43.5635025489192
0.730279487688642,0.77071838632148,1069,222,32,32,16,15,16,17,41.9202832822525,43.5635025489192
0.718222043443282,0.805607371903717,1069,222,48,107,26,39,22,68,41.9202832822525,43.5635025489192
0.782563694267516,0.827809844618589,1077,214,35,39,19,12,16,27,41.9202832822525,43.5635025489192
0.776253658536585,0.831404298280811,1061,230,41,125,21,29,20,96,41.9202832822525,43.5635025489192
0.760070567480153,0.793916646817551,1084,207,38,33,21,6,17,27,41.9202832822525,43.5635025489192
0.692753517532989,0.767911400355285,1059,232,44,73,18,22,26,51,41.9202832822525,43.5635025489192
0.730799026117751,0.804280838904352,1079,212,36,71,20,19,16,52,41.9202832822525,43.5635025489192
0.726645519429025,0.774059220748229,1064,227,30,66,15,16,15,50,41.9202832822525,43.5635025489192
0.756884107546008,0.797815092180689,1070,221,47,52,22,18,25,34,41.9202832822525,43.5635025489192
0.692549923195084,0.751773385408399,1086,205,31,27,15,6,16,21,41.9202832822525,43.5635025489192
0.675747120730739,0.730677761427786,1082,209,32,56,10,9,22,47,41.9202832822525,43.5635025489192
0.756244313011829,0.815343678046038,1068,223,35,69,20,14,15,55,41.9202832822525,43.5635025489192
0.743604567133979,0.77228049413402,1065,226,33,35,11,8,22,27,41.9202832822525,43.5635025489192
0.760092961487384,0.79034698808454,1055,236,36,36,20,10,16,26,41.9202832822525,43.5635025489192
0.794527211918516,0.81218988571998,1073,218,26,37,13,10,13,27,41.9202832822525,43.5635025489192
0.802470547866865,0.86341154407264,1050,241,42,154,24,44,18,110,41.9202832822525,43.5635025489192
0.726086854789649,0.789188285871424,1094,197,34,60,17,20,17,40,41.9202832822525,43.5635025489192
0.735570731707317,0.785377549431026,1083,208,41,50,20,15,21,35,41.9202832822525,43.5635025489192
0.727832474776724,0.775174853688159,1059,232,53,50,23,14,30,36,41.9202832822525,43.5635025489192
0.790992319297764,0.814340749844708,1060,231,23,80,11,15,12,65,41.9202832822525,43.5635025489192
0.752258950017156,0.811732207404532,1042,249,42,55,22,14,20,41,41.9202832822525,43.5635025489192
0.762032085561497,0.803865366468666,1066,225,33,41,16,11,17,30,41.9202832822525,43.5635025489192
0.713494242906008,0.740873270437317,1075,216,33,38,12,8,21,30,41.9202832822525,43.5635025489192
0.738569890963545,0.761653637810415,1074,217,34,21,15,10,19,11,41.9202832822525,43.5635025489192
0.700749400479616,0.739181508040348,1067,224,40,33,15,8,25,25,41.9202832822525,43.5635025489192
0.731313849734902,0.768245412829938,1097,194,37,58,14,12,23,46,41.9202832822525,43.5635025489192
0.68244798583444,0.731277931480504,1062,229,36,41,17,15,19,26,41.9202832822525,43.5635025489192
0.706362019748233,0.725039546026214,1072,219,34,37,12,9,22,28,41.9202832822525,43.5635025489192
0.695657260517572,0.735861023948709,1089,202,34,34,12,9,22,25,41.9202832822525,43.5635025489192
0.771520055599682,0.800600315581348,1076,215,32,75,14,18,18,57,41.9202832822525,43.5635025489192
0.722324628776242,0.786576551480686,1068,223,31,91,15,19,16,72,41.9202832822525,43.5635025489192
0.767470427661511,0.797013241400634,1058,233,35,24,19,7,16,17,41.9202832822525,43.5635025489192
0.739785227867994,0.782177653822842,1057,234,46,35,21,14,25,21,41.9202832822525,43.5635025489192
0.769666339089335,0.801455065669021,1034,257,34,50,20,18,14,32,41.9202832822525,43.5635025489192
0.767166113843456,0.804715346845045,1067,224,42,34,23,9,19,25,41.9202832822525,43.5635025489192
0.797255422753431,0.838690702070108,1064,227,36,56,20,12,16,44,41.9202832822525,43.5635025489192
0.773201438848921,0.810216485230629,1073,218,40,74,21,20,19,54,41.9202832822525,43.5635025489192
0.706584732214229,0.751520817379281,1052,239,40,54,17,11,23,43,41.9202832822525,43.5635025489192
0.752421732416117,0.78742812094392,1074,217,34,125,14,33,20,92,41.9202832822525,43.5635025489192
0.743730407523511,0.795400594377356,1073,218,44,74,23,19,21,55,41.9202832822525,43.5635025489192
0.664584210772615,0.738799186081389,1068,223,34,99,14,29,20,70,41.9202832822525,43.5635025489192
0.66810591330207,0.698287365137873,1062,229,42,31,16,7,26,24,41.9202832822525,43.5635025489192
0.715853658536585,0.773201692272994,1100,191,41,70,17,18,24,52,41.9202832822525,43.5635025489192
0.701885807990459,0.742981099878893,1075,216,43,67,21,18,22,49,41.9202832822525,43.5635025489192
0.778861902756329,0.820108986101884,1047,244,34,58,17,15,17,43,41.9202832822525,43.5635025489192
0.713687150837989,0.761185277968199,1058,233,38,35,19,4,19,31,41.9202832822525,43.5635025489192
0.700807552320291,0.724493985708639,1063,228,35,42,12,10,23,32,41.9202832822525,43.5635025489192
0.792751217352811,0.847432961650201,1071,220,36,95,20,23,16,72,41.9202832822525,43.5635025489192
0.742959549411162,0.788945384189354,1069,222,31,29,15,8,16,21,41.9202832822525,43.5635025489192
0.728504765687053,0.762340250756431,1065,226,32,22,14,6,18,16,41.9202832822525,43.5635025489192
0.793212743865785,0.81755454790379,1040,251,29,14,18,5,11,9,41.9202832822525,43.5635025489192
0.777607175433262,0.832585932087279,1078,213,26,29,15,9,11,20,41.9202832822525,43.5635025489192
0.701339088092076,0.748851474948822,1066,225,36,36,15,11,21,25,41.9202832822525,43.5635025489192
0.746390243902439,0.779629630726739,1080,211,41,58,15,11,26,47,41.9202832822525,43.5635025489192
0.802185888420066,0.833209629840938,1091,200,27,42,16,13,11,29,41.9202832822525,43.5635025489192
0.731016833484986,0.785788959200261,1072,219,35,82,16,23,19,59,41.9202832822525,43.5635025489192
0.741217042081369,0.777926686765168,1050,241,46,43,24,15,22,28,41.9202832822525,43.5635025489192
0.732720295755534,0.754580367870397,1051,240,34,33,14,8,20,25,41.9202832822525,43.5635025489192
0.763626023657871,0.815847086767439,1032,259,35,51,20,16,15,35,41.9202832822525,43.5635025489192
0.756407453959233,0.816889593746309,1073,218,29,105,14,24,15,81,41.9202832822525,43.5635025489192
0.754276610017889,0.801328745954599,1066,225,43,64,24,21,19,43,41.9202832822525,43.5635025489192
0.69868106019238,0.756601639818184,1047,244,38,80,19,22,19,58,41.9202832822525,43.5635025489192
0.694012745974955,0.75889675632283,1060,231,43,84,18,27,25,57,41.9202832822525,43.5635025489192
0.802352587573091,0.862864782120492,1114,177,29,101,15,26,14,75,41.9202832822525,43.5635025489192
0.792404845036424,0.817016491255051,1069,222,37,64,17,18,20,46,41.9202832822525,43.5635025489192
0.720097388224878,0.752643470718807,1069,222,36,56,15,19,21,37,41.9202832822525,43.5635025489192
0.693016821602479,0.729063626855395,1072,219,36,56,12,13,24,43,41.9202832822525,43.5635025489192
0.740781037952174,0.768126199428885,1039,252,34,23,17,9,17,14,41.9202832822525,43.5635025489192
0.776156097560976,0.795060439827098,1078,213,41,39,20,13,21,26,41.9202832822525,43.5635025489192
0.750716845878136,0.795369978331419,1081,210,31,51,15,12,16,39,41.9202832822525,43.5635025489192
0.76499558953249,0.81804886086902,1056,235,38,69,21,19,17,50,41.9202832822525,43.5635025489192
0.806352368304559,0.859684834446192,1069,222,36,75,21,21,15,54,41.9202832822525,43.5635025489192
0.73968253968254,0.775623494254705,1069,222,45,49,18,17,27,32,41.9202832822525,43.5635025489192
0.729424390243903,0.792808146708973,1076,215,41,53,22,19,19,34,41.9202832822525,43.5635025489192
0.783639254227489,0.840391643139766,1055,236,33,106,21,26,12,80,41.9202832822525,43.5635025489192
0.76565059144677,0.814894816979576,1101,190,35,30,20,7,15,23,41.9202832822525,43.5635025489192
0.754544290834613,0.819948476267287,1061,230,31,77,18,22,13,55,41.9202832822525,43.5635025489192
0.81319381255687,0.84975261691916,1052,239,35,57,23,23,12,34,41.9202832822525,43.5635025489192
0.720023980815348,0.762324542656617,1041,250,40,43,21,16,19,27,41.9202832822525,43.5635025489192
0.659489822891885,0.70170599718288,1075,216,30,85,12,12,18,73,41.9202832822525,43.5635025489192
0.737703196538833,0.800048424692898,1051,240,38,75,21,22,17,53,41.9202832822525,43.5635025489192
0.788926980778247,0.813179633185823,1061,230,27,27,14,7,13,20,41.9202832822525,43.5635025489192
0.744313011828935,0.769463397738077,1076,215,35,32,18,10,17,22,41.9202832822525,43.5635025489192
0.759912195121951,0.820292081722233,1072,219,41,68,22,19,19,49,41.9202832822525,43.5635025489192
0.806172349986783,0.815302967172733,1051,240,30,78,15,17,15,61,41.9202832822525,43.5635025489192
0.793721495895409,0.828704988878748,1064,227,26,36,15,16,11,20,41.9202832822525,43.5635025489192
0.74804708400214,0.798303358133708,1053,238,45,73,23,22,22,51,41.9202832822525,43.5635025489192
0.687336585365854,0.729687656362936,1055,236,41,41,20,15,21,26,41.9202832822525,43.5635025489192
0.781119558735838,0.807328545899264,1065,226,43,62,26,22,17,40,41.9202832822525,43.5635025489192
0.716485624380361,0.750391076468631,1073,218,37,39,15,8,22,31,41.9202832822525,43.5635025489192
0.74513417160476,0.776772690717115,1094,197,33,88,13,25,20,63,41.9202832822525,43.5635025489192
0.809986351228389,0.830354094776825,1058,233,35,50,23,15,12,35,41.9202832822525,43.5635025489192
0.779636290967226,0.813862601565453,1066,225,40,57,20,18,20,39,41.9202832822525,43.5635025489192
0.694933975377284,0.739309229142124,1045,246,32,46,15,12,17,34,41.9202832822525,43.5635025489192
0.717440619161996,0.75848213338614,1062,229,42,86,18,20,24,66,41.9202832822525,43.5635025489192
0.783174729051018,0.824098996547824,1067,224,30,34,15,10,15,24,41.9202832822525,43.5635025489192
0.748005355483906,0.787043288733325,1067,224,29,42,15,15,14,27,41.9202832822525,43.5635025489192
0.804546996946047,0.836516195310882,1071,220,28,69,17,16,11,53,41.9202832822525,43.5635025489192
0.801757218400487,0.833253565524102,1089,202,34,25,17,7,17,18,41.9202832822525,43.5635025489192
0.780946780358718,0.824384653140316,1064,227,38,70,19,19,19,51,41.9202832822525,43.5635025489192
0.734393574542018,0.784935168511985,1027,264,53,60,28,26,25,34,41.9202832822525,43.5635025489192
0.658505929285753,0.717582343142958,1065,226,29,69,11,14,18,55,41.9202832822525,43.5635025489192
0.697627965043695,0.734008321250764,1062,229,45,77,18,20,27,57,41.9202832822525,43.5635025489192
0.72076252236136,0.78532173505072,1077,214,43,79,19,16,24,63,41.9202832822525,43.5635025489192
0.74887972020329,0.786826185379089,1055,236,29,43,16,10,13,33,41.9202832822525,43.5635025489192
0.673219512195122,0.710323481618879,1066,225,41,31,17,9,24,22,41.9202832822525,43.5635025489192
0.751181618232018,0.785165911519815,1077,214,34,29,16,8,18,21,41.9202832822525,43.5635025489192
0.728895305971983,0.768493481977578,1064,227,39,30,19,7,20,23,41.9202832822525,43.5635025489192
0.671389907455911,0.698597065973522,1073,218,46,56,19,17,27,39,41.9202832822525,43.5635025489192
0.699883716497007,0.748462332500511,1074,217,42,63,18,15,24,48,41.9202832822525,43.5635025489192
0.668438973284442,0.698613567227536,1047,244,46,45,17,14,29,31,41.9202832822525,43.5635025489192
0.743423905188611,0.798258854997824,1060,231,33,62,15,15,18,47,41.9202832822525,43.5635025489192
0.828478169310684,0.854271575536454,1080,211,34,64,24,15,10,49,41.9202832822525,43.5635025489192
0.789998001598721,0.826508676030956,1085,206,40,36,22,10,18,26,41.9202832822525,43.5635025489192
0.721360381861575,0.778449738393984,1076,215,34,60,17,15,17,45,41.9202832822525,43.5635025489192
0.72810517914899,0.741417380427044,1103,188,38,45,11,9,27,36,41.9202832822525,43.5635025489192
0.677162808741756,0.70742602658201,1054,237,37,38,15,13,22,25,41.9202832822525,43.5635025489192
0.718636564851704,0.749923812774384,1070,221,36,29,16,5,20,24,41.9202832822525,43.5635025489192
0.790834613415259,0.822765805417237,1053,238,31,72,13,21,18,51,41.9202832822525,43.5635025489192
0.683941118151644,0.760799578774312,1102,189,37,89,13,15,24,74,41.9202832822525,43.5635025489192
0.754720200181984,0.810496614650339,1054,237,35,83,19,22,16,61,41.9202832822525,43.5635025489192
0.705822132292721,0.739451956218182,1058,233,33,31,15,7,18,24,41.9202832822525,43.5635025489192
0.720836405341198,0.7542638788437,1085,206,39,46,15,9,24,37,41.9202832822525,43.5635025489192
0.772930500221337,0.802264718980807,1060,231,36,43,18,17,18,26,41.9202832822525,43.5635025489192
0.761383312274791,0.801514061452885,1077,214,34,29,19,8,15,21,41.9202832822525,43.5635025489192
0.727737809752198,0.775329420890967,1057,234,40,47,20,17,20,30,41.9202832822525,43.5635025489192
0.74975922953451,0.797380106371228,1063,228,45,52,21,21,24,31,41.9202832822525,43.5635025489192
0.779576344707924,0.815727881047153,1068,223,56,42,32,20,24,22,41.9202832822525,43.5635025489192
0.733928152836381,0.781983313038144,1076,215,27,61,10,11,17,50,41.9202832822525,43.5635025489192
0.764268557703306,0.800394324959964,1089,202,42,58,19,17,23,41,41.9202832822525,43.5635025489192
0.72227305654047,0.764500426348173,1054,237,42,34,21,15,21,19,41.9202832822525,43.5635025489192
0.719977317595665,0.765287895090046,1048,243,38,78,16,18,22,60,41.9202832822525,43.5635025489192
0.701331285202253,0.739358534528738,1102,189,31,32,13,7,18,25,41.9202832822525,43.5635025489192
0.71142628388425,0.783377173536082,1059,232,42,69,18,16,24,53,41.9202832822525,43.5635025489192
0.807123975680677,0.836507136840589,1069,222,30,19,17,6,13,13,41.9202832822525,43.5635025489192
0.778440731901352,0.817662032451593,1082,209,34,37,18,8,16,29,41.9202832822525,43.5635025489192
0.840035063906798,0.878185852074241,1022,269,28,86,21,22,7,64,41.9202832822525,43.5635025489192
0.723155778395552,0.763159903838845,1092,199,32,24,11,5,21,19,41.9202832822525,43.5635025489192
0.660912108280529,0.728854374026495,1075,216,37,37,16,12,21,25,41.9202832822525,43.5635025489192
0.737586245899785,0.788586606285453,1078,213,28,61,15,16,13,45,41.9202832822525,43.5635025489192
0.749191037929057,0.793949598415108,1051,240,39,97,21,24,18,73,41.9202832822525,43.5635025489192
0.685227854582693,0.713830999454727,1060,231,31,61,10,14,21,47,41.9202832822525,43.5635025489192
0.716136585365854,0.738531333532511,1045,246,41,74,20,22,21,52,41.9202832822525,43.5635025489192
0.751336585365854,0.790421131839445,1073,218,41,70,22,18,19,52,41.9202832822525,43.5635025489192
0.727682227682228,0.774201249941791,1062,229,33,34,18,13,15,21,41.9202832822525,43.5635025489192
0.712078106814949,0.759007897825716,1088,203,37,26,16,8,21,18,41.9202832822525,43.5635025489192
0.73977277059743,0.775781022792912,1057,234,42,49,18,17,24,32,41.9202832822525,43.5635025489192
0.682938919781025,0.733677529224668,1057,234,37,51,14,12,23,39,41.9202832822525,43.5635025489192
0.699369019024744,0.736850222881857,1061,230,42,62,16,18,26,44,41.9202832822525,43.5635025489192
0.813303945656887,0.861552207806299,1069,222,33,60,19,16,14,44,41.9202832822525,43.5635025489192
0.725085910652921,0.798101321248223,1066,225,30,33,14,8,16,25,41.9202832822525,43.5635025489192
0.78569119358593,0.819736370082698,1079,212,37,36,19,14,18,22,41.9202832822525,43.5635025489192
0.754565557207671,0.782164455755319,1078,213,42,36,19,12,23,24,41.9202832822525,43.5635025489192
0.762459637793065,0.793953100066088,1055,236,34,33,14,11,20,22,41.9202832822525,43.5635025489192
0.796902054377837,0.827667424286068,1060,231,34,77,19,18,15,59,41.9202832822525,43.5635025489192
0.791026856240126,0.813214020484654,1083,208,25,56,10,11,15,45,41.9202832822525,43.5635025489192
0.740208122561064,0.784899820570492,1082,209,33,41,12,4,21,37,41.9202832822525,43.5635025489192
0.704729701348343,0.733586652705773,1080,211,38,17,16,7,22,10,41.9202832822525,43.5635025489192
0.821731383632342,0.843469993787618,1059,232,39,40,22,15,17,25,41.9202832822525,43.5635025489192
0.781085077343039,0.833756761596992,1102,189,35,88,14,19,21,69,41.9202832822525,43.5635025489192
0.726050785372819,0.772421897689003,1045,246,52,83,25,20,27,63,41.9202832822525,43.5635025489192
0.722730810190874,0.763139585247466,1074,217,39,15,15,5,24,10,41.9202832822525,43.5635025489192
0.659476321241027,0.698084935101218,1055,236,33,73,11,18,22,55,41.9202832822525,43.5635025489192
0.762634168157424,0.805884201917407,1059,232,43,42,23,14,20,28,41.9202832822525,43.5635025489192
0.722120829238617,0.76200802165625,1059,232,34,58,15,13,19,45,41.9202832822525,43.5635025489192
0.737563760587767,0.790131473978756,1076,215,34,59,15,13,19,46,41.9202832822525,43.5635025489192
0.756668538537133,0.78737866674156,1066,225,34,30,18,13,16,17,41.9202832822525,43.5635025489192
0.785722888664065,0.824167158285975,1070,221,33,66,19,18,14,48,41.9202832822525,43.5635025489192
0.708410801239487,0.74817411528793,1077,214,36,48,14,12,22,36,41.9202832822525,43.5635025489192
0.825345486621582,0.863665191419343,1071,220,38,85,22,26,16,59,41.9202832822525,43.5635025489192
0.795928116469518,0.814370950928425,1052,239,35,27,17,11,18,16,41.9202832822525,43.5635025489192
0.778969034160727,0.803418195432706,1048,243,39,41,21,14,18,27,41.9202832822525,43.5635025489192
0.750435227854583,0.802176611076198,1063,228,31,24,16,11,15,13,41.9202832822525,43.5635025489192
0.712939648281375,0.746837095227266,1041,250,40,71,19,25,21,46,41.9202832822525,43.5635025489192
0.77041095141811,0.811179347492624,1075,216,29,64,16,19,13,45,41.9202832822525,43.5635025489192
0.753969517743403,0.7895625067428,1076,215,35,31,14,10,21,21,41.9202832822525,43.5635025489192
0.732253118830596,0.786096787352559,1066,225,38,89,16,20,22,69,41.9202832822525,43.5635025489192
0.727778580719757,0.764807851609411,1097,194,33,64,12,16,21,48,41.9202832822525,43.5635025489192
0.716129032258064,0.755960624321848,1082,209,31,50,12,16,19,34,41.9202832822525,43.5635025489192
0.73669757958432,0.788782397763673,1076,215,24,54,11,15,13,39,41.9202832822525,43.5635025489192
0.707146048451152,0.756581562999704,1071,220,32,31,13,8,19,23,41.9202832822525,43.5635025489192
0.68097609561753,0.732598236075777,1072,219,36,30,14,12,22,18,41.9202832822525,43.5635025489192
0.730738510690587,0.788380424386553,1049,242,39,182,21,43,18,139,41.9202832822525,43.5635025489192
0.652162447257384,0.724276036999878,1035,256,27,43,13,11,14,32,41.9202832822525,43.5635025489192
0.701588750058496,0.750755082476757,1081,210,34,29,13,10,21,19,41.9202832822525,43.5635025489192
0.764681791104051,0.812272113740991,1052,239,32,43,16,15,16,28,41.9202832822525,43.5635025489192
0.69946542311192,0.75851197980563,1033,258,35,33,16,9,19,24,41.9202832822525,43.5635025489192
0.653686122831692,0.680371593123785,1067,224,27,33,8,11,19,22,41.9202832822525,43.5635025489192
0.715149359886202,0.76158832026965,1057,234,37,78,19,21,18,57,41.9202832822525,43.5635025489192
0.750009756097561,0.788238194865113,1051,240,41,34,21,12,20,22,41.9202832822525,43.5635025489192
0.806582077716098,0.840993681711426,1058,233,30,77,18,17,12,60,41.9202832822525,43.5635025489192
0.722324265289913,0.771454178425484,1067,224,32,86,16,23,16,63,41.9202832822525,43.5635025489192
0.76315843368559,0.798839796504629,1078,213,39,83,18,21,21,62,41.9202832822525,43.5635025489192
0.767996465364887,0.803876090407604,1076,215,37,39,20,15,17,24,41.9202832822525,43.5635025489192
0.834806989540891,0.854745058663744,1064,227,38,43,26,16,12,27,41.9202832822525,43.5635025489192
0.750304178950817,0.796227436678917,1039,252,34,34,21,15,13,19,41.9202832822525,43.5635025489192
0.676012911307029,0.72922922047296,1070,221,33,17,12,4,21,13,41.9202832822525,43.5635025489192
0.679096262160778,0.712772680251056,1066,225,31,34,11,7,20,27,41.9202832822525,43.5635025489192
0.839888535031847,0.864428907110399,1076,215,35,40,20,10,15,30,41.9202832822525,43.5635025489192
0.761988171064604,0.790122546541473,1090,201,35,53,16,13,19,40,41.9202832822525,43.5635025489192
0.783388615654428,0.818880485898137,1079,212,42,47,24,15,18,32,41.9202832822525,43.5635025489192
0.777658310805276,0.816745540663143,1068,223,39,45,25,15,14,30,41.9202832822525,43.5635025489192
0.80116055968927,0.828656070501148,1055,236,34,42,24,18,10,24,41.9202832822525,43.5635025489192
0.688236047107015,0.73659308662062,1047,244,31,53,16,15,15,38,41.9202832822525,43.5635025489192
0.734986351228389,0.784016604333039,1057,234,35,53,17,18,18,35,41.9202832822525,43.5635025489192
0.778387290167866,0.823612894040436,1072,219,40,56,22,19,18,37,41.9202832822525,43.5635025489192
0.745407615982837,0.777177973290883,1071,220,48,56,23,19,25,37,41.9202832822525,43.5635025489192
0.707485465116279,0.726641307791613,1052,239,43,32,20,12,23,20,41.9202832822525,43.5635025489192
0.740466535594331,0.778366319577961,1078,213,39,56,17,17,22,39,41.9202832822525,43.5635025489192
0.735346650142159,0.774262248163857,1079,212,44,51,20,12,24,39,41.9202832822525,43.5635025489192
0.741132137298272,0.781665699341423,1075,216,39,54,16,13,23,41,41.9202832822525,43.5635025489192
0.791595973306187,0.823717347910968,1078,213,28,42,18,15,10,27,41.9202832822525,43.5635025489192
0.70089928057554,0.739879216332216,1054,237,40,66,16,20,24,46,41.9202832822525,43.5635025489192
0.747544582998123,0.795727708699862,1054,237,48,49,25,14,23,35,41.9202832822525,43.5635025489192
0.755177048767169,0.788506384973572,1087,204,38,64,14,18,24,46,41.9202832822525,43.5635025489192
0.702817745803357,0.741411220896208,1081,210,40,63,15,13,25,50,41.9202832822525,43.5635025489192
0.749224104487263,0.784690820222588,1085,206,37,33,16,10,21,23,41.9202832822525,43.5635025489192
0.765811159650516,0.80181844822931,1055,236,32,58,16,17,16,41,41.9202832822525,43.5635025489192
0.714773737657354,0.782324549061725,1093,198,34,74,15,17,19,57,41.9202832822525,43.5635025489192
0.825908372827804,0.853646188270068,1064,227,25,59,14,17,11,42,41.9202832822525,43.5635025489192
0.740990990990991,0.772013011091505,1057,234,33,57,15,13,18,44,41.9202832822525,43.5635025489192
0.709674776767429,0.766022597603075,1069,222,39,94,17,24,22,70,41.9202832822525,43.5635025489192
0.78654934471803,0.807232562713321,1056,235,32,45,17,13,15,32,41.9202832822525,43.5635025489192
0.673458929636255,0.718361229723054,1068,223,43,59,15,16,28,43,41.9202832822525,43.5635025489192
0.796007734303913,0.820534579082783,1069,222,35,37,22,17,13,20,41.9202832822525,43.5635025489192
0.64815483933131,0.696149407067662,1074,217,33,82,10,16,23,66,41.9202832822525,43.5635025489192
0.741443902439024,0.77751648289482,1052,239,41,54,20,16,21,38,41.9202832822525,43.5635025489192
0.776790906687814,0.803345526879993,1053,238,30,67,17,21,13,46,41.9202832822525,43.5635025489192
0.823820348980093,0.858482960189088,1071,220,39,85,27,28,12,57,41.9202832822525,43.5635025489192
0.830912463265405,0.874680158575782,1054,237,33,66,22,22,11,44,41.9202832822525,43.5635025489192
0.829246602717826,0.863029812290527,1062,229,40,87,25,25,15,62,41.9202832822525,43.5635025489192
0.740764039803271,0.785411383937031,1060,231,42,66,20,17,22,49,41.9202832822525,43.5635025489192
0.707185237329042,0.742357740704365,1064,227,48,36,23,8,25,28,41.9202832822525,43.5635025489192
0.73768265873529,0.804965619213841,1073,218,37,63,19,19,18,44,41.9202832822525,43.5635025489192
0.762965853658537,0.79472324633898,1068,223,41,46,19,19,22,27,41.9202832822525,43.5635025489192
0.831397890595114,0.870116254534254,1073,218,29,76,18,19,11,57,41.9202832822525,43.5635025489192
0.780955599246334,0.809699998475724,1070,221,39,60,20,20,19,40,41.9202832822525,43.5635025489192
0.770193640525896,0.799336124681209,1077,214,38,63,16,12,22,51,41.9202832822525,43.5635025489192
0.666596471524171,0.733864024765605,1053,238,34,40,18,11,16,29,41.9202832822525,43.5635025489192
0.783253842077371,0.808806902039838,1089,202,33,67,15,18,18,49,41.9202832822525,43.5635025489192
0.75615719406042,0.809897094009771,1076,215,31,119,17,26,14,93,41.9202832822525,43.5635025489192
0.688370325326847,0.745428971624487,1059,232,26,36,12,8,14,28,41.9202832822525,43.5635025489192
0.731638340892945,0.777921859368802,1067,224,29,37,15,11,14,26,41.9202832822525,43.5635025489192
0.750051200131072,0.783657306542764,1044,247,39,36,23,17,16,19,41.9202832822525,43.5635025489192
0.698123510722796,0.791524510135426,1073,218,32,77,16,23,16,54,41.9202832822525,43.5635025489192
0.694404069767442,0.745910074313034,1085,206,43,53,16,16,27,37,41.9202832822525,43.5635025489192
0.786363185067514,0.805785042036875,1066,225,32,26,17,10,15,16,41.9202832822525,43.5635025489192
0.770897215104801,0.79768467383471,1061,230,38,27,17,12,21,15,41.9202832822525,43.5635025489192
0.772520473157416,0.796885842257442,1049,242,35,57,20,14,15,43,41.9202832822525,43.5635025489192
0.793853915258783,0.818646138220595,1068,223,48,24,27,7,21,17,41.9202832822525,43.5635025489192
0.774600319744205,0.816340710410176,1046,245,40,50,24,20,16,30,41.9202832822525,43.5635025489192
0.726342979145221,0.760660603091541,1079,212,42,44,20,13,22,31,41.9202832822525,43.5635025489192
0.74169361952367,0.773856360074272,1084,207,38,46,17,5,21,41,41.9202832822525,43.5635025489192
0.719009216589862,0.742951822607315,1077,214,31,70,11,11,20,59,41.9202832822525,43.5635025489192
0.764320587358378,0.804703007649057,1071,220,43,70,23,22,20,48,41.9202832822525,43.5635025489192
0.688060435955384,0.731712628939904,1071,220,44,53,19,15,25,38,41.9202832822525,43.5635025489192
0.79356818788364,0.829781472955035,1054,237,42,72,26,25,16,47,41.9202832822525,43.5635025489192
0.819346341463415,0.8517160355556,1052,239,41,36,26,14,15,22,41.9202832822525,43.5635025489192
0.76778889899909,0.790343301279689,1041,250,35,36,17,15,18,21,41.9202832822525,43.5635025489192
0.701408953094346,0.743354915198345,1071,220,45,61,17,12,28,49,41.9202832822525,43.5635025489192
0.675112195121951,0.707676965558046,1083,208,41,43,14,10,27,33,41.9202832822525,43.5635025489192
0.660384201413262,0.682930008899084,1074,217,34,56,11,12,23,44,41.9202832822525,43.5635025489192
0.751866304716661,0.794904608158417,1046,245,28,37,15,14,13,23,41.9202832822525,43.5635025489192
0.725946178422217,0.768552182456804,1063,228,39,92,21,29,18,63,41.9202832822525,43.5635025489192
0.799820662375972,0.829816994620214,1052,239,48,59,30,24,18,35,41.9202832822525,43.5635025489192
0.730006083579016,0.767872142843047,1069,222,34,8,16,1,18,7,41.9202832822525,43.5635025489192
0.677125100240577,0.730941112798424,1070,221,44,75,13,19,31,56,41.9202832822525,43.5635025489192
0.756282926829268,0.804756925069547,1051,240,41,68,24,20,17,48,41.9202832822525,43.5635025489192
0.714438449240608,0.778655220995752,1083,208,40,75,19,19,21,56,41.9202832822525,43.5635025489192
0.686751152073733,0.726857522298211,1071,220,31,28,11,7,20,21,41.9202832822525,43.5635025489192
0.763659063804413,0.793469117304735,1060,231,43,37,21,9,22,28,41.9202832822525,43.5635025489192
0.746040663456394,0.785383094166015,1108,183,45,90,15,16,30,74,41.9202832822525,43.5635025489192
0.728082347588717,0.770055210617565,1055,236,35,48,17,15,18,33,41.9202832822525,43.5635025489192
0.763997983786281,0.813793050466558,1033,258,38,42,21,18,17,24,41.9202832822525,43.5635025489192
0.763295545673252,0.824882822718986,1062,229,44,81,27,22,17,59,41.9202832822525,43.5635025489192
0.673851228389445,0.732271777869563,1053,238,35,83,13,14,22,69,41.9202832822525,43.5635025489192
0.702411741885426,0.736601171326547,1079,212,37,44,13,7,24,37,41.9202832822525,43.5635025489192
0.753728535267155,0.779964852364379,1073,218,47,82,18,21,29,61,41.9202832822525,43.5635025489192
0.729138999557326,0.760632982574417,1065,226,36,29,17,10,19,19,41.9202832822525,43.5635025489192
0.715582115980522,0.732011037907156,1077,214,36,37,9,7,27,30,41.9202832822525,43.5635025489192
0.724016098086012,0.758111556016565,1051,240,34,40,17,10,17,30,41.9202832822525,43.5635025489192
0.729906320624043,0.746570626947635,1054,237,44,41,18,12,26,29,41.9202832822525,43.5635025489192
0.715536851683349,0.752744337348435,1076,215,35,40,13,11,22,29,41.9202832822525,43.5635025489192
0.739575653313673,0.787509899907163,1051,240,39,75,19,22,20,53,41.9202832822525,43.5635025489192
0.713249400479616,0.75267709299058,1056,235,40,17,15,4,25,13,41.9202832822525,43.5635025489192
0.692453148335501,0.759812304061389,1084,207,33,142,12,24,21,118,41.9202832822525,43.5635025489192
0.707603916866507,0.749959498963373,1074,217,40,45,17,12,23,33,41.9202832822525,43.5635025489192
0.724174960712415,0.759462938897111,1072,219,46,87,19,23,27,64,41.9202832822525,43.5635025489192
0.815457233848954,0.829168298283845,1057,234,35,28,21,12,14,16,41.9202832822525,43.5635025489192
0.782392756680731,0.834068485487592,1057,234,27,36,14,14,13,22,41.9202832822525,43.5635025489192
0.761703821656051,0.807164785183704,1049,242,35,41,19,11,16,30,41.9202832822525,43.5635025489192
0.728924265972193,0.786927839960533,1065,226,38,51,14,13,24,38,41.9202832822525,43.5635025489192
0.749473170731707,0.801465532613082,1064,227,41,42,21,10,20,32,41.9202832822525,43.5635025489192
0.73562416998672,0.774662605454083,1086,205,36,42,19,15,17,27,41.9202832822525,43.5635025489192
0.736169244767971,0.777186815555743,1055,236,35,42,21,15,14,27,41.9202832822525,43.5635025489192
0.700820674000349,0.743748708965087,1043,248,46,105,21,31,25,74,41.9202832822525,43.5635025489192
0.713888888888889,0.756393415453763,1083,208,36,52,17,12,19,40,41.9202832822525,43.5635025489192
0.780327451645741,0.80558114005455,1074,217,28,51,11,14,17,37,41.9202832822525,43.5635025489192
0.746384950161449,0.793207337031936,1056,235,34,66,14,17,20,49,41.9202832822525,43.5635025489192
0.77502770149829,0.824606301663152,1066,225,33,37,19,11,14,26,41.9202832822525,43.5635025489192
0.753523858787017,0.814495672267204,1066,225,37,39,20,14,17,25,41.9202832822525,43.5635025489192
0.818687443130118,0.861349008555809,1060,231,35,83,23,28,12,55,41.9202832822525,43.5635025489192
0.718260096401329,0.79154228846427,1051,240,34,125,16,32,18,93,41.9202832822525,43.5635025489192
0.732421358710018,0.772260532703798,1095,196,30,20,13,3,17,17,41.9202832822525,43.5635025489192
0.783124007148531,0.807677110351173,1054,237,32,48,18,16,14,32,41.9202832822525,43.5635025489192
0.661347517730496,0.72101946898779,1081,210,22,53,10,13,12,40,41.9202832822525,43.5635025489192
0.73763067880715,0.784834525875241,1072,219,33,77,15,17,18,60,41.9202832822525,43.5635025489192
0.798128474980143,0.827079150874429,1053,238,32,40,21,16,11,24,41.9202832822525,43.5635025489192
0.770887112787927,0.815138038623884,1081,210,32,57,18,19,14,38,41.9202832822525,43.5635025489192
0.759281164695177,0.789784338306927,1087,204,35,40,16,13,19,27,41.9202832822525,43.5635025489192
0.735899483902679,0.767542945792996,1069,222,39,53,20,18,19,35,41.9202832822525,43.5635025489192
0.732135336234732,0.764874620749647,1075,216,34,43,12,10,22,33,41.9202832822525,43.5635025489192
0.712941345129844,0.770473874646657,1058,233,39,49,19,16,20,33,41.9202832822525,43.5635025489192
0.765190627482129,0.81956474602786,1040,251,32,111,16,24,16,87,41.9202832822525,43.5635025489192
0.741521951219512,0.779943994986046,1063,228,41,34,21,8,20,26,41.9202832822525,43.5635025489192
0.710546564733916,0.771620641177962,1059,232,32,65,16,12,16,53,41.9202832822525,43.5635025489192
0.813071636267513,0.848091611435887,1052,239,30,59,17,18,13,41,41.9202832822525,43.5635025489192
0.760884134233519,0.814128711481948,1061,230,32,59,19,20,13,39,41.9202832822525,43.5635025489192
0.749283198164987,0.782212322788902,1067,224,39,71,17,17,22,54,41.9202832822525,43.5635025489192
0.736101119104716,0.796604638323127,1040,251,40,82,20,20,20,62,41.9202832822525,43.5635025489192
0.721702352630188,0.79258487320021,1088,203,30,33,14,9,16,24,41.9202832822525,43.5635025489192
0.7568865916692,0.781967781654803,1092,199,26,55,13,14,13,41,41.9202832822525,43.5635025489192
0.835261119936457,0.853799216035233,1065,226,32,41,15,8,17,33,41.9202832822525,43.5635025489192
0.714036228742111,0.752335013543895,1075,216,33,38,13,12,20,26,41.9202832822525,43.5635025489192
0.783564977303571,0.832904462199986,1077,214,34,65,20,18,14,47,41.9202832822525,43.5635025489192
0.728451715881884,0.772372534132719,1052,239,38,57,20,22,18,35,41.9202832822525,43.5635025489192
0.768675373938532,0.790342714876986,1056,235,37,38,20,14,17,24,41.9202832822525,43.5635025489192
0.773865667196187,0.80979816085588,1060,231,32,63,18,18,14,45,41.9202832822525,43.5635025489192
0.768429453522073,0.806782229027677,1074,217,38,56,20,20,18,36,41.9202832822525,43.5635025489192
0.767618980766531,0.819107145318565,1061,230,34,36,19,12,15,24,41.9202832822525,43.5635025489192
0.661139793486894,0.707085537991526,1047,244,32,43,11,14,21,29,41.9202832822525,43.5635025489192
0.745726065969429,0.779230243855856,1063,228,48,54,24,21,24,33,41.9202832822525,43.5635025489192
0.772488085782367,0.81030135322497,1050,241,32,47,20,15,12,32,41.9202832822525,43.5635025489192
0.661398849048252,0.694103442848986,1064,227,36,11,12,2,24,9,41.9202832822525,43.5635025489192
0.734506418769367,0.788113650155474,1074,217,36,53,14,10,22,43,41.9202832822525,43.5635025489192
0.779808594797533,0.817623071038105,1065,226,48,66,30,26,18,40,41.9202832822525,43.5635025489192
0.724629310706935,0.76812323471843,1064,227,38,47,20,15,18,32,41.9202832822525,43.5635025489192
0.749266720386785,0.791673749569311,1056,235,50,61,23,16,27,45,41.9202832822525,43.5635025489192
0.74095854160541,0.778392756645691,1059,232,38,60,17,13,21,47,41.9202832822525,43.5635025489192
0.748586132790408,0.807786180581426,1073,218,28,41,11,6,17,35,41.9202832822525,43.5635025489192
0.77156274980016,0.822111128665084,1067,224,40,53,22,21,18,32,41.9202832822525,43.5635025489192
0.710860381913014,0.735567521847909,1061,230,37,24,14,5,23,19,41.9202832822525,43.5635025489192
0.687087805508858,0.753381018776866,1066,225,37,34,17,13,20,21,41.9202832822525,43.5635025489192
0.707597816196542,0.770389151844674,1080,211,35,33,18,13,17,20,41.9202832822525,43.5635025489192
0.792946669943475,0.829156194811143,1050,241,39,85,21,23,18,62,41.9202832822525,43.5635025489192
0.749622828570197,0.804484458852478,1033,258,37,58,20,20,17,38,41.9202832822525,43.5635025489192
0.756074836016696,0.793577040935961,1053,238,43,99,17,20,26,79,41.9202832822525,43.5635025489192
0.64105133841976,0.695683577219736,1044,247,37,58,15,14,22,44,41.9202832822525,43.5635025489192
0.788770849880858,0.828408488109242,1069,222,32,47,19,14,13,33,41.9202832822525,43.5635025489192
0.712058371735791,0.74097796173135,1110,181,31,68,8,11,23,57,41.9202832822525,43.5635025489192
0.754890261593897,0.777695476762959,1077,214,34,52,16,17,18,35,41.9202832822525,43.5635025489192
0.760966383422779,0.804700079658898,1054,237,43,48,24,16,19,32,41.9202832822525,43.5635025489192
0.764798737174428,0.821298503967885,1068,223,24,81,11,22,13,59,41.9202832822525,43.5635025489192
0.717908346134153,0.76279407696209,1075,216,31,88,9,16,22,72,41.9202832822525,43.5635025489192
0.743548030101815,0.778294371808435,1038,253,36,75,16,24,20,51,41.9202832822525,43.5635025489192
0.714518090605047,0.756612687330068,1066,225,26,23,14,8,12,15,41.9202832822525,43.5635025489192
0.733188263372175,0.783639053674885,1068,223,34,47,18,14,16,33,41.9202832822525,43.5635025489192
0.766213718654177,0.79100228295749,1079,212,38,41,17,12,21,29,41.9202832822525,43.5635025489192
0.718479117415288,0.784666422760082,1084,207,22,54,10,16,12,38,41.9202832822525,43.5635025489192
0.686710634079055,0.721994901567507,1065,226,37,42,14,10,23,32,41.9202832822525,43.5635025489192
0.752176817966292,0.792244769450303,1069,222,37,42,21,13,16,29,41.9202832822525,43.5635025489192
0.72223164800362,0.780262240406286,1071,220,28,91,11,19,17,72,41.9202832822525,43.5635025489192
0.761379800853485,0.808864243641731,1073,218,37,22,20,7,17,15,41.9202832822525,43.5635025489192
0.753814644137225,0.773408722546796,1079,212,31,39,14,10,17,29,41.9202832822525,43.5635025489192
0.737114266547406,0.762897645410094,1062,229,43,75,21,18,22,57,41.9202832822525,43.5635025489192
0.801254099582588,0.825787591734269,1035,256,43,92,27,38,16,54,41.9202832822525,43.5635025489192
0.750537654005978,0.802880557521127,1056,235,44,68,21,15,23,53,41.9202832822525,43.5635025489192
0.663110112780196,0.719631990921612,1073,218,34,221,13,40,21,181,41.9202832822525,43.5635025489192
0.745525625136692,0.794991657919317,1047,244,44,48,23,19,21,29,41.9202832822525,43.5635025489192
0.730721966205837,0.762464050932817,1067,224,31,36,14,11,17,25,41.9202832822525,43.5635025489192
0.791212926073484,0.832721206933914,1081,210,36,49,19,18,17,31,41.9202832822525,43.5635025489192
0.686044073353921,0.742242385633588,1049,242,42,63,19,21,23,42,41.9202832822525,43.5635025489192
0.746556097560976,0.810949972256107,1044,247,41,105,22,30,19,75,41.9202832822525,43.5635025489192
0.695982770745429,0.771433970331936,1081,210,27,60,14,19,13,41,41.9202832822525,43.5635025489192
0.779685434840074,0.818365855115924,1061,230,30,87,16,19,14,68,41.9202832822525,43.5635025489192
0.697717139290173,0.761673004936197,1059,232,45,91,19,22,26,69,41.9202832822525,43.5635025489192
0.637231503579952,0.713104232407301,1063,228,34,103,15,18,19,85,41.9202832822525,43.5635025489192
0.726981766455451,0.806136849158243,1073,218,37,96,20,25,17,71,41.9202832822525,43.5635025489192
0.774159048288795,0.811205815034583,1067,224,27,25,16,10,11,15,41.9202832822525,43.5635025489192
0.756614815662053,0.800210623911231,1059,232,42,75,19,21,23,54,41.9202832822525,43.5635025489192
0.760321819145349,0.815470971991379,1070,221,33,27,13,5,20,22,41.9202832822525,43.5635025489192
0.727689643876644,0.776484963573903,1085,206,34,104,16,26,18,78,41.9202832822525,43.5635025489192
0.803353253652058,0.839016711919476,1059,232,36,42,21,14,15,28,41.9202832822525,43.5635025489192
0.747326829268293,0.775005201030725,1069,222,41,42,19,10,22,32,41.9202832822525,43.5635025489192
0.762,0.779377397205092,1061,230,41,41,20,12,21,29,41.9202832822525,43.5635025489192
0.729606460418562,0.761511288612826,1093,198,35,33,14,13,21,20,41.9202832822525,43.5635025489192
0.759609756097561,0.808846669059754,1066,225,41,86,18,22,23,64,41.9202832822525,43.5635025489192
0.718290806195393,0.737271535166572,1091,200,32,56,10,11,22,45,41.9202832822525,43.5635025489192
0.747786631252767,0.777510262517037,1064,227,36,66,16,19,20,47,41.9202832822525,43.5635025489192
0.733138218432336,0.790177220298746,1053,238,33,69,17,21,16,48,41.9202832822525,43.5635025489192
0.752158034528552,0.760764398210623,1090,201,36,56,11,10,25,46,41.9202832822525,43.5635025489192
0.75508929302859,0.796453905206373,1067,224,39,43,22,14,17,29,41.9202832822525,43.5635025489192
0.724970023980815,0.772374671181669,1047,244,40,74,21,19,19,55,41.9202832822525,43.5635025489192
0.73637957985436,0.765807086325897,1058,233,42,19,20,4,22,15,41.9202832822525,43.5635025489192
0.765770609318996,0.801122010277954,1077,214,31,16,15,5,16,11,41.9202832822525,43.5635025489192
0.772957662492546,0.808964291702358,1042,249,43,38,25,16,18,22,41.9202832822525,43.5635025489192
0.758353317346123,0.795747410744861,1073,218,40,58,19,11,21,47,41.9202832822525,43.5635025489192
0.783449717660244,0.820992768559449,1061,230,37,46,21,21,16,25,41.9202832822525,43.5635025489192
0.663619104716227,0.69067706257115,1062,229,40,54,11,9,29,45,41.9202832822525,43.5635025489192
0.773866078497907,0.808812051994169,1091,200,28,46,15,13,13,33,41.9202832822525,43.5635025489192
0.731721553207176,0.775543210044892,1080,211,39,36,16,9,23,27,41.9202832822525,43.5635025489192
0.7004,0.753171968950666,1039,252,41,80,18,25,23,55,41.9202832822525,43.5635025489192
0.728770731707317,0.74937157867661,1079,212,41,20,15,6,26,14,41.9202832822525,43.5635025489192
0.807264859506653,0.842675360055906,1078,213,42,71,25,24,17,47,41.9202832822525,43.5635025489192
0.618447180301827,0.6363933298719,1085,206,32,29,6,3,26,26,41.9202832822525,43.5635025489192
0.76984126984127,0.81611610913952,1052,239,45,35,25,12,20,23,41.9202832822525,43.5635025489192
0.738848780487805,0.775160601187243,1083,208,41,65,16,19,25,46,41.9202832822525,43.5635025489192
0.762298271483575,0.798916198756416,1059,232,39,30,19,6,20,24,41.9202832822525,43.5635025489192
0.781375440321127,0.809347962261266,1031,260,39,28,22,10,17,18,41.9202832822525,43.5635025489192
0.750430545637838,0.800797172222974,1094,197,38,27,21,14,17,13,41.9202832822525,43.5635025489192
0.746443446113529,0.793783871178239,1067,224,34,41,17,13,17,28,41.9202832822525,43.5635025489192
0.69777556440903,0.756979452898972,1100,191,36,53,16,11,20,42,41.9202832822525,43.5635025489192
0.696009756097561,0.76497678494347,1059,232,41,155,21,29,20,126,41.9202832822525,43.5635025489192
0.745341383422779,0.796840792721644,1040,251,43,79,20,23,23,56,41.9202832822525,43.5635025489192
0.68695102685624,0.711756162258208,1076,215,25,32,9,12,16,20,41.9202832822525,43.5635025489192
0.7735101411572,0.826004034059115,1070,221,33,43,21,17,12,26,41.9202832822525,43.5635025489192
0.737602365787079,0.765057538076063,1070,221,35,59,14,21,21,38,41.9202832822525,43.5635025489192
0.746400706927023,0.78955885078032,1039,252,37,43,21,14,16,29,41.9202832822525,43.5635025489192
0.726738038593709,0.754983573914144,1085,206,30,51,10,10,20,41,41.9202832822525,43.5635025489192
0.717474546259407,0.75497916735139,1089,202,36,31,16,8,20,23,41.9202832822525,43.5635025489192
0.778813111287338,0.819030977870827,1040,251,30,75,16,22,14,53,41.9202832822525,43.5635025489192
0.747009912345376,0.792392960830016,1056,235,39,81,20,17,19,64,41.9202832822525,43.5635025489192
0.832897537245363,0.865200081823236,1063,228,26,76,14,18,12,58,41.9202832822525,43.5635025489192
0.793660643367752,0.852463838266783,1071,220,32,119,18,33,14,86,41.9202832822525,43.5635025489192
0.818717732327244,0.851544639673957,1057,234,32,29,21,3,11,26,41.9202832822525,43.5635025489192
0.747395723946738,0.80967350864824,1052,239,38,81,20,24,18,57,41.9202832822525,43.5635025489192
0.675654123022544,0.699395922420782,1063,228,37,24,14,4,23,20,41.9202832822525,43.5635025489192
0.796122677701625,0.848102967666845,1077,214,37,29,22,12,15,17,41.9202832822525,43.5635025489192
0.757007815059198,0.788276959785919,1075,216,34,38,17,15,17,23,41.9202832822525,43.5635025489192
0.739409813165706,0.790067294818485,1071,220,46,59,27,22,19,37,41.9202832822525,43.5635025489192
0.747289615564932,0.796260007900951,1062,229,27,92,14,21,13,71,41.9202832822525,43.5635025489192
0.708582395686826,0.748965949318977,1074,217,27,47,10,12,17,35,41.9202832822525,43.5635025489192
0.747008033225859,0.836076776927285,1086,205,29,120,15,31,14,89,41.9202832822525,43.5635025489192
0.678382408535305,0.754613888275749,1082,209,38,83,13,16,25,67,41.9202832822525,43.5635025489192
0.799215266630997,0.83571412541408,1068,223,45,57,24,14,21,43,41.9202832822525,43.5635025489192
0.721615387548134,0.782009308252079,1088,203,42,111,17,25,25,86,41.9202832822525,43.5635025489192
0.749867514573397,0.792394861171558,1052,239,33,81,15,17,18,64,41.9202832822525,43.5635025489192
0.734684955462047,0.789791289117859,1055,236,29,19,15,6,14,13,41.9202832822525,43.5635025489192
0.758232872684505,0.800719241717467,1063,228,38,57,22,19,16,38,41.9202832822525,43.5635025489192
0.733595478004424,0.759533318767254,1082,209,39,48,15,12,24,36,41.9202832822525,43.5635025489192
0.817015468607825,0.850758695429044,1047,244,35,37,26,18,9,19,41.9202832822525,43.5635025489192
0.716230664240219,0.76170545874467,1049,242,35,37,20,14,15,23,41.9202832822525,43.5635025489192
0.783433685590235,0.811704084290195,1068,223,39,53,25,14,14,39,41.9202832822525,43.5635025489192
0.698673224293721,0.747709428979651,1081,210,42,38,19,9,23,29,41.9202832822525,43.5635025489192
0.691177058353317,0.731736512016259,1057,234,40,53,16,16,24,37,41.9202832822525,43.5635025489192
0.716487804878049,0.75353209835762,1080,211,41,54,16,11,25,43,41.9202832822525,43.5635025489192
0.806133885081253,0.857733465037452,1075,216,37,100,19,24,18,76,41.9202832822525,43.5635025489192
0.759852118305356,0.811450354160849,1056,235,40,45,21,18,19,27,41.9202832822525,43.5635025489192
0.790466212676794,0.826836851191324,1058,233,46,26,26,9,20,17,41.9202832822525,43.5635025489192
0.7951978980322,0.849095187922502,1069,222,43,80,23,32,20,48,41.9202832822525,43.5635025489192
0.639423934367754,0.672088607394256,1067,224,45,29,15,7,30,22,41.9202832822525,43.5635025489192
0.778429817605075,0.822500262817305,1078,213,30,29,18,15,12,14,41.9202832822525,43.5635025489192
0.751543663628345,0.788628928448761,1064,227,38,34,17,14,21,20,41.9202832822525,43.5635025489192
0.789927609998869,0.865442894916016,1077,214,28,49,16,17,12,32,41.9202832822525,43.5635025489192
0.70673339399454,0.734818862566109,1077,214,35,72,13,13,22,59,41.9202832822525,43.5635025489192
0.7492,0.774971453958615,1064,227,41,30,18,11,23,19,41.9202832822525,43.5635025489192
0.676956097560976,0.713496636392489,1080,211,41,57,17,15,24,42,41.9202832822525,43.5635025489192
0.698673612982425,0.736266279358816,1060,231,54,59,23,17,31,42,41.9202832822525,43.5635025489192
0.709202025493278,0.756043859519105,1011,280,46,54,21,16,25,38,41.9202832822525,43.5635025489192
0.682677434030937,0.740618334301841,1067,224,35,94,14,20,21,74,41.9202832822525,43.5635025489192
0.709254935692635,0.768531102136963,1067,224,39,48,20,16,19,32,41.9202832822525,43.5635025489192
0.744918805657412,0.791218265324242,1071,220,46,54,25,20,21,34,41.9202832822525,43.5635025489192
0.744745080500894,0.78740405118089,1062,229,43,76,21,27,22,49,41.9202832822525,43.5635025489192
0.730924841143765,0.777003521929137,1044,247,32,23,20,13,12,10,41.9202832822525,43.5635025489192
0.744353157267673,0.787403387292371,1068,223,32,32,16,11,16,21,41.9202832822525,43.5635025489192
0.726320492454329,0.74729959072831,1073,218,32,33,10,11,22,22,41.9202832822525,43.5635025489192
0.743010497922286,0.783771766231513,1053,238,44,53,23,16,21,37,41.9202832822525,43.5635025489192
0.780236966824645,0.81497586118965,1061,230,25,49,16,19,9,30,41.9202832822525,43.5635025489192
0.728740913454945,0.784819632020799,1071,220,23,61,7,10,16,51,41.9202832822525,43.5635025489192
0.704699612403101,0.727616364939535,1069,222,43,73,14,14,29,59,41.9202832822525,43.5635025489192
0.751543800207662,0.789397024901475,1076,215,29,27,15,11,14,16,41.9202832822525,43.5635025489192
0.74757636122178,0.791242348014099,1039,252,36,79,19,27,17,52,41.9202832822525,43.5635025489192
0.815724815724816,0.851496530295016,1074,217,33,38,22,14,11,24,41.9202832822525,43.5635025489192
0.658928571428571,0.712784129907127,1053,238,35,51,17,12,18,39,41.9202832822525,43.5635025489192
0.751216715803266,0.80649267151007,1078,213,34,37,18,11,16,26,41.9202832822525,43.5635025489192
0.783587352138308,0.826977379010791,1086,205,35,44,19,19,16,25,41.9202832822525,43.5635025489192
0.804569598888006,0.830183952262196,1067,224,32,49,17,15,15,34,41.9202832822525,43.5635025489192
0.74912711754817,0.776831690097583,1082,209,37,50,18,15,19,35,41.9202832822525,43.5635025489192
0.79110111978283,0.831619629600341,1074,217,28,51,15,13,13,38,41.9202832822525,43.5635025489192
0.783651298357181,0.828982706388802,1070,221,33,72,19,19,14,53,41.9202832822525,43.5635025489192
0.70695092979438,0.740114482060829,1084,207,39,15,16,4,23,11,41.9202832822525,43.5635025489192
0.774033341525354,0.829365621760458,1091,200,39,91,22,22,17,69,41.9202832822525,43.5635025489192
0.679779056579997,0.707039748308351,1065,226,38,41,10,13,28,28,41.9202832822525,43.5635025489192
0.761882926829268,0.810661671513606,1035,256,41,91,18,24,23,67,41.9202832822525,43.5635025489192
0.73636070293884,0.774843824509875,1051,240,32,27,16,10,16,17,41.9202832822525,43.5635025489192
0.813187327436941,0.842313053726265,1064,227,34,37,18,13,16,24,41.9202832822525,43.5635025489192
0.774688564162248,0.817068113650641,1053,238,37,70,22,23,15,47,41.9202832822525,43.5635025489192
0.697920463658234,0.743446093802783,1079,212,44,54,16,9,28,45,41.9202832822525,43.5635025489192
0.72568290215349,0.758893257848982,1072,219,33,59,15,16,18,43,41.9202832822525,43.5635025489192
0.803856071261135,0.835864594761568,1069,222,27,43,17,12,10,31,41.9202832822525,43.5635025489192
0.703832936822627,0.749727553387844,1069,222,30,58,12,18,18,40,41.9202832822525,43.5635025489192
0.761499549438847,0.796010972052065,1078,213,39,31,22,10,17,21,41.9202832822525,43.5635025489192
0.662800501035795,0.703688068079724,1063,228,33,42,13,14,20,28,41.9202832822525,43.5635025489192
0.722322142286171,0.759155456086003,1050,241,40,62,20,19,20,43,41.9202832822525,43.5635025489192
0.769373859328935,0.80638901402604,1082,209,34,51,14,18,20,33,41.9202832822525,43.5635025489192
0.799308755760369,0.839009301646742,1072,219,31,48,21,16,10,32,41.9202832822525,43.5635025489192
0.758739600844864,0.782772632258793,1063,228,37,75,18,20,19,55,41.9202832822525,43.5635025489192
0.727896644162033,0.772888446811897,1064,227,32,54,14,17,18,37,41.9202832822525,43.5635025489192
0.789171947066684,0.822383918915634,1081,210,37,58,19,17,18,41,41.9202832822525,43.5635025489192
0.741306954436451,0.794406569048377,1085,206,40,59,19,17,21,42,41.9202832822525,43.5635025489192
0.680351385321602,0.734471662168355,1073,218,29,50,12,12,17,38,41.9202832822525,43.5635025489192
0.691991365648396,0.710022750220705,1084,207,29,51,7,8,22,43,41.9202832822525,43.5635025489192
0.746943947525343,0.791103910414598,1071,220,43,60,24,15,19,45,41.9202832822525,43.5635025489192
0.721762134805613,0.771974612110401,1059,232,49,51,28,18,21,33,41.9202832822525,43.5635025489192
0.710980662983425,0.786994413808898,1073,218,24,19,12,5,12,14,41.9202832822525,43.5635025489192
0.74919212040726,0.774451446243915,1077,214,36,38,16,17,20,21,41.9202832822525,43.5635025489192
0.809033751126403,0.831294288714499,1085,206,39,29,25,11,14,18,41.9202832822525,43.5635025489192
0.666714323840024,0.731710047892081,1082,209,42,136,14,27,28,109,41.9202832822525,43.5635025489192
0.699740207833733,0.743205212776323,1055,236,40,71,17,20,23,51,41.9202832822525,43.5635025489192
0.790373783922171,0.84641508990295,1039,252,31,48,16,14,15,34,41.9202832822525,43.5635025489192
0.729953917050691,0.772864927472931,1087,204,31,23,13,14,18,9,41.9202832822525,43.5635025489192
0.803304255881576,0.825506350890706,1053,238,30,60,19,16,11,44,41.9202832822525,43.5635025489192
0.815286624203822,0.834356410647697,1081,210,35,58,20,16,15,42,41.9202832822525,43.5635025489192
0.78119880707355,0.815232653140418,1063,228,38,75,21,25,17,50,41.9202832822525,43.5635025489192
0.763877768881772,0.827254385910924,1053,238,42,125,25,37,17,88,41.9202832822525,43.5635025489192
0.729636290967226,0.767550043037525,1074,217,40,42,21,14,19,28,41.9202832822525,43.5635025489192
0.713239308462238,0.77463484513303,1074,217,35,69,19,25,16,44,41.9202832822525,43.5635025489192
0.709575708974265,0.768382457263902,1067,224,44,48,21,12,23,36,41.9202832822525,43.5635025489192
0.720967249990469,0.757397531689601,1048,243,42,57,21,16,21,41,41.9202832822525,43.5635025489192
0.745586897179254,0.80488993938542,1072,219,35,42,18,15,17,27,41.9202832822525,43.5635025489192
0.756502816180236,0.784843451459026,1066,225,31,88,17,27,14,61,41.9202832822525,43.5635025489192
0.738428838308742,0.783934655317624,1063,228,42,49,18,13,24,36,41.9202832822525,43.5635025489192
0.723501788908766,0.768772743286306,1061,230,43,64,20,21,23,43,41.9202832822525,43.5635025489192
0.712892176330421,0.753817483583839,1052,239,32,65,14,17,18,48,41.9202832822525,43.5635025489192
0.671996124031008,0.720489770883094,1062,229,43,56,14,16,29,40,41.9202832822525,43.5635025489192
0.746067829933645,0.798066339473809,1062,229,39,79,17,18,22,61,41.9202832822525,43.5635025489192
0.761047171000126,0.800754475164558,1065,226,38,60,21,21,17,39,41.9202832822525,43.5635025489192
0.745413917356919,0.764849314325634,1061,230,34,47,8,11,26,36,41.9202832822525,43.5635025489192
0.787756097560976,0.822231837945176,1074,217,41,48,21,16,20,32,41.9202832822525,43.5635025489192
0.782723900370959,0.810153402422184,1050,241,33,25,19,8,14,17,41.9202832822525,43.5635025489192
0.823192810034916,0.853825384605235,1041,250,37,35,22,16,15,19,41.9202832822525,43.5635025489192
0.807661587613664,0.840569078513662,1060,231,39,58,22,20,17,38,41.9202832822525,43.5635025489192
0.791054155964807,0.825670729264394,1051,240,29,75,18,21,11,54,41.9202832822525,43.5635025489192
0.780145941015506,0.824634526240221,1077,214,26,43,12,10,14,33,41.9202832822525,43.5635025489192
0.756438812083973,0.788258977962598,1078,213,31,34,14,11,17,23,41.9202832822525,43.5635025489192
0.665907086151132,0.724427578588055,1091,200,38,113,10,20,28,93,41.9202832822525,43.5635025489192
0.719996723191611,0.753085900523339,1067,224,39,54,16,16,23,38,41.9202832822525,43.5635025489192
0.710803869063883,0.775412109360499,1064,227,29,89,13,24,16,65,41.9202832822525,43.5635025489192
0.67469533854309,0.718098775151695,1071,220,29,35,9,7,20,28,41.9202832822525,43.5635025489192
0.746993404888142,0.792363258266859,1068,223,37,51,19,15,18,36,41.9202832822525,43.5635025489192
0.756768657327763,0.789537474319353,1045,246,39,47,21,15,18,32,41.9202832822525,43.5635025489192
0.746302957633893,0.770129595845554,1059,232,40,34,21,14,19,20,41.9202832822525,43.5635025489192
0.752013924327477,0.808591098505223,1058,233,44,72,21,18,23,54,41.9202832822525,43.5635025489192
0.728654311039484,0.763671904644386,1055,236,50,45,26,16,24,29,41.9202832822525,43.5635025489192
0.705935600672443,0.749857892770371,1086,205,37,54,12,8,25,46,41.9202832822525,43.5635025489192
0.754618251822725,0.812870907221554,1083,208,39,64,21,22,18,42,41.9202832822525,43.5635025489192
0.782027649769585,0.810330202180667,1046,245,31,36,17,11,14,25,41.9202832822525,43.5635025489192
0.735082379529052,0.802077485339025,1044,247,44,63,23,25,21,38,41.9202832822525,43.5635025489192
0.765183844131213,0.823128954907872,1072,219,37,86,16,21,21,65,41.9202832822525,43.5635025489192
0.739228844404004,0.774860966995682,1059,232,35,41,15,8,20,33,41.9202832822525,43.5635025489192
0.717674335651864,0.759148774799238,1056,235,45,45,24,14,21,31,41.9202832822525,43.5635025489192
0.7703666233078,0.829670780030862,1074,217,33,88,20,22,13,66,41.9202832822525,43.5635025489192
0.786996458610004,0.819518386066347,1086,205,36,25,19,8,17,17,41.9202832822525,43.5635025489192
0.750769384492406,0.77474984519405,1050,241,40,27,21,12,19,15,41.9202832822525,43.5635025489192
0.800813859790492,0.835915984547651,1046,245,50,64,34,25,16,39,41.9202832822525,43.5635025489192
0.821610555050046,0.857666096217596,1063,228,35,34,26,12,9,22,41.9202832822525,43.5635025489192
0.733740424916895,0.763920862564382,1057,234,33,90,16,27,17,63,41.9202832822525,43.5635025489192
0.7120007708243,0.753505061131194,1071,220,33,46,11,16,22,30,41.9202832822525,43.5635025489192
0.738090849512575,0.791624900152931,1054,237,39,68,23,24,16,44,41.9202832822525,43.5635025489192
0.779810950597468,0.82348711895354,1055,236,45,58,28,21,17,37,41.9202832822525,43.5635025489192
0.693855585193505,0.733163037413095,1084,207,34,79,11,16,23,63,41.9202832822525,43.5635025489192
0.722583719478129,0.764247526065223,1065,226,49,40,21,11,28,29,41.9202832822525,43.5635025489192
0.747332890659584,0.777004632007588,1068,223,36,46,16,16,20,30,41.9202832822525,43.5635025489192
0.73149623727313,0.761759711168624,1068,223,36,62,12,15,24,47,41.9202832822525,43.5635025489192
0.663162728355838,0.68114455471746,1094,197,32,41,8,7,24,34,41.9202832822525,43.5635025489192
0.693025561446614,0.740211736002406,1080,211,37,36,15,9,22,27,41.9202832822525,43.5635025489192
0.71697399924392,0.750401424888079,1047,244,38,62,18,18,20,44,41.9202832822525,43.5635025489192
0.692891467416784,0.754399103056875,1079,212,27,67,13,12,14,55,41.9202832822525,43.5635025489192
0.753640991589199,0.793278442571296,1044,247,36,43,22,12,14,31,41.9202832822525,43.5635025489192
0.743301737756714,0.776077092102951,1069,222,25,47,10,10,15,37,41.9202832822525,43.5635025489192
0.715619409660107,0.77972530388823,1055,236,43,47,23,17,20,30,41.9202832822525,43.5635025489192
0.796912231930103,0.831611651975472,1064,227,32,44,18,10,14,34,41.9202832822525,43.5635025489192
0.772587894316798,0.819490920646406,1072,219,38,73,20,20,18,53,41.9202832822525,43.5635025489192
0.704231119199272,0.763814925374302,1098,193,35,146,11,21,24,125,41.9202832822525,43.5635025489192
0.743737052560582,0.814955371185988,1057,234,33,57,18,18,15,39,41.9202832822525,43.5635025489192
0.730222273056541,0.774745043597816,1066,225,42,54,20,16,22,38,41.9202832822525,43.5635025489192
0.694803219617202,0.727736288239957,1045,246,34,32,16,10,18,22,41.9202832822525,43.5635025489192
0.792575524833589,0.842688968735641,1056,235,31,41,18,10,13,31,41.9202832822525,43.5635025489192
0.737704211388422,0.767899646684055,1088,203,37,27,15,9,22,18,41.9202832822525,43.5635025489192
0.678790034053192,0.728827408455032,1067,224,37,39,17,10,20,29,41.9202832822525,43.5635025489192
0.805903093721565,0.841239834220149,1065,226,35,36,15,9,20,27,41.9202832822525,43.5635025489192
0.715520240354206,0.747953757168728,1057,234,51,70,17,14,34,56,41.9202832822525,43.5635025489192
0.78285000409601,0.820127748903635,1072,219,39,57,20,15,19,42,41.9202832822525,43.5635025489192
0.7433329690147,0.779028297715679,1066,225,29,39,15,15,14,24,41.9202832822525,43.5635025489192
0.754858536585366,0.784791462674366,1083,208,41,48,17,11,24,37,41.9202832822525,43.5635025489192
0.760641532380663,0.795478272173785,1080,211,26,23,12,5,14,18,41.9202832822525,43.5635025489192
0.749726360595926,0.78925427811655,1082,209,26,51,12,16,14,35,41.9202832822525,43.5635025489192
0.788789219300401,0.846342308770769,1072,219,39,190,21,50,18,140,41.9202832822525,43.5635025489192
0.698268637704478,0.743195856382316,1069,222,48,40,22,13,26,27,41.9202832822525,43.5635025489192
0.735676481707061,0.787386896054802,1070,221,38,42,21,15,17,27,41.9202832822525,43.5635025489192
0.784337827121332,0.826942302556138,1057,234,30,78,22,25,8,53,41.9202832822525,43.5635025489192
0.680568858178833,0.71796563938265,1063,228,47,51,22,14,25,37,41.9202832822525,43.5635025489192
0.73480791300071,0.772193511228686,1076,215,29,46,10,8,19,38,41.9202832822525,43.5635025489192
0.693097200158856,0.761572135458149,1042,249,32,33,15,6,17,27,41.9202832822525,43.5635025489192
0.788348888006354,0.816925782461126,1053,238,32,71,18,29,14,42,41.9202832822525,43.5635025489192
0.826207442596991,0.827926408721524,1100,191,28,55,15,14,13,41,41.9202832822525,43.5635025489192
0.793765853658537,0.834111128559476,1049,242,41,65,26,21,15,44,41.9202832822525,43.5635025489192
0.721791513881613,0.777703137982466,1066,225,46,53,22,19,24,34,41.9202832822525,43.5635025489192
0.793235411670664,0.815193172871114,1047,244,40,36,23,12,17,24,41.9202832822525,43.5635025489192
0.679863414634146,0.705990853775286,1057,234,41,36,15,11,26,25,41.9202832822525,43.5635025489192
0.763063414634146,0.808788901277688,1046,245,41,48,19,12,22,36,41.9202832822525,43.5635025489192
0.702776835199638,0.774771685159317,1077,214,28,98,13,16,15,82,41.9202832822525,43.5635025489192
0.750647007363126,0.77841345843471,1052,239,44,43,21,14,23,29,41.9202832822525,43.5635025489192
0.723852228336204,0.763722630729209,1060,231,38,62,17,14,21,48,41.9202832822525,43.5635025489192
0.687371361364305,0.715028131886127,1095,196,38,30,12,7,26,23,41.9202832822525,43.5635025489192
0.731591548704163,0.812583170192586,1076,215,38,68,21,22,17,46,41.9202832822525,43.5635025489192
0.770609318996416,0.827766837624486,1062,229,31,97,18,21,13,76,41.9202832822525,43.5635025489192
0.710186265218342,0.765655619074004,1061,230,44,76,21,22,23,54,41.9202832822525,43.5635025489192
0.718079825258141,0.787309296463171,1058,233,32,69,17,21,15,48,41.9202832822525,43.5635025489192
0.830901481732836,0.854411252881278,1074,217,28,80,15,21,13,59,41.9202832822525,43.5635025489192
0.787024390243902,0.816810918113786,1060,231,41,77,24,19,17,58,41.9202832822525,43.5635025489192
0.750261601455869,0.781456319307036,1059,232,35,40,16,11,19,29,41.9202832822525,43.5635025489192
0.717520057126055,0.756247746283387,1053,238,38,42,20,14,18,28,41.9202832822525,43.5635025489192
0.723659995399126,0.767130582726469,1051,240,49,97,24,23,25,74,41.9202832822525,43.5635025489192
0.657624723519292,0.684643002309736,1071,220,39,46,8,9,31,37,41.9202832822525,43.5635025489192
0.717394356310543,0.747511081847618,1076,215,34,49,11,9,23,40,41.9202832822525,43.5635025489192
0.719909251881363,0.769550503841048,1061,230,36,43,16,10,20,33,41.9202832822525,43.5635025489192
0.723892682926829,0.761190783178628,1052,239,41,36,18,10,23,26,41.9202832822525,43.5635025489192
0.786351228389445,0.821802562386747,1060,231,35,63,20,17,15,46,41.9202832822525,43.5635025489192
0.776252983293556,0.810347370454833,1064,227,34,26,19,8,15,18,41.9202832822525,43.5635025489192
0.7256,0.770977705032659,1074,217,41,89,19,23,22,66,41.9202832822525,43.5635025489192
0.741833484986351,0.819028476743344,1064,227,35,84,18,25,17,59,41.9202832822525,43.5635025489192
0.717124205718824,0.758660743958236,1051,240,32,54,12,8,20,46,41.9202832822525,43.5635025489192
0.700420837124659,0.740362448156064,1047,244,35,73,10,20,25,53,41.9202832822525,43.5635025489192
0.782155976965846,0.832402721847805,1062,229,32,47,17,17,15,30,41.9202832822525,43.5635025489192
0.73336006415397,0.77949560520552,1069,222,44,80,25,26,19,54,41.9202832822525,43.5635025489192
0.801262892639475,0.84208300460721,1058,233,27,45,17,11,10,34,41.9202832822525,43.5635025489192
0.820630347476864,0.857090237890431,1043,248,46,70,24,22,22,48,41.9202832822525,43.5635025489192
0.807642089093702,0.855899722233206,1083,208,31,35,17,11,14,24,41.9202832822525,43.5635025489192
0.761380895283773,0.803584310766679,1064,227,40,86,19,26,21,60,41.9202832822525,43.5635025489192
0.784092725819345,0.839739632200904,1023,268,40,71,22,28,18,43,41.9202832822525,43.5635025489192
0.736341463414634,0.779641470792394,1072,219,41,103,20,30,21,73,41.9202832822525,43.5635025489192
0.757288595629182,0.808999335509243,1066,225,34,57,19,14,15,43,41.9202832822525,43.5635025489192
0.701176528991263,0.736747744201869,1052,239,32,37,10,9,22,28,41.9202832822525,43.5635025489192
0.774088633066592,0.810455054345737,1067,224,34,52,19,11,15,41,41.9202832822525,43.5635025489192
0.747195194598888,0.800708227570746,1073,218,32,32,17,6,15,26,41.9202832822525,43.5635025489192
0.762068292682927,0.798608561030556,1098,193,41,34,19,14,22,20,41.9202832822525,43.5635025489192
0.684142685851319,0.718099017711826,1081,210,40,38,14,9,26,29,41.9202832822525,43.5635025489192
0.751339088092076,0.781737067029512,1060,231,36,48,18,17,18,31,41.9202832822525,43.5635025489192
0.709827357237716,0.770067297342556,1079,212,36,76,17,22,19,54,41.9202832822525,43.5635025489192
0.763067995694698,0.817672607461459,1070,221,34,63,18,19,16,44,41.9202832822525,43.5635025489192
0.706531088719587,0.754819399230815,1073,218,39,71,15,20,24,51,41.9202832822525,43.5635025489192
0.78016711722782,0.813554389300475,1081,210,39,50,21,7,18,43,41.9202832822525,43.5635025489192
0.730542754736303,0.760970251257784,1058,233,31,64,16,14,15,50,41.9202832822525,43.5635025489192
0.789160600545951,0.822610610044226,1034,257,35,49,20,17,15,32,41.9202832822525,43.5635025489192
0.6709367575981,0.694259513665869,1055,236,39,30,13,9,26,21,41.9202832822525,43.5635025489192
0.709635210150674,0.747843967044244,1054,237,30,22,11,6,19,16,41.9202832822525,43.5635025489192
0.696863819320215,0.745005199912408,1062,229,43,53,17,12,26,41,41.9202832822525,43.5635025489192
0.707703836930456,0.767636299447767,1065,226,40,76,19,20,21,56,41.9202832822525,43.5635025489192
0.72695102685624,0.77981865746397,1066,225,25,33,11,12,14,21,41.9202832822525,43.5635025489192
0.740696788560713,0.779513946705693,1065,226,27,51,11,11,16,40,41.9202832822525,43.5635025489192
0.746045088150351,0.796065267998298,1060,231,37,50,20,14,17,36,41.9202832822525,43.5635025489192
0.738974807366523,0.771704401386805,1072,219,29,66,11,12,18,54,41.9202832822525,43.5635025489192
0.719966449349956,0.763855249141525,1057,234,42,38,20,11,22,27,41.9202832822525,43.5635025489192
0.705016612850391,0.749484453179992,1083,208,34,36,15,12,19,24,41.9202832822525,43.5635025489192
0.694302096022178,0.720167877599821,1063,228,38,39,15,11,23,28,41.9202832822525,43.5635025489192
0.688400729705077,0.738623427874208,1086,205,26,56,9,13,17,43,41.9202832822525,43.5635025489192
0.760478714683862,0.811978761126241,1079,212,29,43,17,14,12,29,41.9202832822525,43.5635025489192
0.835720313741064,0.887848297595021,1065,226,32,64,24,21,8,43,41.9202832822525,43.5635025489192
0.662120303756994,0.762594507951811,1072,219,40,207,17,41,23,166,41.9202832822525,43.5635025489192
0.748889770023791,0.788763853656056,1067,224,30,57,14,16,16,41,41.9202832822525,43.5635025489192
0.640514103730664,0.687790125962974,1050,241,35,83,12,16,23,67,41.9202832822525,43.5635025489192
0.742253658536585,0.801314324534398,1047,244,41,73,23,22,18,51,41.9202832822525,43.5635025489192
0.773778792692613,0.816672181218145,1081,210,32,42,16,14,16,28,41.9202832822525,43.5635025489192
0.683769479564834,0.732970775762607,1089,202,38,66,16,16,22,50,41.9202832822525,43.5635025489192
0.72697825655282,0.758645662815538,1063,228,32,74,12,15,20,59,41.9202832822525,43.5635025489192
0.733258659729248,0.785804012740685,1063,228,33,47,18,16,15,31,41.9202832822525,43.5635025489192
0.702434030937216,0.751399836277424,1051,240,35,54,14,16,21,38,41.9202832822525,43.5635025489192
0.810669041963579,0.843975409593475,1091,200,28,68,16,18,12,50,41.9202832822525,43.5635025489192
0.73814604077762,0.795315258104673,1081,210,37,45,17,12,20,33,41.9202832822525,43.5635025489192
0.761578707916288,0.808445628677209,1048,243,35,69,20,23,15,46,41.9202832822525,43.5635025489192
0.726561699948797,0.781647906092103,1063,228,31,24,15,7,16,17,41.9202832822525,43.5635025489192
0.724636032757052,0.767939066678321,1047,244,35,52,18,17,17,35,41.9202832822525,43.5635025489192
0.771544876886418,0.80669759278171,1069,222,32,56,18,18,14,38,41.9202832822525,43.5635025489192
0.730885966180084,0.75705258154917,1056,235,33,27,13,8,20,19,41.9202832822525,43.5635025489192
0.776516451256243,0.823089617592595,1054,237,42,44,25,14,17,30,41.9202832822525,43.5635025489192
0.678121901806112,0.720981677927564,1074,217,37,60,13,14,24,46,41.9202832822525,43.5635025489192
0.770403662788255,0.832089027752405,1072,219,38,75,22,25,16,50,41.9202832822525,43.5635025489192
0.771682653876898,0.825056078157078,1091,200,40,65,21,19,19,46,41.9202832822525,43.5635025489192
0.753077537969624,0.802662338025319,1047,244,40,51,24,22,16,29,41.9202832822525,43.5635025489192
0.741611680471711,0.768103974762836,1072,219,34,76,11,17,23,59,41.9202832822525,43.5635025489192
0.773869390605902,0.81129932437385,1053,238,46,43,20,10,26,33,41.9202832822525,43.5635025489192
0.746771023445178,0.776850969291101,1061,230,34,27,18,5,16,22,41.9202832822525,43.5635025489192
0.738271942017474,0.79367358518316,1067,224,32,86,17,23,15,63,41.9202832822525,43.5635025489192
0.761476905798119,0.832917007956586,1073,218,34,51,20,17,14,34,41.9202832822525,43.5635025489192
0.747482926829268,0.772927938928063,1072,219,41,31,18,11,23,20,41.9202832822525,43.5635025489192
0.76608214849921,0.810453603939372,1089,202,25,50,10,10,15,40,41.9202832822525,43.5635025489192
0.731895633652822,0.790764139810561,1067,224,39,23,19,8,20,15,41.9202832822525,43.5635025489192
0.722975432211101,0.76402884088301,1096,195,35,52,14,13,21,39,41.9202832822525,43.5635025489192
0.668821041501454,0.727465004034051,1056,235,30,33,15,6,15,27,41.9202832822525,43.5635025489192
0.743976033449718,0.778340999429214,1061,230,37,52,16,16,21,36,41.9202832822525,43.5635025489192
0.72667896541443,0.791623423323159,1065,226,43,133,23,39,20,94,41.9202832822525,43.5635025489192
0.751421120487576,0.83804138130833,1093,198,27,105,15,22,12,83,41.9202832822525,43.5635025489192
0.68453237410072,0.729627762027057,1058,233,40,26,16,6,24,20,41.9202832822525,43.5635025489192
0.706903633491311,0.758062158047466,1066,225,25,29,9,6,16,23,41.9202832822525,43.5635025489192
0.757551669316375,0.806922581053127,1073,218,33,44,16,12,17,32,41.9202832822525,43.5635025489192
0.774347056219566,0.818493740443892,1063,228,36,47,20,19,16,28,41.9202832822525,43.5635025489192
0.793117088607595,0.836040839968426,1082,209,27,55,12,17,15,38,41.9202832822525,43.5635025489192
0.741605241605242,0.794473278130994,1073,218,37,45,15,8,22,37,41.9202832822525,43.5635025489192
0.722501810972588,0.768862247556293,1078,213,42,39,19,8,23,31,41.9202832822525,43.5635025489192
0.801546860782529,0.834425055711724,1065,226,35,27,22,8,13,19,41.9202832822525,43.5635025489192
0.754494781135581,0.810180398212697,1071,220,29,30,16,8,13,22,41.9202832822525,43.5635025489192
0.753575887283752,0.784660846110426,1048,243,45,107,21,25,24,82,41.9202832822525,43.5635025489192
0.733806648777579,0.762650862596289,1051,240,43,26,17,8,26,18,41.9202832822525,43.5635025489192
0.693118536197295,0.747772415463705,1051,240,34,72,15,21,19,51,41.9202832822525,43.5635025489192
0.75218264361795,0.826342332116769,1059,232,46,80,27,33,19,47,41.9202832822525,43.5635025489192
0.777364713774597,0.795996928813731,1063,228,43,25,22,7,21,18,41.9202832822525,43.5635025489192
0.704889912954429,0.784067111042853,1051,240,31,57,18,9,13,48,41.9202832822525,43.5635025489192
0.708046612599328,0.781469977009398,1092,199,39,124,16,24,23,100,41.9202832822525,43.5635025489192
0.740896616695339,0.779142244463928,1073,218,39,44,20,13,19,31,41.9202832822525,43.5635025489192
0.810355862775218,0.850803583265994,1083,208,31,23,18,5,13,18,41.9202832822525,43.5635025489192
0.776292335115865,0.824473253399703,1074,217,33,40,13,7,20,33,41.9202832822525,43.5635025489192
0.793088995897985,0.846416069804344,1078,213,45,91,22,28,23,63,41.9202832822525,43.5635025489192
0.747970731707317,0.812313878690096,1038,253,41,60,23,20,18,40,41.9202832822525,43.5635025489192
0.688284696301323,0.722610105914005,1060,231,28,33,10,8,18,25,41.9202832822525,43.5635025489192
0.715927099841521,0.739767789358042,1078,213,29,39,9,15,20,24,41.9202832822525,43.5635025489192
0.752241475925687,0.808597411323953,1061,230,37,77,19,25,18,52,41.9202832822525,43.5635025489192
0.779623041663816,0.807781370047765,1042,249,47,81,25,27,22,54,41.9202832822525,43.5635025489192
0.715304322258159,0.745321520365053,1056,235,38,38,13,10,25,28,41.9202832822525,43.5635025489192
0.803254070691025,0.843106038636902,1054,237,32,39,18,15,14,24,41.9202832822525,43.5635025489192
0.772211853862685,0.797541092937601,1050,241,28,59,11,13,17,46,41.9202832822525,43.5635025489192
0.71164695177434,0.753626099936595,1070,221,35,32,15,11,20,21,41.9202832822525,43.5635025489192
0.758736452550886,0.815531117922697,1075,216,30,42,16,10,14,32,41.9202832822525,43.5635025489192
0.725127379994637,0.750875009099496,1071,220,48,31,21,9,27,22,41.9202832822525,43.5635025489192
0.708148373365765,0.735069815937411,1072,219,26,14,12,5,14,9,41.9202832822525,43.5635025489192
0.693802736135005,0.728881860947566,1080,211,39,59,14,13,25,46,41.9202832822525,43.5635025489192
0.75012931591879,0.786406834595154,1070,221,37,45,16,17,21,28,41.9202832822525,43.5635025489192
0.777597644603458,0.818861919452537,1060,231,43,56,23,14,20,42,41.9202832822525,43.5635025489192
0.70493581230633,0.762257018463725,1067,224,36,66,13,16,23,50,41.9202832822525,43.5635025489192
0.727639122375965,0.77464221726145,1073,218,37,70,18,18,19,52,41.9202832822525,43.5635025489192
0.696997624313918,0.743338149209519,1048,243,39,71,19,18,20,53,41.9202832822525,43.5635025489192
0.728619050221324,0.757992012115985,1052,239,29,56,14,14,15,42,41.9202832822525,43.5635025489192
0.738914490527394,0.782761499096456,1088,203,31,36,16,6,15,30,41.9202832822525,43.5635025489192
0.764095435148067,0.817235227931886,1055,236,37,72,19,26,18,46,41.9202832822525,43.5635025489192
0.710934848998982,0.740683414879102,1080,211,28,41,12,7,16,34,41.9202832822525,43.5635025489192
0.733282130056324,0.776915158511984,1063,228,31,52,12,18,19,34,41.9202832822525,43.5635025489192
0.7600028078057,0.79393275358272,1077,214,34,51,14,8,20,43,41.9202832822525,43.5635025489192
0.759318001586043,0.803243530884947,1049,242,30,100,14,20,16,80,41.9202832822525,43.5635025489192
0.745083267248216,0.783781139082827,1069,222,30,47,15,14,15,33,41.9202832822525,43.5635025489192
0.775131707317073,0.813527232856119,1067,224,41,42,20,14,21,28,41.9202832822525,43.5635025489192
0.731070570742308,0.775106475999521,1080,211,42,37,20,11,22,26,41.9202832822525,43.5635025489192
0.664399092970522,0.722948907537417,1074,217,49,64,21,19,28,45,41.9202832822525,43.5635025489192
0.762685624012638,0.791121123012088,1056,235,25,60,9,14,16,46,41.9202832822525,43.5635025489192
0.725632966649206,0.774828386373067,1058,233,46,77,22,24,24,53,41.9202832822525,43.5635025489192
0.727957810202466,0.766691335333625,1074,217,28,43,13,10,15,33,41.9202832822525,43.5635025489192
0.750008380262805,0.782199406106481,1056,235,48,42,25,15,23,27,41.9202832822525,43.5635025489192
0.775141560204034,0.804511569653506,1053,238,34,28,17,8,17,20,41.9202832822525,43.5635025489192
0.741263073885832,0.792323847707799,1073,218,38,57,18,14,20,43,41.9202832822525,43.5635025489192
0.695107398568019,0.758309854022225,1097,194,34,65,14,13,20,52,41.9202832822525,43.5635025489192
0.768751219512195,0.809742762666439,1073,218,41,109,24,31,17,78,41.9202832822525,43.5635025489192
0.705061419472247,0.774246891809719,1076,215,35,112,17,36,18,76,41.9202832822525,43.5635025489192
0.771853658536585,0.808906906531178,1091,200,41,49,19,15,22,34,41.9202832822525,43.5635025489192
0.792379364992623,0.836946329988434,1059,232,29,91,18,21,11,70,41.9202832822525,43.5635025489192
0.733886675520142,0.80334082225182,1059,232,36,64,17,14,19,50,41.9202832822525,43.5635025489192
0.679609034872193,0.692658157309584,1077,214,37,33,9,4,28,29,41.9202832822525,43.5635025489192
0.722543249509542,0.774731502505123,1061,230,45,96,20,25,25,71,41.9202832822525,43.5635025489192
0.714134118066702,0.745786429395326,1070,221,45,44,18,11,27,33,41.9202832822525,43.5635025489192
0.791528159175218,0.829091063293571,1074,217,33,58,16,14,17,44,41.9202832822525,43.5635025489192
0.748799890275683,0.806111076415248,1060,231,23,103,14,26,9,77,41.9202832822525,43.5635025489192
0.781540504648074,0.827675700633672,1082,209,36,57,22,18,14,39,41.9202832822525,43.5635025489192
0.698937583001328,0.761809575727155,1095,196,36,64,13,9,23,55,41.9202832822525,43.5635025489192
0.739464364763169,0.808959924269834,1116,175,36,55,21,15,15,40,41.9202832822525,43.5635025489192
0.726865332120109,0.805597415463712,1067,224,35,66,18,18,17,48,41.9202832822525,43.5635025489192
0.738368195226602,0.78137222272361,1068,223,48,33,23,13,25,20,41.9202832822525,43.5635025489192
0.726983668160139,0.760578817671464,1069,222,33,47,15,12,18,35,41.9202832822525,43.5635025489192
0.725653984744256,0.78976765994069,1089,202,34,31,20,10,14,21,41.9202832822525,43.5635025489192
0.753265846179695,0.781272916082476,1073,218,38,38,17,14,21,24,41.9202832822525,43.5635025489192
0.791818662437219,0.851859496529496,1065,226,30,81,18,22,12,59,41.9202832822525,43.5635025489192
0.792544937281779,0.845485346794172,1070,221,37,35,22,13,15,22,41.9202832822525,43.5635025489192
0.782583763414434,0.809227385219497,1086,205,39,30,21,7,18,23,41.9202832822525,43.5635025489192
0.785863614810983,0.825712651016395,1067,224,37,57,20,20,17,37,41.9202832822525,43.5635025489192
0.713591724303123,0.759910596697419,1060,231,54,81,22,24,32,57,41.9202832822525,43.5635025489192
0.73411249941504,0.782463200808895,1063,228,34,72,15,20,19,52,41.9202832822525,43.5635025489192
0.762952683055776,0.81400730280828,1090,201,30,62,17,17,13,45,41.9202832822525,43.5635025489192
0.783476910454759,0.821535952399347,1065,226,27,25,13,7,14,18,41.9202832822525,43.5635025489192
0.718042593328038,0.746376188300299,1058,233,32,32,15,9,17,23,41.9202832822525,43.5635025489192
0.776731707317073,0.815910678138433,1051,240,41,36,20,13,21,23,41.9202832822525,43.5635025489192
0.797297297297297,0.862703866067871,1053,238,33,141,18,35,15,106,41.9202832822525,43.5635025489192
0.726173085436034,0.76090588697963,1058,233,36,58,20,20,16,38,41.9202832822525,43.5635025489192
0.848883572567783,0.878627694446252,1059,232,37,42,29,18,8,24,41.9202832822525,43.5635025489192
0.694334532374101,0.73132952143044,1074,217,40,52,15,10,25,42,41.9202832822525,43.5635025489192
0.694760264577682,0.730458415453908,1063,228,53,35,25,13,28,22,41.9202832822525,43.5635025489192
0.743977935154406,0.774924541452706,1069,222,33,16,13,5,20,11,41.9202832822525,43.5635025489192
0.721331961187886,0.777253460175994,1044,247,38,49,20,12,18,37,41.9202832822525,43.5635025489192
0.748758320532514,0.821588628635599,1077,214,31,49,17,12,14,37,41.9202832822525,43.5635025489192
0.744802092811647,0.778573867698138,1056,235,35,54,16,8,19,46,41.9202832822525,43.5635025489192
0.811749933914882,0.842327255403184,1091,200,30,41,17,11,13,30,41.9202832822525,43.5635025489192
0.72347585114806,0.765788944982092,1051,240,28,48,13,12,15,36,41.9202832822525,43.5635025489192
0.779016786570743,0.835461499455778,1078,213,40,72,17,23,23,49,41.9202832822525,43.5635025489192
0.750256000655362,0.817570119299596,1046,245,39,77,20,24,19,53,41.9202832822525,43.5635025489192
0.721660162836634,0.778342608279432,1069,222,33,58,15,20,18,38,41.9202832822525,43.5635025489192
0.722595121951219,0.75517860191116,1070,221,41,44,13,7,28,37,41.9202832822525,43.5635025489192
0.74111605830218,0.801194542670784,1061,230,38,54,22,21,16,33,41.9202832822525,43.5635025489192
0.768104366347178,0.811799675286912,1066,225,39,68,23,17,16,51,41.9202832822525,43.5635025489192
0.724298461140566,0.769840983062411,1059,232,37,42,18,13,19,29,41.9202832822525,43.5635025489192
0.764588890448781,0.817563734787284,1096,195,34,67,19,20,15,47,41.9202832822525,43.5635025489192
0.678711951472758,0.707247480558129,1065,226,29,51,9,10,20,41,41.9202832822525,43.5635025489192
0.703039449670083,0.740411535426919,1061,230,34,39,10,10,24,29,41.9202832822525,43.5635025489192
0.710012167158033,0.756003936557706,1087,204,34,21,17,7,17,14,41.9202832822525,43.5635025489192
0.758499743983615,0.802370014495312,1083,208,31,50,15,16,16,34,41.9202832822525,43.5635025489192
0.770689262966333,0.801711311549165,1042,249,35,46,20,17,15,29,41.9202832822525,43.5635025489192
0.778016969798799,0.819199860439551,1076,215,38,26,20,9,18,17,41.9202832822525,43.5635025489192
0.751910828025478,0.813687761790609,1058,233,35,11,22,5,13,6,41.9202832822525,43.5635025489192
0.74609872611465,0.804088040233258,1080,211,35,57,18,20,17,37,41.9202832822525,43.5635025489192
0.803299336446301,0.840872374795701,1054,237,39,20,26,9,13,11,41.9202832822525,43.5635025489192
0.697338489535942,0.756766380812198,1062,229,35,69,16,18,19,51,41.9202832822525,43.5635025489192
0.71088467614534,0.755773329081016,1073,218,25,74,9,15,16,59,41.9202832822525,43.5635025489192
0.738186247742261,0.775465685371879,1069,222,38,58,17,13,21,45,41.9202832822525,43.5635025489192
0.744321680235342,0.780327102588996,1071,220,47,29,22,9,25,20,41.9202832822525,43.5635025489192
0.80218721395192,0.862571650165617,1056,235,33,103,24,26,9,77,41.9202832822525,43.5635025489192
0.716243902439024,0.776645883172352,1053,238,41,32,20,12,21,20,41.9202832822525,43.5635025489192
0.832488479262673,0.873158787228068,1051,240,31,24,20,12,11,12,41.9202832822525,43.5635025489192
0.704464141821112,0.755076587579595,1074,217,50,50,19,14,31,36,41.9202832822525,43.5635025489192
0.758513297986982,0.816009873951938,1074,217,37,43,21,12,16,31,41.9202832822525,43.5635025489192
0.780108220810167,0.819811813214449,1073,218,32,27,16,7,16,20,41.9202832822525,43.5635025489192
0.739698533628246,0.79060083292492,1085,206,39,82,17,11,22,71,41.9202832822525,43.5635025489192
0.746723996723997,0.827566062800086,1080,211,33,46,19,19,14,27,41.9202832822525,43.5635025489192
0.748431254996003,0.783569898803423,1053,238,40,53,20,17,20,36,41.9202832822525,43.5635025489192
0.705214818362181,0.741753389381194,1062,229,47,44,21,16,26,28,41.9202832822525,43.5635025489192
0.804971157108924,0.833892652122723,1091,200,28,74,15,16,13,58,41.9202832822525,43.5635025489192
0.76629380576749,0.820195130382232,1069,222,37,56,19,20,18,36,41.9202832822525,43.5635025489192
0.622349863512284,0.662981075379539,1079,212,35,57,14,11,21,46,41.9202832822525,43.5635025489192
0.752246893999471,0.808934556715224,1064,227,30,90,14,25,16,65,41.9202832822525,43.5635025489192
0.705261325468993,0.778367830204579,1066,225,39,68,20,20,19,48,41.9202832822525,43.5635025489192
0.753226767275616,0.791412177804749,1079,212,32,47,15,13,17,34,41.9202832822525,43.5635025489192
0.719383572872835,0.764837356990357,1063,228,29,81,9,16,20,65,41.9202832822525,43.5635025489192
0.67579755515802,0.721940361077917,1051,240,43,87,17,26,26,61,41.9202832822525,43.5635025489192
0.742857831093125,0.76991370339118,1077,214,33,54,15,11,18,43,41.9202832822525,43.5635025489192
0.731176069153776,0.772339274088765,1070,221,35,40,16,13,19,27,41.9202832822525,43.5635025489192
0.704818837938325,0.731674163094402,1053,238,44,28,19,10,25,18,41.9202832822525,43.5635025489192
0.738432666060054,0.776310315077449,1074,217,35,20,19,3,16,17,41.9202832822525,43.5635025489192
0.749385749385749,0.799851050876757,1061,230,37,65,17,13,20,52,41.9202832822525,43.5635025489192
0.780086235968589,0.80260563549819,1035,256,33,62,19,24,14,38,41.9202832822525,43.5635025489192
0.761148382004736,0.805466265553479,1056,235,24,39,12,11,12,28,41.9202832822525,43.5635025489192
0.799436763952893,0.855811509534161,1090,201,31,64,17,18,14,46,41.9202832822525,43.5635025489192
0.776030698675652,0.822175741631973,1077,214,34,74,19,24,15,50,41.9202832822525,43.5635025489192
0.782167334798914,0.82815940517731,1067,224,37,105,20,30,17,75,41.9202832822525,43.5635025489192
0.721367570246674,0.76296198645515,1055,236,42,40,18,11,24,29,41.9202832822525,43.5635025489192
0.697003745318352,0.738155917258042,1100,191,45,52,17,9,28,43,41.9202832822525,43.5635025489192
0.806931333247123,0.839344219745298,1045,246,37,54,24,20,13,34,41.9202832822525,43.5635025489192
0.776685170499604,0.815394849622676,1075,216,30,71,16,20,14,51,41.9202832822525,43.5635025489192
0.765659583886675,0.772732146125698,1063,228,36,14,17,3,19,11,41.9202832822525,43.5635025489192
0.744266282764099,0.783005932064473,1078,213,32,34,16,15,16,19,41.9202832822525,43.5635025489192
0.738437313655337,0.775132800975186,1087,204,43,21,20,6,23,15,41.9202832822525,43.5635025489192
0.737307317073171,0.782464399689007,1068,223,41,32,21,14,20,18,41.9202832822525,43.5635025489192
0.77936033643205,0.809085799050057,1061,230,36,47,18,16,18,31,41.9202832822525,43.5635025489192
0.742117445505577,0.769476535672374,1061,230,44,50,20,16,24,34,41.9202832822525,43.5635025489192
0.742434715821813,0.7713056133686,1050,241,31,23,14,9,17,14,41.9202832822525,43.5635025489192
0.720893525949706,0.758747022635888,1054,237,45,58,21,17,24,41,41.9202832822525,43.5635025489192
0.70279991146525,0.749543956346463,1074,217,36,45,16,11,20,34,41.9202832822525,43.5635025489192
0.782393084622384,0.808323421259639,1064,227,35,46,18,14,17,32,41.9202832822525,43.5635025489192
0.660599078341014,0.692773176251484,1044,247,31,21,11,4,20,17,41.9202832822525,43.5635025489192
0.721774193548387,0.761709019978402,1077,214,31,103,11,23,20,80,41.9202832822525,43.5635025489192
0.72728672094137,0.753213470655981,1051,240,47,79,19,20,28,59,41.9202832822525,43.5635025489192
0.710725659690628,0.751141843121774,1076,215,35,26,16,9,19,17,41.9202832822525,43.5635025489192
0.749333146146287,0.790026111353014,1090,201,34,92,16,24,18,68,41.9202832822525,43.5635025489192
0.764958033573142,0.835399521164813,1045,246,40,127,23,47,17,80,41.9202832822525,43.5635025489192
0.764958033573142,0.795884887035825,1034,257,40,22,20,8,20,14,41.9202832822525,43.5635025489192
0.71322726370135,0.779722324795352,1069,222,32,55,17,18,15,37,41.9202832822525,43.5635025489192
0.762842861343302,0.799100422844539,1066,225,38,56,18,16,20,40,41.9202832822525,43.5635025489192
0.729621331326538,0.764558628958834,1050,241,47,69,21,20,26,49,41.9202832822525,43.5635025489192
0.707664884135472,0.758373693381163,1071,220,33,59,14,17,19,42,41.9202832822525,43.5635025489192
0.781681205392546,0.813643125667895,1054,237,30,41,17,17,13,24,41.9202832822525,43.5635025489192
0.710343118237855,0.738961193383927,1074,217,37,55,14,15,23,40,41.9202832822525,43.5635025489192
0.743893626246568,0.805993632771802,1079,212,33,158,15,27,18,131,41.9202832822525,43.5635025489192
0.763458385756224,0.803127146202428,1081,210,42,66,20,20,22,46,41.9202832822525,43.5635025489192
0.707604663487017,0.749564623283532,1076,215,33,43,10,7,23,36,41.9202832822525,43.5635025489192
0.731778889899909,0.779845016142643,1059,232,35,82,16,17,19,65,41.9202832822525,43.5635025489192
0.747081413210445,0.78624627840233,1069,222,31,34,17,11,14,23,41.9202832822525,43.5635025489192
0.716057154276579,0.786961439860922,1076,215,40,109,18,33,22,76,41.9202832822525,43.5635025489192
0.77239003709592,0.814148989368332,1054,237,33,42,15,10,18,32,41.9202832822525,43.5635025489192
0.740026777419531,0.791629710106431,1055,236,29,27,13,4,16,23,41.9202832822525,43.5635025489192
0.722646942017474,0.787159340370826,1065,226,32,46,15,12,17,34,41.9202832822525,43.5635025489192
0.769720512311358,0.79475607191884,1088,203,32,46,16,13,16,33,41.9202832822525,43.5635025489192
0.766564616542382,0.804666098993619,1040,251,47,54,27,17,20,37,41.9202832822525,43.5635025489192
0.764551942902458,0.800099117966409,1065,226,30,26,14,10,16,16,41.9202832822525,43.5635025489192
0.762908607623572,0.807953824816179,1046,245,28,27,16,8,12,19,41.9202832822525,43.5635025489192
0.72868520813589,0.775533204167789,1059,232,44,54,22,21,22,33,41.9202832822525,43.5635025489192
0.784972022382094,0.818673211630274,1066,225,40,45,21,14,19,31,41.9202832822525,43.5635025489192
0.757203277821835,0.801798286476928,1091,200,30,26,14,7,16,19,41.9202832822525,43.5635025489192
0.75388689048761,0.795506132799657,1055,236,40,43,20,13,20,30,41.9202832822525,43.5635025489192
0.751882926829268,0.772943018454625,1046,245,41,73,16,25,25,48,41.9202832822525,43.5635025489192
0.774345592655337,0.825153433217252,1064,227,29,44,18,19,11,25,41.9202832822525,43.5635025489192
0.756989247311828,0.800312494663494,1055,236,51,39,29,14,22,25,41.9202832822525,43.5635025489192
0.721496616233458,0.76922538820796,1056,235,37,18,17,6,20,12,41.9202832822525,43.5635025489192
0.714691943127962,0.735705866326054,1099,192,25,69,7,13,18,56,41.9202832822525,43.5635025489192
0.785342320909331,0.828708493112912,1065,226,30,67,16,23,14,44,41.9202832822525,43.5635025489192
0.665736585365854,0.702555416304015,1072,219,41,58,12,11,29,47,41.9202832822525,43.5635025489192
0.768858536585366,0.786493633130552,1053,238,41,22,23,7,18,15,41.9202832822525,43.5635025489192
0.65510243902439,0.688562949776394,1072,219,41,60,14,18,27,42,41.9202832822525,43.5635025489192
0.78102035421623,0.826917192194474,1070,221,30,47,16,14,14,33,41.9202832822525,43.5635025489192
0.751849185861795,0.781607084685832,1056,235,32,39,15,6,17,33,41.9202832822525,43.5635025489192
0.690556861030657,0.732850506535652,1061,230,29,33,12,7,17,26,41.9202832822525,43.5635025489192
0.75049642573471,0.802345864080342,1063,228,32,68,19,18,13,50,41.9202832822525,43.5635025489192
0.740869111508646,0.798535009837038,1081,210,43,76,22,17,21,59,41.9202832822525,43.5635025489192
0.737807097361238,0.795074623019198,1037,254,35,47,17,18,18,29,41.9202832822525,43.5635025489192
0.743573703366697,0.778110047644153,1051,240,35,78,16,21,19,57,41.9202832822525,43.5635025489192
0.753519256308101,0.79010186059481,1073,218,36,32,18,13,18,19,41.9202832822525,43.5635025489192
0.735215053763441,0.779376818706278,1065,226,31,69,11,14,20,55,41.9202832822525,43.5635025489192
0.702,0.775077868139715,1083,208,41,119,15,23,26,96,41.9202832822525,43.5635025489192
0.754080948121646,0.791084381690701,1078,213,43,108,18,23,25,85,41.9202832822525,43.5635025489192
0.781068239534693,0.825123805747383,1066,225,39,79,16,22,23,57,41.9202832822525,43.5635025489192
0.796972105795635,0.820972891662621,1052,239,33,22,19,8,14,14,41.9202832822525,43.5635025489192
0.802684934873433,0.832091716183749,1061,230,39,73,20,18,19,55,41.9202832822525,43.5635025489192
0.727467688436463,0.777627076495191,1059,232,42,39,21,18,21,21,41.9202832822525,43.5635025489192
0.724585365853659,0.795542664991041,1079,212,41,59,20,11,21,48,41.9202832822525,43.5635025489192
0.687840451248993,0.740484201723221,1078,213,50,50,19,16,31,34,41.9202832822525,43.5635025489192
0.718236698020497,0.745659444465797,1082,209,34,34,13,5,21,29,41.9202832822525,43.5635025489192
0.732960333892011,0.765147688390814,1072,219,49,75,23,12,26,63,41.9202832822525,43.5635025489192
0.705990750108397,0.757550422124786,1065,226,33,45,16,15,17,30,41.9202832822525,43.5635025489192
0.727420562497075,0.771497785370321,1042,249,34,72,15,19,19,53,41.9202832822525,43.5635025489192
0.811116478346705,0.858333267845803,1049,242,38,151,24,47,14,104,41.9202832822525,43.5635025489192
0.721270473660912,0.743295138764582,1084,207,36,64,10,9,26,55,41.9202832822525,43.5635025489192
0.767969841499253,0.796121647862973,1063,228,33,42,18,19,15,23,41.9202832822525,43.5635025489192
0.737294710978922,0.791466370966997,1057,234,37,52,17,12,20,40,41.9202832822525,43.5635025489192
0.771686746987952,0.808415852563763,1087,204,46,54,23,20,23,34,41.9202832822525,43.5635025489192
0.732324840764331,0.757371823235042,1055,236,35,45,16,11,19,34,41.9202832822525,43.5635025489192
0.654418659165495,0.687200314911418,1064,227,27,29,11,12,16,17,41.9202832822525,43.5635025489192
0.764700256844636,0.802842183436458,1069,222,29,20,14,7,15,13,41.9202832822525,43.5635025489192
0.775996015936255,0.825922467370566,1060,231,36,51,23,17,13,34,41.9202832822525,43.5635025489192
0.784315286624204,0.830444481448014,1052,239,35,54,22,18,13,36,41.9202832822525,43.5635025489192
0.762742689213277,0.793580923416574,1084,207,33,61,14,16,19,45,41.9202832822525,43.5635025489192
0.758948788360553,0.791388818191783,1063,228,33,44,16,8,17,36,41.9202832822525,43.5635025489192
0.728577729239299,0.784526283236013,1068,223,38,58,21,15,17,43,41.9202832822525,43.5635025489192
0.749368243717535,0.794831488497936,1046,245,34,41,21,16,13,25,41.9202832822525,43.5635025489192
0.786584741423451,0.793417719736637,1079,212,31,53,13,13,18,40,41.9202832822525,43.5635025489192
0.776261620185923,0.805572863051994,1061,230,36,32,19,9,17,23,41.9202832822525,43.5635025489192
0.735171774645459,0.77097824824498,1082,209,37,26,18,5,19,21,41.9202832822525,43.5635025489192
0.732334132693845,0.785243204997442,1049,242,40,58,19,12,21,46,41.9202832822525,43.5635025489192
0.744893084622384,0.783975822746365,1060,231,35,41,19,16,16,25,41.9202832822525,43.5635025489192
0.768812930577637,0.814259510288928,1082,209,33,37,18,13,15,24,41.9202832822525,43.5635025489192
0.773118636564852,0.825753226323651,1042,249,36,50,19,19,17,31,41.9202832822525,43.5635025489192
0.700903056166214,0.776277992918438,1071,220,37,101,17,29,20,72,41.9202832822525,43.5635025489192
0.78012541532126,0.820243621824127,1040,251,34,60,20,22,14,38,41.9202832822525,43.5635025489192
0.787318804606831,0.828276760152601,1035,256,32,24,21,10,11,14,41.9202832822525,43.5635025489192
0.68542471331477,0.738010817000779,1072,219,54,96,25,27,29,69,41.9202832822525,43.5635025489192
0.789664416203336,0.809496717268738,1072,219,32,40,16,13,16,27,41.9202832822525,43.5635025489192
0.753859857482185,0.783659753179349,1070,221,28,56,10,9,18,47,41.9202832822525,43.5635025489192
0.775497557775023,0.810193281344876,1052,239,44,53,25,16,19,37,41.9202832822525,43.5635025489192
0.747165826113194,0.78395674528686,1074,217,37,38,18,11,19,27,41.9202832822525,43.5635025489192
0.699509913536076,0.75842149739156,1069,222,43,58,20,18,23,40,41.9202832822525,43.5635025489192
0.738975609756097,0.785657281199861,1065,226,41,19,23,5,18,14,41.9202832822525,43.5635025489192
0.742616948499301,0.792361621524423,1079,212,33,105,12,18,21,87,41.9202832822525,43.5635025489192
0.74241214057508,0.796344873958552,1078,213,39,94,20,30,19,64,41.9202832822525,43.5635025489192
0.762595823420566,0.827629831385864,1063,228,30,96,16,18,14,78,41.9202832822525,43.5635025489192
0.713873170731707,0.774553836061806,1052,239,41,68,20,21,21,47,41.9202832822525,43.5635025489192
0.715873015873016,0.757949087542309,1063,228,31,29,15,10,16,19,41.9202832822525,43.5635025489192
0.722873066424022,0.75629425526155,1078,213,35,41,15,8,20,33,41.9202832822525,43.5635025489192
0.741890354868062,0.781956711823458,1059,232,35,67,17,16,18,51,41.9202832822525,43.5635025489192
0.715278879196405,0.785818401330744,1077,214,30,76,12,14,18,62,41.9202832822525,43.5635025489192
0.714327718738186,0.762290999913308,1065,226,38,40,19,12,19,28,41.9202832822525,43.5635025489192
0.689093543915655,0.721243597574455,1058,233,38,48,13,12,25,36,41.9202832822525,43.5635025489192
0.76198327514117,0.835746765637695,1077,214,37,85,20,23,17,62,41.9202832822525,43.5635025489192
0.733665338645418,0.758384944873502,1066,225,36,22,15,5,21,17,41.9202832822525,43.5635025489192
0.758975609756098,0.801265075571891,1071,220,41,59,22,19,19,40,41.9202832822525,43.5635025489192
0.731766365473331,0.776635697982009,1075,216,42,46,19,16,23,30,41.9202832822525,43.5635025489192
0.754703074547241,0.809111296492382,1090,201,34,64,17,23,17,41,41.9202832822525,43.5635025489192
0.74587306254463,0.793216729943638,1068,223,38,66,19,17,19,49,41.9202832822525,43.5635025489192
0.750829777145567,0.77560095207636,1058,233,37,26,21,11,16,15,41.9202832822525,43.5635025489192
0.781318732743694,0.81717312386175,1080,211,34,27,18,5,16,22,41.9202832822525,43.5635025489192
0.753454866215819,0.790233010357778,1056,235,38,47,18,19,20,28,41.9202832822525,43.5635025489192
0.730199809392356,0.776864564024312,1061,230,49,73,23,22,26,51,41.9202832822525,43.5635025489192
0.749543731573775,0.800963524632206,1063,228,34,42,19,14,15,28,41.9202832822525,43.5635025489192
0.738372343635502,0.779556757233373,1061,230,37,56,17,14,20,42,41.9202832822525,43.5635025489192
0.744842850818946,0.791584695999369,1052,239,36,46,18,11,18,35,41.9202832822525,43.5635025489192
0.793636564851704,0.846665438979475,1073,218,36,38,16,11,20,27,41.9202832822525,43.5635025489192
0.721032722122838,0.767866018758459,1066,225,43,71,21,17,22,54,41.9202832822525,43.5635025489192
0.713029576338929,0.7588310834531,1086,205,40,32,19,9,21,23,41.9202832822525,43.5635025489192
0.75345723421263,0.779315929980925,1076,215,40,34,20,11,20,23,41.9202832822525,43.5635025489192
0.768425841674249,0.804284586753804,1058,233,35,46,19,19,16,27,41.9202832822525,43.5635025489192
0.752941780119039,0.802120851087222,1026,265,47,80,25,29,22,51,41.9202832822525,43.5635025489192
0.718470562195662,0.766544519777225,1040,251,36,37,16,11,20,26,41.9202832822525,43.5635025489192
0.755046480743692,0.786307332880461,1063,228,36,49,20,16,16,33,41.9202832822525,43.5635025489192
0.676850295271348,0.707364195679779,1046,245,37,65,13,15,24,50,41.9202832822525,43.5635025489192
0.787373461586928,0.821960453982039,1075,216,38,78,16,22,22,56,41.9202832822525,43.5635025489192
0.744751928962455,0.794714518647155,1065,226,37,61,20,19,17,42,41.9202832822525,43.5635025489192
0.741259674406192,0.789870477823323,1075,216,42,37,22,12,20,25,41.9202832822525,43.5635025489192
0.791111857856933,0.826890515335338,1047,244,38,33,22,13,16,20,41.9202832822525,43.5635025489192
0.753726829268293,0.803693632868131,1067,224,41,48,21,16,20,32,41.9202832822525,43.5635025489192
0.778760243193233,0.812819559853119,1074,217,30,41,19,13,11,28,41.9202832822525,43.5635025489192
0.707883693045564,0.754131325779837,1071,220,40,54,15,12,25,42,41.9202832822525,43.5635025489192
0.65457638509682,0.689595210143651,1066,225,38,45,11,8,27,37,41.9202832822525,43.5635025489192
0.797577481788008,0.823870558164963,1076,215,37,42,18,12,19,30,41.9202832822525,43.5635025489192
0.739051252209147,0.777940345799913,1070,221,37,56,17,13,20,43,41.9202832822525,43.5635025489192
0.745903989514213,0.783760210979044,1058,233,39,45,20,12,19,33,41.9202832822525,43.5635025489192
0.747775987107172,0.786551429824723,1067,224,50,58,28,14,22,44,41.9202832822525,43.5635025489192
0.734203789042499,0.770524447372099,1069,222,31,56,16,16,15,40,41.9202832822525,43.5635025489192
0.759967710234452,0.808249568027495,1079,212,34,41,18,12,16,29,41.9202832822525,43.5635025489192
0.780090398775242,0.833890946920985,1046,245,44,84,27,24,17,60,41.9202832822525,43.5635025489192
0.719301637852593,0.766575889113413,1066,225,35,44,16,9,19,35,41.9202832822525,43.5635025489192
0.679276870453341,0.727818334571807,1054,237,33,54,17,15,16,39,41.9202832822525,43.5635025489192
0.727340823970037,0.783754058571887,1071,220,45,54,23,15,22,39,41.9202832822525,43.5635025489192
0.701242400211472,0.739620714270774,1076,215,30,33,11,6,19,27,41.9202832822525,43.5635025489192
0.711567182155417,0.762493885754388,1069,222,33,58,14,11,19,47,41.9202832822525,43.5635025489192
0.662318016378526,0.68523177204487,1076,215,35,64,13,18,22,46,41.9202832822525,43.5635025489192
0.731540084388185,0.764947613731055,1063,228,27,28,14,5,13,23,41.9202832822525,43.5635025489192
0.725682438580528,0.755301831156009,1071,220,35,62,13,14,22,48,41.9202832822525,43.5635025489192
0.755745403677058,0.778796163297856,1071,220,40,41,17,11,23,30,41.9202832822525,43.5635025489192
0.64123044154993,0.695951837901799,1084,207,39,52,12,12,27,40,41.9202832822525,43.5635025489192
0.687784928935371,0.741117275537464,1067,224,48,52,23,15,25,37,41.9202832822525,43.5635025489192
0.669080563817406,0.715136793598963,1072,219,37,44,12,7,25,37,41.9202832822525,43.5635025489192
0.735464597824149,0.788652318773022,1057,234,45,67,22,20,23,47,41.9202832822525,43.5635025489192
0.723603299587551,0.77207674585385,1085,206,21,16,10,0,11,16,41.9202832822525,43.5635025489192
0.784785369050545,0.824884987858536,1075,216,39,114,17,27,22,87,41.9202832822525,43.5635025489192
0.800325158856235,0.840323492152481,1038,253,32,24,23,14,9,10,41.9202832822525,43.5635025489192
0.715973464519976,0.760010838968107,1078,213,43,52,16,15,27,37,41.9202832822525,43.5635025489192
0.654990659194022,0.689513710718693,1051,240,42,49,15,11,27,38,41.9202832822525,43.5635025489192
0.752897681854516,0.783067958259893,1080,211,40,25,21,14,19,11,41.9202832822525,43.5635025489192
0.781967537608868,0.812475612559955,1075,216,28,51,12,10,16,41,41.9202832822525,43.5635025489192
0.761232876712329,0.798289353750234,1083,208,50,49,27,20,23,29,41.9202832822525,43.5635025489192
0.788526695447839,0.817312893466167,1079,212,29,42,15,14,14,28,41.9202832822525,43.5635025489192
0.698848389982111,0.722649673824206,1078,213,43,42,13,8,30,34,41.9202832822525,43.5635025489192
0.768715698839923,0.807505132362297,1055,236,49,77,25,24,24,53,41.9202832822525,43.5635025489192
0.70119082622758,0.786273290581902,1066,225,38,105,21,33,17,72,41.9202832822525,43.5635025489192
0.688027956556718,0.733541692968371,1047,244,48,67,21,27,27,40,41.9202832822525,43.5635025489192
0.783404040828328,0.817293416424032,1057,234,38,47,23,15,15,32,41.9202832822525,43.5635025489192
0.713401947764498,0.745828394127323,1050,241,36,53,15,17,21,36,41.9202832822525,43.5635025489192
0.770583417642241,0.811155403676224,1062,229,33,51,16,14,17,37,41.9202832822525,43.5635025489192
0.73946138652021,0.784787223330313,1049,242,33,35,16,10,17,25,41.9202832822525,43.5635025489192
0.77390243902439,0.831154556637375,1078,213,41,94,22,21,19,73,41.9202832822525,43.5635025489192
0.742509295035357,0.789943802596288,1099,192,44,50,22,18,22,32,41.9202832822525,43.5635025489192
0.784974681334032,0.836351869723464,1080,211,46,75,24,22,22,53,41.9202832822525,43.5635025489192
0.69500968992248,0.7398222903531,1090,201,43,51,19,12,24,39,41.9202832822525,43.5635025489192
0.763863414634146,0.816622715466708,1057,234,41,42,25,17,16,25,41.9202832822525,43.5635025489192
0.784767753255148,0.848721043974968,1041,250,17,18,10,5,7,13,41.9202832822525,43.5635025489192
0.823391988633259,0.861544834740224,1053,238,29,50,20,14,9,36,41.9202832822525,43.5635025489192
0.759235668789809,0.807353294574139,1056,235,35,36,16,13,19,23,41.9202832822525,43.5635025489192
0.760200668896321,0.799131991993287,1061,230,26,49,14,17,12,32,41.9202832822525,43.5635025489192
0.723711340206186,0.764948425686935,1079,212,30,49,13,9,17,40,41.9202832822525,43.5635025489192
0.74178590355061,0.770319400032347,1056,235,33,53,14,10,19,43,41.9202832822525,43.5635025489192
0.740021121600069,0.774009109188152,1069,222,37,34,17,6,20,28,41.9202832822525,43.5635025489192
0.776736228933378,0.812457221042372,1064,227,28,29,14,8,14,21,41.9202832822525,43.5635025489192
0.795572297118689,0.825004970157071,1071,220,30,37,14,13,16,24,41.9202832822525,43.5635025489192
0.755389144905274,0.790797053075784,1080,211,31,22,13,4,18,18,41.9202832822525,43.5635025489192
0.680556314552708,0.735820398029502,1076,215,29,94,10,18,19,76,41.9202832822525,43.5635025489192
0.720160351739299,0.746530958046137,1072,219,37,38,14,8,23,30,41.9202832822525,43.5635025489192
0.717868516833485,0.781379106254572,1066,225,35,64,16,17,19,47,41.9202832822525,43.5635025489192
