"ROC_observed_outcome","ROC_observed_corrected","ROC_true","sum_low_risk","sum_high_risk","sum_outcome_observed","sum_outcome_true","sum_high_risk_observed","sum_high_risk_true","sum_low_risk_observed","sum_low_risk_true"
0.714125675583225,0.74403144989963,0.663483146067416,1093,198,47,45,20,15,27,30
0.75829231129864,0.795262317595516,0.665323806628154,1044,247,27,26,15,11,12,15
0.702653658536585,0.722202161246633,0.708167330677291,1058,233,41,36,16,14,25,22
0.730001228803146,0.775315961932972,0.674408126484804,1066,225,39,39,19,15,20,24
0.730803965220313,0.756889473244359,0.704587805605247,1063,228,38,43,18,17,20,26
0.745466560930478,0.775860311098802,0.669670065635256,1045,246,30,27,16,14,14,13
0.71761829236056,0.744858386485547,0.651326207442597,1053,238,30,28,13,10,17,18
0.78157962109575,0.806158377069534,0.698237305972113,1069,222,31,24,17,13,14,11
0.7428,0.773827791262679,0.665765544359794,1051,240,41,39,24,18,17,21
0.648902899126291,0.681073674740108,0.620066889632107,1078,213,32,26,12,5,20,21
0.735305816837475,0.751435035262234,0.671463334737236,1061,230,34,34,15,14,19,20
0.781694248013414,0.807597309100584,0.780216819690504,1056,235,44,37,26,20,18,17
0.731924460431655,0.747796596725293,0.734713375796178,1076,215,40,35,15,11,25,24
0.722340068047213,0.759110325332485,0.705727307094552,1080,211,38,38,20,18,18,20
0.725095909306436,0.76975413300786,0.681590148981453,1036,255,37,26,22,16,15,10
0.712878468809958,0.736264713319163,0.672777340676633,1059,232,34,20,15,8,19,12
0.686387782204515,0.712785582125151,0.624627680698967,1068,223,36,32,11,9,25,23
0.746760975609756,0.766555838080885,0.594373105047262,1043,248,41,45,24,19,17,26
0.720100123439857,0.759656036124797,0.713379508983679,1056,235,23,23,11,7,12,16
0.793437361664453,0.813785621568077,0.746266319795732,1060,231,36,33,20,18,16,15
0.737703196538833,0.760769859344077,0.713709111329496,1065,226,38,34,17,15,21,19
0.840376245963779,0.86212578557669,0.721989818503763,1065,226,34,36,24,20,10,16
0.682057426067011,0.706373475645989,0.670660276890309,1068,223,39,39,13,10,26,29
0.783593060864452,0.794901781908723,0.736848780487805,1069,222,38,41,21,17,17,24
0.769836681601388,0.789272751511325,0.696889400921659,1089,202,33,31,15,12,18,19
0.715814634146341,0.747315637172687,0.67731129499727,1050,241,41,38,20,16,21,22
0.738778976818545,0.758965514585091,0.706630402822699,1057,234,40,38,17,14,23,24
0.795700844289495,0.807906355696808,0.789484185323644,1069,222,38,38,20,19,18,19
0.747939833200953,0.786004122170046,0.642658757372103,1049,242,32,23,15,8,17,15
0.779990516832622,0.797606852572583,0.771279620853081,1058,233,37,25,21,14,16,11
0.723919472247498,0.748659771247012,0.671044546850998,1080,211,35,31,17,13,18,18
0.764030821356358,0.794250739267661,0.722397476340694,1065,226,29,23,13,8,16,15
0.696967569844167,0.737362842400231,0.709577379142597,1081,210,34,26,14,10,20,16
0.725561723499868,0.76092826300004,0.670671424795136,1084,207,30,30,12,8,18,22
0.701513743920433,0.734135426539069,0.657570690179386,1052,239,29,26,13,9,16,17
0.775661505693455,0.791321818694343,0.763600317208565,1046,245,39,30,20,15,19,15
0.734347048300537,0.759093173592914,0.678322525342874,1089,202,43,43,22,20,21,23
0.645833333333333,0.667303118817024,0.672855538396743,1063,228,40,34,14,11,26,23
0.757639439598202,0.787356158128469,0.692332914366905,1067,224,30,29,16,13,14,16
0.822177921049655,0.841131159380913,0.707009531374106,1066,225,28,32,18,15,10,17
0.764456323930846,0.793332568672347,0.765948422124194,1083,208,35,28,18,17,17,11
0.810943296237414,0.840492551106289,0.771510815628463,1080,211,33,33,17,15,16,18
0.751823888700373,0.789990418368686,0.75329641350211,1066,225,28,27,14,13,14,14
0.69398601016449,0.739316158422145,0.685608214849921,1096,195,29,25,15,13,14,12
0.720787439283027,0.744104912055669,0.701848071735802,1069,222,47,44,20,16,27,28
0.734885759529465,0.758087977151431,0.63641736514077,1045,246,28,22,12,8,16,14
0.751734988577094,0.786004664683708,0.712142764774344,1083,208,37,37,18,18,19,19
0.682040491355778,0.721466562361451,0.600166002656042,1067,224,35,36,14,12,21,24
0.757219218481199,0.772097269354641,0.727808617499339,1076,215,39,30,15,11,24,19
0.730899672033393,0.770263771597777,0.755675614194722,1054,237,43,35,22,19,21,16
0.734034846925159,0.760798652732756,0.637830752846727,1064,227,42,39,18,14,24,25
0.749920063948841,0.777329319396453,0.726589919977538,1061,230,40,34,19,15,21,19
0.715511591709675,0.748862927859877,0.636230940479691,1088,203,39,38,18,14,21,24
0.753733680204269,0.779271167539233,0.665414077178783,1091,200,33,33,12,8,21,25
0.741316457770132,0.772950282078483,0.694886062533121,1049,242,39,33,20,15,19,18
0.72611931551805,0.75824537880209,0.678193238621415,1078,213,27,24,9,7,18,17
0.761508879086076,0.803882955439841,0.698284849086577,1045,246,28,32,18,16,10,16
0.701354725700656,0.740125251870029,0.707391548504843,1065,226,43,34,23,18,20,16
0.734029268292683,0.754312365267588,0.698373521383076,1071,220,41,35,18,14,23,21
0.798849088322773,0.838175921461576,0.739234511008705,1074,217,37,31,23,16,14,15
0.723447131341868,0.763548541695391,0.719299513417161,1053,238,37,33,20,20,17,13
0.768475694946283,0.791262078591289,0.724764366068714,1090,201,33,26,13,10,20,16
0.74341186105892,0.766948260362129,0.703745724809261,1064,227,33,24,15,12,18,12
0.770956785662668,0.79586369339902,0.660100090991811,1060,231,33,35,14,11,19,24
0.690895573601738,0.696238851144568,0.675565249447039,1068,223,42,39,16,14,26,25
0.722897538687012,0.753741647426767,0.637941628264209,1075,216,37,31,19,14,18,17
0.729037761601456,0.762478271255708,0.688096685922773,1061,230,35,26,17,11,18,15
0.760151299624984,0.775205008720142,0.767610251926335,1056,235,37,29,16,13,21,16
0.665999466239658,0.683923160801882,0.68015278119112,1049,242,42,39,16,17,26,22
0.688546405823476,0.727791436860618,0.644617323019222,1059,232,35,27,14,10,21,17
0.751627861089187,0.786201763350502,0.680050822449314,1062,229,24,29,13,13,11,16
0.642548649722001,0.664228025749569,0.660059188935771,1082,209,32,27,7,3,25,24
0.750762514773724,0.769178359074732,0.704416138626665,1053,238,42,37,19,14,23,23
0.737073055028463,0.763146401936498,0.728389888486009,1065,226,51,47,25,22,26,25
0.805166949013607,0.843706268013295,0.723333333333333,1063,228,29,25,19,11,10,14
0.738379814077025,0.764686148894763,0.689381895264248,1059,232,36,33,19,17,17,16
0.735516617095565,0.753423544731176,0.668691899070385,1082,209,37,36,14,9,23,27
0.810315726767276,0.831877455656083,0.774536859937701,1082,209,32,29,18,16,14,13
0.705453149001536,0.745525443020873,0.719004867140226,1066,225,31,24,14,10,17,14
0.775039339103068,0.798850151853849,0.684189837802052,1091,200,20,19,8,6,12,13
0.682428001530138,0.72303987409553,0.634257989301879,1061,230,29,23,13,8,16,15
0.693931669010783,0.720950993644138,0.631646538062189,1082,209,27,29,12,11,15,18
0.777767785771383,0.824218062762865,0.678560927458311,1057,234,40,38,20,17,20,21
0.768603554408261,0.789530071435084,0.728917604313174,1087,204,32,27,14,9,18,18
0.755696364567332,0.782672059576919,0.696612261692498,1075,216,31,23,16,10,15,13
0.765843949044586,0.787373423933579,0.664838165210485,1044,247,35,32,21,16,14,16
0.671857686563569,0.695387258859877,0.613634236510833,1084,207,33,34,12,10,21,24
0.657756714060032,0.674889498827025,0.566455696202532,1060,231,25,27,9,7,16,20
0.716859227728793,0.744103126446539,0.679171353580802,1078,213,26,21,8,5,18,16
0.78131400016384,0.804523065247725,0.696137671536078,1057,234,39,36,25,18,14,18
0.732049579459938,0.768735733318331,0.670323514946172,1059,232,36,29,18,12,18,17
0.756731707317073,0.785112297637386,0.697056195393169,1080,211,41,32,20,11,21,21
0.774645458855985,0.80416440999683,0.768695306284805,1056,235,37,34,18,15,19,19
0.748940116587175,0.78037549390462,0.758538522637013,1078,213,33,32,17,15,16,17
0.753750161644898,0.765348133407335,0.737403683261381,1038,253,37,29,17,13,20,16
0.764763169544046,0.787707714898869,0.718119706116337,1048,243,36,34,19,16,17,18
0.787541552247435,0.812595042381523,0.751682501979414,1099,192,33,28,18,13,15,15
0.738648296719452,0.751579584319764,0.724032856385798,1056,235,38,33,18,17,20,16
0.753740417657943,0.775705724604962,0.672011084718923,1070,221,30,28,12,8,18,20
0.808828014792787,0.826529327592877,0.756130573248407,1061,230,42,35,25,18,17,17
0.752707006369427,0.778071536995589,0.713504864311316,1037,254,35,31,18,14,17,17
0.717224984971856,0.736139727088216,0.61424121536696,1092,199,29,29,11,8,18,21
0.718970984909237,0.742263377374389,0.719788297559541,1066,225,44,38,22,18,22,20
0.801941463414634,0.812685844062553,0.730709455202252,1059,232,41,38,24,18,17,20
0.759126984126984,0.798869467696336,0.683280465239228,1060,231,31,30,17,12,14,18
0.694713261648746,0.747185931311525,0.636385350318471,1070,221,31,35,15,14,16,21
0.764644559173948,0.784079982558148,0.781562885749554,1097,194,32,23,15,10,17,13
0.752468529177781,0.791299399108186,0.705383737092931,1075,216,34,32,21,16,13,16
0.74701239008793,0.769371278244638,0.706025179856115,1068,223,40,40,19,18,21,22
0.771884174005871,0.789022396923579,0.730615630376014,1054,237,42,39,21,20,21,19
0.705645161290323,0.736937377284296,0.646005246188316,1063,228,31,29,14,11,17,18
0.756380487804878,0.775698721489638,0.759558238569891,1054,237,41,34,21,17,20,17
0.751890928361516,0.759330638886076,0.740110584518167,1067,224,33,25,18,11,15,14
0.72808280381255,0.766801545570759,0.652695476224888,1059,232,32,33,16,13,16,20
0.767543859649123,0.792157033274601,0.723212091422954,1049,242,37,39,16,16,21,23
0.738917073170732,0.760400615404315,0.705048902987047,1079,212,41,30,16,10,25,20
0.797179253867152,0.819775743858458,0.729595494111623,1102,189,35,31,19,14,16,17
0.761239119303636,0.790804884655142,0.664435215039073,1071,220,31,29,15,11,16,18
0.702695489725113,0.720257950590418,0.695939968404423,1076,215,42,25,18,11,24,14
0.763163103721299,0.810220979008095,0.740453025235634,1095,196,28,26,15,12,13,14
0.756442735291973,0.78211377147497,0.740747402078337,1072,219,44,40,21,18,23,22
0.742520595461772,0.770458115842686,0.742605474493836,1053,238,33,28,16,14,17,14
0.836269830127755,0.85859236294442,0.740277972764285,1065,226,34,34,23,18,11,16
0.733805956839665,0.751904716185058,0.685551558752998,1059,232,45,40,20,15,25,25
0.743134846076023,0.767979083048834,0.666898332009531,1078,213,33,32,16,12,17,20
0.754526091586795,0.78272730900139,0.674570504473474,1073,218,39,38,19,16,20,22
0.754429268292683,0.772636037001809,0.741015021760494,1059,232,41,34,19,15,22,19
0.76424710953,0.789742811364886,0.735116818262886,1061,230,47,45,27,21,20,24
0.69060321025785,0.711125600016572,0.679408710858517,1061,230,34,29,14,13,20,16
0.760813241076599,0.777287895695576,0.733365853658536,1067,224,53,41,25,15,28,26
0.690575972490866,0.739163288883112,0.639936150805716,1076,215,22,26,11,9,11,17
0.723341326938449,0.750651050476421,0.752631056393963,1052,239,40,32,21,18,19,14
0.66048030101815,0.692941030493662,0.603752978554408,1049,242,36,32,14,10,22,22
0.810133821342788,0.845316563988277,0.694452473864238,1045,246,42,33,26,17,16,16
0.779777877161598,0.799557824709789,0.747713830755232,1051,240,43,35,24,18,19,17
0.759892667787405,0.791360952420442,0.690571049136786,1066,225,37,36,20,14,17,22
0.63516179952644,0.685424013295297,0.612024500322373,1100,191,24,22,7,5,17,17
0.736964446628983,0.773785511231798,0.725307219662058,1077,214,39,31,20,15,19,16
0.713129693081578,0.733543463794512,0.697429481346679,1046,245,44,35,16,11,28,24
0.688127090301003,0.710732147238465,0.675296442687747,1072,219,26,26,9,6,17,20
0.726506652104845,0.752561462552079,0.648451100870455,1075,216,32,31,14,11,18,20
0.747470713525027,0.766645916281257,0.699124203821656,1066,225,39,35,19,11,20,24
0.7577914266968,0.790065595031592,0.751421747042766,1066,225,44,35,22,16,22,19
0.75472003103582,0.774179806151322,0.748419017288444,1072,219,37,35,19,15,18,20
0.816868546465449,0.828947763434048,0.776804743428603,1088,203,32,29,16,11,16,18
0.668789808917197,0.699264267267507,0.647658341985901,1085,206,35,29,15,11,20,18
0.73888454084675,0.756135786101149,0.657286578697966,1058,233,43,44,20,16,23,28
0.788446215139442,0.79350563232549,0.707327766975485,1056,235,36,42,16,17,20,25
0.748730236749406,0.767787554177858,0.765559923253311,1096,195,39,34,17,15,22,19
0.717361732259988,0.736423140453351,0.67209756097561,1084,207,43,41,15,10,28,31
0.719874100719424,0.742109584374959,0.690647482014389,1068,223,40,40,17,14,23,26
0.718740299248774,0.745762065769197,0.715317874216179,1061,230,52,52,22,23,30,29
0.694294257393299,0.736523351410209,0.674145437303332,1057,234,39,37,17,13,22,24
0.795712010919017,0.836540502413135,0.735540576262226,1078,213,35,30,21,13,14,17
0.753618857901726,0.78356431612703,0.687322349087055,1056,235,36,33,21,16,15,17
0.724460106039053,0.749513776404935,0.735637480798771,1054,237,37,31,19,16,18,15
0.793085222716337,0.81568340876752,0.763824035389531,1062,229,44,39,23,21,21,18
0.737826471890217,0.757751259025013,0.745518880813159,1077,214,36,29,16,11,20,18
0.741529786138799,0.764604940488709,0.715481524305054,1076,215,34,33,16,14,18,19
0.729840600093765,0.777640796122855,0.633731833098922,1057,234,27,27,14,11,13,16
0.787946074544013,0.832362203072591,0.703072196620584,1069,222,30,31,19,16,11,15
0.717879065156887,0.755687894906579,0.722930500221337,1054,237,42,36,21,18,21,18
0.7710931254996,0.779694559672779,0.727260683143036,1067,224,40,33,15,12,25,21
0.699800067447126,0.719638368594118,0.666129541864139,1072,219,33,25,14,8,19,17
0.806320144179569,0.832836758386686,0.717120407259849,1044,247,39,36,21,16,18,20
0.703359683794466,0.742668967662218,0.589381453534551,1064,227,26,32,13,10,13,22
0.766688800354139,0.792945502165185,0.720293683951831,1090,201,36,39,20,18,16,21
0.824432721491545,0.849788195624529,0.745730901401005,1098,193,33,30,18,12,15,18
0.717535545023697,0.743679377474759,0.619151467089611,1045,246,25,30,9,8,16,22
0.801660932251987,0.821805135336791,0.690147881694644,1056,235,39,40,21,13,18,27
0.717191188040913,0.747808702866916,0.730181045124126,1080,211,20,23,8,9,12,14
0.749566411331117,0.768883577149051,0.755683746182558,1064,227,33,28,12,12,21,16
0.742666317443688,0.759217747285828,0.710475432211101,1056,235,46,35,23,14,23,21
0.74692515127598,0.775074305435024,0.692669826224328,1061,230,24,25,12,9,12,16
0.732507317073171,0.758419097759783,0.739338529176659,1091,200,41,40,15,15,26,25
0.751600102406554,0.758212695470984,0.722311854646545,1079,212,31,32,11,11,20,21
0.758819764464926,0.793263984719373,0.658096070823542,1080,211,31,29,19,11,12,18
0.733424390243902,0.749102200364272,0.686415760070567,1098,193,41,38,17,13,24,25
0.743413355795779,0.780984873297369,0.750180873454354,1081,210,34,24,17,13,17,11
0.749490925188136,0.778942753929381,0.717826110716433,1075,216,36,29,19,12,17,17
0.664828639294198,0.690098586326022,0.658957345971564,1066,225,28,25,11,7,17,18
0.694722140546898,0.724193657652219,0.667383512544803,1069,222,38,31,19,12,19,19
0.683713029576339,0.706608724861768,0.632036834789516,1059,232,40,32,16,9,24,23
0.694881710646042,0.721017308055681,0.694139020537125,1063,228,35,25,14,10,21,15
0.772353904706846,0.789218115347984,0.724611944225204,1081,210,33,24,14,9,19,15
0.719648780487805,0.746925732569662,0.683314614628668,1070,221,41,34,19,13,22,21
0.74293677250123,0.759202590013212,0.655069124423963,1072,219,29,31,6,6,23,25
0.708688620993825,0.721403944556782,0.659564413827866,1063,228,38,38,14,9,24,29
0.727581892629663,0.754883390280737,0.692352561556791,1055,236,35,32,18,14,17,18
0.769589170148276,0.788154201341103,0.694597003420533,1065,226,39,33,22,15,17,18
0.750409727729315,0.774036598843342,0.738054301884089,1060,231,30,22,15,10,15,12
0.688880586133994,0.714065309862888,0.663579017264276,1044,247,44,36,17,15,27,21
0.718468468468469,0.738561214625306,0.712593584348872,1070,221,37,29,13,9,24,20
0.760752688172043,0.791254602771687,0.750351617440225,1063,228,31,27,18,14,13,13
0.800175844293491,0.839454721087755,0.759891250888027,1075,216,33,29,19,14,14,15
0.725789192081327,0.740249166614267,0.696121474067334,1071,220,45,35,19,14,26,21
0.719913764031411,0.747422006721534,0.655163785259327,1057,234,33,35,15,13,18,22
0.758329823576209,0.774128658558049,0.701285259326661,1084,207,34,35,12,10,22,25
0.722940256967479,0.746812281493041,0.659262948207171,1075,216,42,36,19,15,23,21
0.678412862623389,0.70488898857753,0.593229138204273,1077,214,37,29,12,4,25,25
0.711385979049154,0.740363375361204,0.669582664526485,1064,227,50,45,22,19,28,26
0.657381710646042,0.687509969066352,0.663133511161028,1063,228,35,34,13,12,22,22
0.752158016764758,0.76790526197646,0.741356097560976,1059,232,45,41,19,16,26,25
0.75021002226236,0.78163554770383,0.697314539419803,1070,221,38,37,21,15,17,22
0.728357030015798,0.763437939311776,0.767955801104972,1066,225,25,24,12,11,13,13
0.650251123447,0.689931317897739,0.562979117102828,1044,247,30,30,12,10,18,20
0.72580543537615,0.771788035048154,0.74182784752856,1085,206,38,28,20,15,18,13
0.763967395756533,0.780897597950892,0.703791111685849,1070,221,39,37,18,17,21,20
0.726134332803813,0.754663169399344,0.66659440188852,1080,211,32,33,13,11,19,22
0.736874723328907,0.785343557740154,0.725398406374502,1056,235,36,36,24,23,12,13
0.74887989593872,0.7843549842167,0.756366468113012,1075,216,33,29,19,16,14,13
0.770463990239811,0.79616777922389,0.709041611332448,1079,212,42,36,21,13,21,23
0.750655361677726,0.773407415179877,0.741188043062462,1076,215,39,29,19,13,20,16
0.742095571723704,0.763297531499961,0.683839706652698,1043,248,54,46,28,20,26,26
0.765450588837685,0.809930519441086,0.718265636157433,1082,209,31,38,19,18,12,20
0.669511312812418,0.702908596753842,0.667514895729891,1074,217,24,19,9,7,15,12
0.774067333939945,0.807970748856541,0.728432313811549,1088,203,35,23,18,10,17,13
0.750892594615029,0.769710095840678,0.73510942159869,1059,232,38,38,20,21,18,17
0.713046627778413,0.750290521579681,0.706245027844073,1070,221,42,34,19,14,23,20
0.745200229242782,0.756509404437509,0.556630131098216,1055,236,22,22,9,5,13,17
0.803289096420087,0.829077638988577,0.726486915146709,1065,226,39,30,26,16,13,14
0.744251267143709,0.772180078691382,0.619024526919264,1068,223,43,37,19,12,24,25
0.71544539191598,0.747777932138416,0.662386274088402,1049,242,33,22,16,9,17,13
0.683501801675324,0.701727704651144,0.658061953931692,1066,225,34,32,12,11,22,21
0.735491957903098,0.76727152280249,0.669232042370076,1064,227,32,19,15,7,17,12
0.750521247021446,0.76755109701038,0.69832208101668,1055,236,32,32,16,12,16,20
0.785369632580788,0.824091148570941,0.732079030976966,1051,240,36,32,21,18,15,14
0.837113402061856,0.857268119258335,0.802273792780122,1086,205,30,27,19,16,11,11
0.745773791425965,0.768911032277172,0.675858816521048,1077,214,26,32,12,13,14,19
0.734697676727561,0.747267677192318,0.697630358556724,1068,223,32,28,11,8,21,20
0.745017182130584,0.768236470686313,0.67777439951353,1066,225,30,26,13,10,17,16
0.733895131086142,0.766539138053854,0.715860881253413,1051,240,45,38,24,17,21,21
0.759531392174704,0.785364767190346,0.769217552207243,1065,226,35,30,18,15,17,15
0.67442322991249,0.692867952319191,0.658166922683052,1083,208,34,31,12,7,22,24
0.761690647482014,0.776861821673306,0.75055282321095,1073,218,40,42,20,20,20,22
0.692174704276615,0.716075595367283,0.682976473698123,1076,215,35,30,14,11,21,19
0.801018933371874,0.828827340038209,0.703417818740399,1090,201,33,31,18,11,15,20
0.72836632780453,0.752210220470254,0.724576805141345,1067,224,45,38,21,17,24,21
0.721088093322607,0.739393719279666,0.675102550383449,1052,239,48,45,21,18,27,27
0.792687024824631,0.820439696371117,0.764121292607348,1057,234,38,36,24,21,14,15
0.751914884902105,0.777167792731684,0.667652411282984,1023,268,39,35,21,16,18,19
0.704119850187266,0.725478180731726,0.656293520111412,1079,212,45,39,19,14,26,25
0.758753873395308,0.793382917713444,0.697055907582224,1069,222,36,37,22,19,14,18
0.758416742493176,0.795528395641887,0.674926295100379,1094,197,35,34,18,15,17,19
0.629288274449565,0.652086605443693,0.637634034948372,1091,200,31,32,9,9,22,23
0.678214849921011,0.711069604126758,0.691658767772512,1110,181,25,25,8,7,17,18
0.781797235023041,0.803677512641313,0.697052603753635,1060,231,31,30,16,11,15,19
0.759362549800797,0.793563205379427,0.729256594724221,1071,220,36,40,22,24,14,16
0.804427422074481,0.811158706431904,0.76919111816019,1078,213,33,30,14,10,19,20
0.753822478157268,0.790831637903845,0.696999735659529,1079,212,32,30,17,11,15,19
0.754547609810768,0.778704304023753,0.744119654231119,1070,221,37,35,16,13,21,22
0.805482481223074,0.824373414843926,0.771920316037963,1087,204,42,33,21,14,21,19
0.743481629039398,0.773291402006041,0.705800814886378,1075,216,36,38,20,16,16,22
0.703116469517743,0.727198863818567,0.73704897636014,1054,237,35,28,16,14,19,14
0.764573396926338,0.776565532380163,0.679334916864608,1078,213,33,28,15,12,18,16
0.657237380921591,0.685161507503367,0.602312979117103,1083,208,37,30,14,9,23,21
0.721282973621103,0.744313511689289,0.669876506909732,1056,235,40,38,19,17,21,21
0.740159484221242,0.769355760374986,0.649713891081295,1076,215,28,24,14,9,14,15
0.726623062015504,0.75473574913762,0.66573482428115,1061,230,43,39,21,15,22,24
0.83614431164232,0.852638605871008,0.764846272637933,1044,247,36,34,24,19,12,15
0.711340833079964,0.76282589315497,0.635451818522685,1072,219,26,21,14,10,12,11
0.690511860174781,0.714336842805591,0.668019905709796,1085,206,45,46,20,19,25,27
0.776376251137398,0.803187288039571,0.715411737943585,1081,210,35,35,20,17,15,18
0.715445424141076,0.746730801098429,0.648086029992107,1080,211,26,24,12,9,14,15
0.718937707396984,0.751011356754035,0.706631101127802,1096,195,38,34,15,13,23,21
0.755928975178176,0.772894719856325,0.673724526665703,1065,226,39,33,17,11,22,22
0.718244542472571,0.738019364356081,0.755903051828466,1088,203,28,24,11,8,17,16
0.769207102672293,0.81454586152499,0.755157962604771,1049,242,27,22,17,14,10,8
0.721510541766747,0.75603897485922,0.711340927258193,1080,211,42,40,20,17,22,23
0.743931195393169,0.769596370369718,0.640866736990155,1062,229,32,27,16,10,16,17
0.706237337816285,0.728990687763502,0.643024040082864,1055,236,37,33,16,10,21,23
0.722150790101371,0.747433266269094,0.702968607825296,1048,243,43,35,19,13,24,22
0.753157463683779,0.779855302178876,0.666602008707272,1075,216,37,37,17,14,20,23
0.735738686882868,0.777567572715208,0.698668714797747,1078,213,34,31,18,13,16,18
0.81504590715117,0.854806906043309,0.765886207062678,1062,229,37,33,25,19,12,14
0.74996003197442,0.776898787991172,0.66636248771585,1088,203,40,34,22,15,18,19
0.731933805463217,0.753687591311553,0.732404477262072,1063,228,33,27,14,12,19,15
0.783560975609756,0.805762982056656,0.764880361397935,1054,237,41,32,21,14,20,18
0.786667680145941,0.806548019067942,0.730335344945824,1074,217,26,23,12,6,14,17
0.760153201329672,0.782283289349668,0.68810812152502,1054,237,33,32,17,13,16,19
0.718546897448177,0.745847984993548,0.744320875899823,1060,231,47,37,23,21,24,16
0.728110814731621,0.758021543062366,0.666795357761243,1075,216,34,34,15,12,19,22
0.689609608514981,0.724905850163004,0.71779313876088,1099,192,44,31,18,13,26,18
0.71566662356136,0.740257487360101,0.71052174344718,1083,208,37,32,16,10,21,22
0.742288444040036,0.768867365991267,0.693916302621128,1080,211,35,32,14,12,21,20
0.72010936347997,0.75678685375448,0.683444001770695,1053,238,39,36,18,16,21,20
0.707454967005529,0.724112244628232,0.700125258948788,1059,232,45,33,20,15,25,18
0.730862787926926,0.765370872687195,0.670370791628753,1070,221,32,35,17,17,15,18
0.742921146953405,0.757241398874218,0.694047619047619,1039,252,31,31,15,11,16,20
0.784676193371846,0.810981052637316,0.755999250093738,1074,217,26,21,16,12,10,9
0.771862455967887,0.796073965345424,0.633429266694745,1065,226,39,34,19,12,20,22
0.684815741583257,0.706075699037247,0.5895982024848,1050,241,35,30,14,10,21,20
0.670023790642347,0.709618482172271,0.661477652782001,1060,231,30,26,15,11,15,15
0.743555756713651,0.768260883468092,0.741212926073484,1045,246,37,36,20,16,17,20
0.762870288020798,0.781258804917497,0.749653463267106,1067,224,47,38,25,18,22,20
0.768490983262801,0.79773663941528,0.718058536585366,1057,234,42,41,22,16,20,25
0.807757296466974,0.834640174407112,0.680459981977554,1049,242,31,39,19,16,12,23
0.773008883297114,0.789036405563244,0.668750455638988,1049,242,42,44,25,19,17,25
0.774720223820943,0.804772089571095,0.744340746624305,1045,246,40,32,25,17,15,15
0.773117600262062,0.798430100660356,0.742761478055596,1068,223,34,33,19,19,15,14
0.713346613545817,0.730246744755429,0.651296633303003,1047,244,36,35,15,11,21,24
0.686712195121951,0.721660541020034,0.630415667466027,1071,220,41,40,17,14,24,26
0.788131112873381,0.800950018904139,0.707344618745036,1069,222,30,32,13,13,17,19
0.78835304822566,0.814673740000749,0.773553199628395,1053,238,35,29,19,14,16,15
0.706070287539936,0.729925445833361,0.666312527667109,1051,240,39,36,15,13,24,23
0.757692307692308,0.782156240079808,0.75540611814346,1064,227,26,27,12,10,14,17
0.702616163621922,0.736950132696725,0.691646841131377,1073,218,32,30,15,12,17,18
0.733522996680891,0.766153084073121,0.717164674634794,1096,195,37,36,14,13,23,23
0.743307901202638,0.765871348080318,0.630191693290735,1059,232,37,39,17,15,20,24
0.765693926026467,0.792408937351106,0.646390168970814,1072,219,28,31,15,12,13,19
0.673562397614147,0.704110967585915,0.629989704712434,1081,210,38,34,16,13,22,21
0.666558155164447,0.684253105571307,0.658828527894983,1059,232,38,27,13,9,25,18
0.692695156521474,0.710124916861821,0.688436409659985,1058,233,53,47,20,17,33,30
0.748000674471263,0.791313766944187,0.717831612390786,1075,216,33,32,14,14,19,18
0.67093674939952,0.706276210219046,0.673908465534185,1055,236,42,34,20,18,22,16
0.761111111111111,0.791347213511419,0.720629370629371,1076,215,31,26,15,11,16,15
0.730885966180084,0.750568676271901,0.691564260112647,1066,225,33,31,15,13,18,18
0.720351043643264,0.740042716915978,0.698640027587396,1064,227,51,37,24,16,27,21
0.731717574147853,0.757761300807004,0.719347358896053,1057,234,36,28,18,14,18,14
0.724240986717268,0.752809712163604,0.660165864098448,1072,219,51,45,24,18,27,27
0.745294739624637,0.792614891790363,0.692322274881517,1080,211,30,25,18,12,12,13
0.797987898228476,0.8201370371013,0.773394062748213,1063,228,44,32,27,16,17,16
0.740926672038678,0.760620208522268,0.7332034372502,1062,229,50,40,23,16,27,24
0.736358743974917,0.757562274052652,0.75517955801105,1074,217,34,24,16,12,18,12
0.750752545374059,0.766517000790363,0.736257648022354,1065,226,36,33,13,12,23,21
0.714247951361353,0.741837417881532,0.723870458135861,1073,218,30,25,12,7,18,18
0.775669464428457,0.797209212492454,0.765471447543161,1076,215,40,36,20,19,20,17
0.789952735270719,0.815259284807587,0.695968120018753,1067,224,34,27,19,11,15,16
0.70210831334932,0.721431828945227,0.65430062239693,1060,231,40,34,13,8,27,26
0.660010649627263,0.688494674710935,0.670706049510902,1074,217,39,29,13,11,26,18
0.749273255813953,0.775583543259679,0.7027350316824,1090,201,43,37,19,17,24,20
0.69303787268332,0.707057201293267,0.655815516444743,1087,204,50,38,18,14,32,24
0.730990559937928,0.75013959725318,0.709741423451101,1066,225,37,31,16,13,21,18
0.736000442673749,0.777648566946857,0.708476693700336,1054,237,36,39,17,16,19,23
0.751450699611587,0.771202027622376,0.691633466135458,1053,238,34,36,14,10,20,26
0.742117073170732,0.762903102221128,0.702260997788154,1063,228,41,39,22,18,19,21
0.721202485908368,0.747455603375574,0.730516401569033,1063,228,33,37,16,17,17,20
0.703775609756097,0.732801214373163,0.681186205737808,1084,207,41,38,18,14,23,24
0.852595875162767,0.863620242160548,0.845347607718742,1063,228,38,30,28,22,10,8
0.698464513193812,0.731771002369584,0.702355540111199,1057,234,35,32,15,13,20,19
0.729825143868969,0.75406965187236,0.665578641957977,1058,233,36,34,16,13,20,21
0.795625165212794,0.822532502544725,0.753916412170569,1059,232,30,28,17,15,13,13
0.748101171564734,0.773796381139638,0.692056375996249,1081,210,32,27,16,10,16,17
0.716581692451946,0.761509706546338,0.693539069626026,1067,224,27,26,12,10,15,16
0.752776322682032,0.780489690510395,0.734384844793548,1064,227,46,38,24,18,22,20
0.72292986766671,0.760816187188788,0.654182219205972,1041,250,37,28,18,10,19,18
0.756153165117308,0.791946276661987,0.678942652329749,1061,230,36,31,18,13,18,18
0.805824541118659,0.835677116349467,0.749363057324841,1067,224,33,35,21,21,12,14
0.740668725456556,0.767407917758557,0.739092682926829,1077,214,42,41,21,18,21,23
0.780315074432721,0.807986488529553,0.798135860979463,1081,210,33,25,18,12,15,13
0.704941116231439,0.727454819622738,0.646579507449073,1083,208,31,26,12,8,19,18
0.756485170429394,0.791683363775907,0.700933595395199,1070,221,36,34,18,15,18,19
0.718450039339103,0.75404761555731,0.669346882399369,1083,208,20,24,8,8,12,16
0.775885347498893,0.800104696355594,0.723521383075523,1049,242,36,35,20,17,16,18
0.77419212040726,0.799840749233392,0.760727086533538,1090,201,36,31,21,16,15,15
0.740043988955964,0.763511844222167,0.710433338013009,1068,223,34,34,11,10,23,24
0.757069336047958,0.785476834052451,0.694696431498989,1083,208,28,29,10,8,18,21
0.771258536585366,0.797621952034593,0.763401947764497,1029,262,41,36,22,20,19,16
0.753096366508689,0.782832575607161,0.650244713269923,1065,226,25,17,14,7,11,10
0.752650136487716,0.801017459539826,0.722166016283663,1052,239,35,33,21,18,14,15
0.729950028672073,0.756850059985479,0.670484531392175,1061,230,39,35,19,15,20,20
0.713767607281576,0.740968269722945,0.697898894154818,1081,210,34,25,15,9,19,16
0.81740814519699,0.848759619205749,0.766257719001038,1060,231,36,29,23,16,13,13
0.753720342552295,0.793681489544544,0.686206311503224,1049,242,34,28,21,15,13,13
0.689365853658537,0.715550765686527,0.601239024390244,1100,191,41,41,13,10,28,31
0.768414467697907,0.801750036819384,0.659620850797321,1050,241,35,33,21,15,14,18
0.713109512390088,0.739712099748145,0.724686408896935,1069,222,40,37,16,15,24,22
0.748376113148245,0.764448041799062,0.67671862509992,1088,203,46,40,21,14,25,26
0.691282796660703,0.711267582109572,0.652536396724295,1056,235,43,35,17,14,26,21
0.701592741066425,0.719240302294701,0.666257195002106,1086,205,37,34,13,11,24,23
0.796762589928057,0.815125785599572,0.718803614320027,1072,219,40,42,24,20,16,22
0.722370731707317,0.739562175597698,0.708476693700336,1057,234,41,39,17,16,24,23
0.757855942066468,0.777974810257919,0.719336421919603,1065,226,37,34,18,15,19,19
0.722411139793487,0.748242769559513,0.692073337340838,1066,225,32,29,13,10,19,19
0.787331215250198,0.800246596471371,0.617537122375832,1057,234,32,31,18,11,14,20
0.742162305048903,0.797350617885397,0.734192964596765,1062,229,30,28,16,14,14,14
0.784229725144215,0.811235692364189,0.723959505061867,1079,212,28,21,14,7,14,14
0.727022529441884,0.744518908406048,0.628817441465897,1066,225,31,28,10,7,21,21
0.719486061419201,0.737485720618609,0.677797575161792,1060,231,43,39,15,11,28,28
0.730861391005161,0.759881188264862,0.683230662681344,1051,240,39,44,21,21,18,23
0.73958013312852,0.774533476699186,0.704890412564463,1075,216,31,27,15,12,16,15
0.635054595086442,0.65884003949265,0.66340206185567,1072,219,35,30,12,12,23,18
0.668705035971223,0.688841344915123,0.595185922974768,1068,223,40,36,14,10,26,26
0.771974522292993,0.794293436991969,0.6580548046203,1067,224,35,39,17,14,18,25
0.722112310151878,0.758304887688129,0.689480087977912,1072,219,40,34,18,12,22,22
0.769404003639673,0.795370010579479,0.661763150938409,1048,243,35,30,19,14,16,16
0.771526663099697,0.78421686224658,0.750051200131072,1037,254,45,39,21,19,24,20
0.777812726371573,0.790159098427107,0.676113744075829,1064,227,42,25,24,11,18,14
0.798399550751088,0.835270571025293,0.72091821222256,1069,222,34,26,21,13,13,13
0.722830948121646,0.757280034761799,0.704769809650288,1076,215,43,36,21,18,22,18
0.719747226352511,0.739148541306859,0.670383796182518,1067,224,42,39,14,11,28,28
0.768288686819038,0.790357121738256,0.744990969042719,1072,219,39,38,21,20,18,18
0.700898757599788,0.729284326515711,0.61831247609159,1056,235,30,29,10,10,20,19
0.771053157474021,0.804329159584493,0.663717015468608,1064,227,40,35,23,17,17,18
0.737926435490664,0.770262100621197,0.710179324894515,1074,217,34,27,20,15,14,12
0.67747055811572,0.704869427966789,0.607445364780757,1069,222,31,34,10,10,21,24
0.739012738853503,0.764436935198196,0.709055139625116,1069,222,35,29,15,10,20,19
0.805674146147736,0.834902053761772,0.780756013745705,1034,257,32,30,23,19,9,11
0.6758212501024,0.69986404328357,0.674961392671627,1075,216,39,34,14,12,25,22
0.80521495234313,0.837879852043226,0.765645324468854,1070,221,32,33,19,14,13,19
0.737833527307212,0.762811919542211,0.738057324840764,1083,208,37,35,16,16,21,19
0.803691458549648,0.821488486208764,0.720558500464506,1081,210,29,29,18,14,11,15
0.796027298028899,0.819470617297095,0.804583712465878,1050,241,42,35,27,20,15,15
0.791167066346922,0.805730312211762,0.744536478075717,1063,228,40,34,24,17,16,17
0.75915171784737,0.789663677858575,0.752538765582244,1102,189,26,26,13,14,13,12
0.778873980531439,0.781884700623324,0.776959130108736,1076,215,24,21,13,11,11,10
0.807724618809594,0.822139095926836,0.753878525932666,1074,217,38,35,23,18,15,17
0.770676691729323,0.800576981554587,0.718914101267042,1074,217,38,33,21,16,17,17
0.679668287884584,0.701071324746274,0.710128944689515,1073,218,29,28,11,12,18,16
0.73299131645777,0.76469664382339,0.693357597816197,1074,217,39,35,19,14,20,21
0.674510526746948,0.694434038156825,0.682337317397078,1063,228,39,36,16,16,23,20
0.727973188499504,0.768027616806946,0.722061314825947,1072,219,37,29,19,13,18,16
0.754156097560976,0.785463633276238,0.733813957498168,1071,220,41,37,18,14,23,23
0.776484312946783,0.799295238531644,0.713385977375813,1049,242,32,29,19,16,13,13
0.751019184652278,0.761360968042523,0.760810051944406,1065,226,40,34,18,15,22,19
0.763977423638778,0.798166966674565,0.73020993343574,1058,233,36,31,19,14,17,17
0.75687529634898,0.78845726450429,0.745588734306074,1080,211,37,28,15,11,22,17
0.771351766513057,0.790728976678439,0.695770849776375,1101,190,31,24,9,4,22,20
0.713668292682927,0.733393651336489,0.578100575698654,1083,208,41,42,14,12,27,30
0.729601867780782,0.758934382895669,0.77640060947023,1059,232,39,27,22,18,17,9
0.741722100873709,0.777795937180546,0.663443830570902,1047,244,32,24,18,11,14,13
0.731055991935145,0.749247169537361,0.737626588562351,1083,208,38,32,14,11,24,21
0.74300487804878,0.770771940723741,0.738352672292546,1075,216,41,27,21,13,20,14
0.673505976095618,0.69602895352783,0.642686533212011,1059,232,36,35,10,8,26,27
0.797887459652166,0.818592763694104,0.767639474917956,1083,208,33,27,16,12,17,15
0.78355106888361,0.806296622640617,0.692250942674463,1061,230,28,29,13,10,15,19
0.666820276497696,0.692971750190254,0.536571669240489,1067,224,31,34,8,6,23,28
0.704864523374983,0.746359259922815,0.621769352290679,1070,221,34,25,17,11,17,14
0.793635881871176,0.835594894036789,0.657822078712153,1080,211,33,34,20,16,13,18
0.730131977884787,0.753965876322087,0.692873944638132,1056,235,45,38,23,19,22,19
0.776715309779826,0.804824977944959,0.740513833992095,1082,209,31,26,17,11,14,15
0.771978751660027,0.80506368968125,0.754731574158326,1103,188,36,35,16,15,20,20
0.760261598496893,0.775797873101007,0.699669574411842,1062,229,33,30,14,10,19,20
0.791614020309795,0.803384174352146,0.754781682059129,1049,242,34,29,17,11,17,18
0.75388413121812,0.787966703650318,0.672939068100358,1060,231,34,31,17,12,17,19
0.738539803220036,0.760773169597221,0.718015862752705,1057,234,43,37,20,14,23,23
0.814802025782689,0.843339782927785,0.776667494207216,1078,213,24,19,13,9,11,10
0.799340927000502,0.815156842597985,0.757629571165483,1042,249,22,24,14,15,8,9
0.748019017432647,0.777823587620782,0.624379467831612,1050,241,29,32,13,9,16,23
0.730994511345949,0.747221252442096,0.711146988628387,1066,225,39,34,17,16,22,18
0.718927206283866,0.740004915115776,0.699314170173234,1081,210,38,29,15,10,23,19
0.762779552715655,0.791906961197655,0.677015596087761,1080,211,39,30,19,12,20,18
0.790502597220272,0.817002683338132,0.772593598009275,1058,233,34,28,19,14,15,14
0.757618862882021,0.793204620351866,0.737403683261381,1061,230,37,29,19,13,18,16
0.762257311378717,0.79187996610522,0.722069663246134,1082,209,39,33,19,13,20,20
0.727401604570085,0.761056548948914,0.664241993189362,1075,216,38,37,22,17,16,20
0.678182887386063,0.712175934521243,0.700153609831029,1063,228,38,31,18,13,20,18
0.747909392646235,0.790712346710235,0.655266151046406,1055,236,37,35,22,14,15,21
0.75411336115482,0.768805041093999,0.71715297256619,1070,221,47,47,22,19,25,28
0.716722703564809,0.759639021351517,0.653012189404594,1048,243,37,27,22,13,15,14
0.75795326349718,0.785182710830213,0.689240268180885,1043,248,50,47,27,23,23,24
0.773960831334932,0.793132718481356,0.791573310016941,1041,250,40,29,20,15,20,14
0.749794889826535,0.783091441809741,0.678736176935229,1068,223,27,25,15,11,12,14
0.708214634146342,0.731626169424452,0.74524567788899,1070,221,41,35,18,17,23,18
0.706388206388206,0.733364766069934,0.637820194598888,1057,234,33,32,12,11,21,21
0.775685722686605,0.807398400940155,0.738480278909564,1079,212,38,38,20,17,18,21
0.797534201687556,0.818436523294491,0.672893225503985,1077,214,39,27,21,12,18,15
0.784672421425409,0.804227581475715,0.681512650964534,1076,215,36,29,20,11,16,18
0.788794775636881,0.813651294553636,0.752764976958525,1053,238,37,31,21,15,16,16
0.775044722719141,0.78890105021056,0.669872244840657,1079,212,43,34,21,11,22,23
0.791708821120586,0.811381203416978,0.707530778395552,1083,208,33,32,18,16,15,16
0.781608350485151,0.805391827008147,0.74530877680699,1072,219,38,32,21,15,17,17
0.754049135577798,0.789117977257185,0.77927137442089,1058,233,35,34,19,19,16,15
0.724500768049155,0.754032983343664,0.615911418330773,1069,222,31,31,12,8,19,23
0.742845786963434,0.779746525799743,0.684986073564348,1054,237,33,39,18,17,15,22
0.680227362986497,0.708146383432156,0.667891264786169,1055,236,32,35,13,14,19,21
0.761397149176702,0.773794918557422,0.679285504263452,1049,242,39,38,22,18,17,20
0.730791867308721,0.757006917991884,0.635946588023265,1075,216,45,39,20,11,25,28
0.74878403383558,0.782252138567625,0.662071172555043,1069,222,30,31,14,12,16,19
0.75021002226236,0.778890874706418,0.679686078252957,1088,203,38,35,18,14,20,21
0.753392765220647,0.7877009551019,0.705721624132466,1072,219,34,29,17,12,17,17
0.667363877822045,0.704316187715566,0.646377368151562,1082,209,36,31,14,9,22,22
0.73705035971223,0.76567459952171,0.618208619963499,1068,223,40,34,20,10,20,24
0.765746883429321,0.798113286680972,0.73557893934195,1063,228,44,42,22,19,22,23
0.748174822415154,0.816833263918862,0.732988750380055,1087,204,24,26,12,11,12,15
0.74582055697904,0.765955743257483,0.692621766151178,1081,210,38,33,17,10,21,23
0.736370903277378,0.762197753628833,0.661908538197198,1053,238,40,30,21,14,19,16
0.737647209421403,0.754621400858739,0.711409974567869,1070,221,31,37,13,15,18,22
0.690404324020778,0.711178405763942,0.752159451945989,1068,223,34,32,10,12,24,20
0.743717401612139,0.765499062976408,0.668623411437649,1059,232,37,32,16,13,21,19
0.74655707923113,0.769083811786037,0.647551181992987,1075,216,27,28,11,9,16,19
0.703795174741859,0.736718589302494,0.680706595988852,1063,228,32,29,15,13,17,16
0.726148771610555,0.741112030728147,0.639524544901493,1062,229,35,34,15,13,20,21
0.778426878354204,0.799035259547138,0.766056726583042,1067,224,43,37,22,18,21,19
0.77503626749029,0.805378752316237,0.674306106264869,1067,224,34,30,18,12,16,18
0.721347015464663,0.745045668156153,0.691826853591559,1040,251,33,33,17,15,16,18
0.769953519256308,0.803590580640817,0.784711497964341,1050,241,36,34,21,19,15,15
0.756131031429836,0.781204107827448,0.754057626222575,1084,207,36,30,14,13,22,17
0.700438273121979,0.71959325790848,0.664649381502417,1064,227,39,39,15,12,24,27
0.778508189464365,0.796809536194232,0.805547935811274,1071,220,36,23,19,13,17,10
0.751688649080735,0.780112545179989,0.692076139884905,1065,226,40,36,20,14,20,22
0.769587628865979,0.800545728880266,0.735173464603844,1070,221,30,27,15,12,15,15
0.673373173970784,0.70531513842888,0.673411115361495,1056,235,36,29,16,13,20,16
0.785084888800635,0.804817802928428,0.751714135021097,1082,209,32,27,19,15,13,12
0.786790567545963,0.806927087260876,0.697415074917077,1080,211,40,42,20,15,20,27
0.793306752629793,0.803843547210372,0.742652329749104,1091,200,28,31,12,11,16,20
0.720120267677477,0.763353732005499,0.641605440826052,1057,234,34,32,16,12,18,20
0.736465250110668,0.766696192311035,0.712265397832408,1049,242,36,30,17,15,19,15
0.769484710087371,0.795280345547869,0.750983660309307,1068,223,32,29,19,15,13,14
0.716013722886233,0.729275787422029,0.660192563081009,1076,215,36,36,13,10,23,26
0.774908161239079,0.815715478827362,0.732319854058985,1081,210,32,26,17,13,15,13
0.778101455379288,0.797943625160216,0.72199213814404,1084,207,34,34,16,15,18,19
0.815537446969379,0.836428564603989,0.758905823475887,1077,214,38,35,23,18,15,17
0.763097749648383,0.796360384163369,0.686976144422953,1079,212,27,22,16,10,11,12
0.755833002382843,0.782522025880617,0.763403461146929,1077,214,32,28,16,12,16,16
0.787544802867383,0.798744456971214,0.738448321438012,1063,228,31,30,18,15,13,15
0.763378673550437,0.800786203684525,0.656502816180236,1076,215,32,31,16,12,16,19
0.721882055141274,0.749523271454458,0.688941925218775,1093,198,47,34,22,14,25,20
0.710201533797039,0.729881421261585,0.689587096232201,1063,228,45,38,18,14,27,24
0.710513501549358,0.74068570496502,0.635930391264786,1054,237,36,35,16,13,20,22
0.771893176046531,0.795069494546056,0.694412728355838,1071,220,39,32,18,10,21,22
0.658198471008737,0.683799085849755,0.621475377283558,1053,238,32,32,11,9,21,23
0.735278771615981,0.753741852006998,0.724907317073171,1073,218,43,41,17,15,26,26
0.741707651835754,0.76236366186892,0.742994687915007,1062,229,42,36,21,18,21,18
0.747568148399502,0.784671540926917,0.671934484285082,1077,214,28,36,16,17,12,19
0.73404026035605,0.763039932439739,0.682410879779301,1076,215,37,37,17,14,20,23
0.674358104286845,0.696354781196057,0.728771097046414,1079,212,28,27,7,9,21,18
0.69223635400106,0.72008427819699,0.600091838760921,1047,244,33,32,15,11,18,21
0.757832393231265,0.791126125282792,0.719014788169464,1077,214,50,40,27,19,23,21
0.698996852871755,0.726021459466266,0.720403546033798,1048,243,20,17,7,7,13,10
0.682641107561235,0.703423116531153,0.673709579297113,1064,227,39,34,17,14,22,20
0.746302452184805,0.769454655675724,0.711021383075523,1069,222,33,35,16,14,17,21
0.783132107258178,0.825007944941321,0.678329416908028,1085,206,34,29,17,9,17,20
0.731919111816019,0.769460552645997,0.607045813586098,1083,208,30,25,13,7,17,18
0.758015936558771,0.783951675581309,0.755980861244019,1071,220,42,37,23,16,19,21
0.765840703823295,0.78975655262538,0.590673339399454,1065,226,34,35,17,12,17,23
0.75893644726341,0.785462192967603,0.629947679708826,1079,212,38,35,17,11,21,24
0.775387339530766,0.812356218372612,0.71933650541898,1061,230,36,30,21,14,15,16
0.743177163338454,0.776815283424011,0.774789029535865,1061,230,31,27,16,14,15,13
0.692170501159265,0.714625675096424,0.653187450039968,1073,218,45,40,16,10,29,30
0.737297819971871,0.775924354448697,0.666525279945708,1056,235,27,28,13,9,14,19
0.755509169240154,0.766345114822348,0.697581305808143,1063,228,42,39,19,16,23,23
0.699668164825471,0.743719876746845,0.618779207014501,1082,209,38,33,18,13,20,20
0.712454504094631,0.75257999958149,0.675602820746133,1070,221,35,35,17,14,18,21
0.64948223837608,0.695283073927018,0.609367674636662,1062,229,23,27,9,7,14,20
0.794552859821847,0.820953346962659,0.757747992308562,1073,218,27,28,16,17,11,11
0.722760975609756,0.736744195556396,0.659130007372819,1044,247,41,39,21,16,20,23
0.714115104640582,0.740595544813143,0.674080267558529,1055,236,35,26,18,12,17,14
0.719136600715548,0.748987410496533,0.708913018889266,1057,234,37,28,18,14,19,14
0.767724273480275,0.784227194307218,0.724478489184372,1073,218,34,33,17,14,17,19
0.722688999052271,0.748821318442373,0.68952331063384,1056,235,44,46,23,20,21,26
0.761366753531752,0.80358072921599,0.719482846902202,1060,231,23,31,11,11,12,20
0.719473264166002,0.738060868559657,0.654478048780488,1075,216,38,41,16,16,22,25
0.814205353679038,0.841130497324512,0.768357597816197,1076,215,37,35,21,18,16,17
0.754487804878049,0.769718614425235,0.682507370489962,1085,206,41,34,18,11,23,23
0.749955732625055,0.778410690768403,0.640928447751416,1043,248,36,34,17,11,19,23
0.757665812576133,0.794267232598997,0.682121297206233,1102,189,38,34,16,13,22,21
0.726063456408816,0.748815044076637,0.728238607270865,1083,208,34,31,14,12,20,19
0.79971226206286,0.828716255787668,0.757834389413337,1065,226,36,37,21,19,15,18
0.764690600697238,0.777195614668117,0.736586985391766,1073,218,48,36,23,17,25,19
0.712950989266779,0.743489507186002,0.723263566315099,1042,249,37,29,18,13,19,16
0.705002096915628,0.721468261253342,0.68695479777954,1077,214,42,30,14,9,28,21
0.736840309372156,0.760770352633043,0.714387664373625,1046,245,35,34,15,15,20,19
0.711805555555556,0.745035419976731,0.634408602150538,1085,206,27,31,12,10,15,21
0.756507304116866,0.78290657808035,0.699885822081017,1046,245,36,32,22,16,14,16
0.758746587807097,0.787103253987183,0.682360167654286,1052,239,35,33,19,15,16,18
0.727533382485459,0.753757843065947,0.662894952368637,1076,215,39,37,18,16,21,21
0.738915281076801,0.768636371474948,0.701832543443918,1048,243,28,25,13,10,15,15
0.782579370814665,0.813721393564805,0.743802742616034,1072,219,33,27,20,15,13,12
0.74857981623394,0.770886011916113,0.673389098490866,1083,208,42,32,20,12,22,20
0.737148913619502,0.768142414781046,0.713677321757432,1069,222,33,24,17,10,16,14
0.680363338289679,0.704492207104122,0.685278494837172,1083,208,42,32,15,12,27,20
0.752388068448195,0.794139732036324,0.688598804500703,1072,219,27,27,15,12,12,15
0.763947102182396,0.79421585635094,0.762995473871897,1071,220,33,23,17,12,16,11
0.74652501985703,0.781477394270922,0.676856000385412,1060,231,32,33,15,15,17,18
0.716544664302871,0.726989471887091,0.686235356762513,1075,216,42,39,16,13,26,26
0.645736815012401,0.661847501101367,0.639843129467832,1064,227,34,32,13,10,21,22
0.730334218680832,0.764907583857485,0.683926996261604,1089,202,36,38,14,14,22,24
0.680787163439325,0.708440076173402,0.619391770042079,1067,224,38,29,17,12,21,17
0.812330135891287,0.830870753123982,0.770438888085947,1038,253,40,33,24,19,16,14
0.786498450641877,0.803205558495643,0.764491536102827,1089,202,36,38,19,19,17,19
0.786326996853313,0.807237337129026,0.729304132154055,1057,234,37,34,22,17,15,17
0.749567129954607,0.776721645664877,0.72040708432461,1037,254,34,30,20,17,14,13
0.764948453608247,0.797403577662811,0.741884747554851,1082,209,30,30,14,12,16,18
0.765493159662489,0.792334496868506,0.745218480512598,1079,212,39,33,19,17,20,16
0.786470051687443,0.821164369763137,0.805072081575246,1078,213,26,27,13,14,13,13
0.74126525763906,0.771205909415124,0.747766084193805,1074,217,39,32,18,13,21,19
0.769993255287373,0.798539104874612,0.661680396974515,1034,257,33,33,21,17,12,16
0.748416070363745,0.788975550372563,0.755427213893668,1057,234,43,39,22,19,21,20
0.723765052838535,0.742502505519064,0.695343526608419,1063,228,39,32,17,13,22,19
0.772778323739997,0.814436086313854,0.673499867829765,1081,210,34,30,19,11,15,19
0.745811829278283,0.770742472224836,0.674220871589293,1081,210,39,37,16,14,23,23
0.743075539568345,0.770661207419453,0.741517023142323,1052,239,40,42,19,20,21,22
0.751318565400844,0.769467481598716,0.673317535545024,1080,211,27,25,11,7,16,18
0.785727451462276,0.812680632411674,0.744300575475874,1087,204,39,36,22,18,17,18
0.672292993630573,0.695499365806554,0.667520707567036,1037,254,35,34,13,14,22,20
0.750378726833199,0.769846540811536,0.727174256799494,1053,238,50,51,24,23,26,28
0.750669464428457,0.775458693897035,0.770643767060964,1049,242,40,35,22,17,18,18
0.759537049010733,0.782454387006605,0.71638689048761,1065,226,37,40,22,20,15,20
0.706443389592124,0.72955375627873,0.65170227881305,1069,222,27,29,12,11,15,18
0.727611367127496,0.775869618321381,0.651850383293682,1079,212,31,30,16,12,15,18
0.750843089078383,0.779953475967822,0.732414118347895,1074,217,33,32,17,14,16,18
0.711598052235502,0.760672006893568,0.705637599624941,1083,208,36,27,19,12,17,15
0.739624900239425,0.766858451824247,0.690803102567809,1068,223,38,33,17,12,21,21
0.72667181431045,0.75098221028407,0.707948521777146,1058,233,34,29,16,13,18,16
0.724501992031872,0.748695205977198,0.663455414012739,1050,241,36,35,15,10,21,25
0.793801215966164,0.809792734167455,0.744374120956399,1073,218,30,27,17,13,13,14
0.72364610087983,0.754828230459388,0.716439752696659,1074,217,29,24,11,6,18,18
0.718343142500446,0.739108732451037,0.66355230828915,1057,234,45,37,19,15,26,22
0.731225775193798,0.746022353595793,0.692685666151902,1060,231,43,34,17,13,26,21
0.747497455039023,0.774461843461982,0.671385819521179,1069,222,28,24,15,12,13,12
0.703368251410153,0.729303627460178,0.648228969006958,1061,230,50,51,21,16,29,35
0.724141821112006,0.752728569219133,0.67157131345689,1083,208,50,50,22,19,28,31
0.717457196690424,0.73490357650472,0.682470119521912,1057,234,39,36,17,15,22,21
0.742722728609233,0.771231563382553,0.707425852146968,1083,208,38,36,19,17,19,19
0.640187849720224,0.665116593098369,0.619764464925755,1049,242,40,31,15,8,25,23
0.694905273937532,0.7156615729496,0.684148264984227,1062,229,31,23,11,8,20,15
0.760673153296267,0.786169886051056,0.686562353492733,1033,258,32,27,18,12,14,15
0.735375792829209,0.758875699749852,0.737385365853659,1054,237,49,41,22,20,27,21
0.724460431654676,0.735238771809127,0.657064348521183,1084,207,40,40,15,12,25,28
0.758179723502304,0.788044972162638,0.670398133439237,1086,205,31,32,17,15,14,17
0.762682468564821,0.795667651430109,0.735736925515056,1078,213,33,29,15,11,18,18
0.786208732694356,0.81212095571173,0.762911307028954,1038,253,39,33,22,17,17,16
0.723373521383076,0.74753782073367,0.670589249536618,1075,216,35,37,13,12,22,25
0.708912443258926,0.72916603321729,0.704833597464342,1065,226,34,29,16,13,18,16
0.675089605734767,0.712976137310668,0.707190371691126,1079,212,31,23,12,9,19,14
0.756710646041856,0.789684501554107,0.702718380345769,1072,219,35,35,19,17,16,18
0.756776211278793,0.784431830223451,0.695895408938887,1083,208,32,26,14,10,18,16
0.7417130048709,0.76503611314399,0.786348549506444,1067,224,37,37,18,20,19,17
0.721164086180061,0.747024473417849,0.725694444444445,1064,227,39,27,16,10,23,17
0.739629919499106,0.752866790602944,0.726852450536661,1062,229,43,37,21,17,22,20
0.704716153875481,0.732471781505243,0.708845208845209,1095,196,42,37,16,15,26,22
0.708584865927278,0.735431293232096,0.685513516570524,1080,211,34,28,11,8,23,20
0.718215565796211,0.728590816287542,0.687680873454354,1060,231,31,24,10,6,21,18
0.712142623085115,0.744012754387066,0.672609561752988,1082,209,39,36,16,13,23,23
0.697728477140242,0.744438153685606,0.689818503762727,1063,228,33,36,15,16,18,20
0.726917073170732,0.748913707599443,0.660232948263373,1066,225,41,42,18,15,23,27
0.774229023351584,0.793044381699331,0.734114376489277,1063,228,34,32,21,15,13,17
0.748270019618334,0.766034689326863,0.690819322124366,1043,248,45,42,22,17,23,25
0.806478727531359,0.832022611026901,0.705039263862793,1070,221,37,33,23,17,14,16
0.77647526791146,0.792289293160161,0.708846306592534,1083,208,34,32,18,14,16,18
0.811300959232614,0.823319093989702,0.786896842732327,1093,198,40,32,21,18,19,14
0.764545274027006,0.791473944336386,0.698260027799841,1074,217,32,32,18,13,14,19
0.675669464428457,0.699228485901534,0.65715522485844,1055,236,40,34,18,15,22,19
0.71414919981518,0.737831517444579,0.722574676182923,1086,205,38,30,14,10,24,20
0.72077460235355,0.748444323310053,0.67004452471962,1077,214,37,38,16,13,21,25
0.746648562438036,0.776736365427249,0.699925275205949,1082,209,37,44,18,17,19,27
0.760643902439024,0.782121793961242,0.686251490757305,1045,246,41,43,24,20,17,23
0.744527688388308,0.772197130777758,0.72242098986285,1065,226,48,43,25,22,23,21
0.734148439420005,0.764356332582371,0.723350773430391,1090,201,39,35,23,19,16,16
0.809124305003971,0.832844125792926,0.73905188611071,1063,228,32,33,18,16,14,17
0.721011681537997,0.745913347684457,0.623381059074266,1080,211,37,29,14,7,23,22
0.746290665855883,0.794322901121448,0.73635618142744,1066,225,26,28,12,12,14,16
0.739593871946813,0.752689887172183,0.732594936708861,1060,231,33,27,14,10,19,17
0.770006221015722,0.795047451698973,0.720690179385831,1057,234,28,26,15,13,13,13
0.771852816398538,0.781844345942091,0.714228844404004,1056,235,38,35,19,16,19,19
0.709480723839496,0.73928705111732,0.643259803921569,1065,226,20,16,7,5,13,11
0.723688133571854,0.747342571724544,0.725343386398958,1084,207,43,38,17,16,26,22
0.793921266878475,0.806742642064186,0.730818623968523,1050,241,32,29,18,13,14,16
0.71640205724508,0.737429484648127,0.755559968228753,1059,232,43,32,20,16,23,16
0.730995203836931,0.763751006172489,0.716341429173101,1074,217,40,34,17,14,23,20
0.713210702341137,0.748986128969648,0.587698412698413,1067,224,26,31,12,12,14,19
0.729471004869411,0.752618940070873,0.668094105207507,1064,227,36,30,14,10,22,20
0.639196967569844,0.659747252722206,0.663812207929855,1083,208,34,33,10,11,24,22
0.74273322972235,0.762066085547445,0.66275232451703,1091,200,38,33,16,9,22,24
0.729850171026642,0.749167203140868,0.680118289353958,1087,204,33,35,12,11,21,24
0.745245641838352,0.768864498552369,0.694664031620553,1098,193,29,26,14,11,15,15
0.709892682926829,0.733341427363679,0.700763597822421,1079,212,41,33,18,15,23,18
0.664426458544106,0.709536524425967,0.622751951136749,1073,218,33,28,13,10,20,18
0.749471959998276,0.779165466672638,0.682347588717016,1054,237,37,35,21,17,16,18
0.773753280839895,0.809981912689579,0.646770586687714,1073,218,21,24,12,10,9,14
0.764190344646146,0.803725582813281,0.715694846712935,1073,218,24,29,12,13,12,16
0.738051810732223,0.757288954250747,0.656265369692333,1075,216,30,29,11,8,19,21
0.747601918465228,0.763334452760361,0.706692682926829,1067,224,40,41,17,16,23,25
0.770256647204604,0.800035531576783,0.737773408699926,1077,214,38,39,19,17,19,22
0.751045303676883,0.780985686195154,0.705991858617951,1064,227,37,32,20,16,17,16
0.792767077045274,0.809582429912987,0.691055876032123,1068,223,32,28,15,9,17,19
0.732270865335381,0.750372725716283,0.66707774269929,1059,232,31,24,14,8,17,16
0.768233634526669,0.798946401399475,0.779174249317561,1058,233,42,35,25,22,17,13
0.649170731707317,0.683421872912343,0.584231036536934,1066,225,41,32,16,9,25,23
0.727482182354387,0.74505935545589,0.68520245677889,1055,236,39,35,18,15,21,20
0.735411670663469,0.755988262267626,0.675004878048781,1059,232,40,41,23,20,17,21
0.700796812749004,0.733829605732682,0.658464614346967,1084,207,36,33,15,14,21,19
0.671937550040032,0.696382148356121,0.688748079877112,1072,219,42,31,18,10,24,21
0.740848753016895,0.768471355158684,0.718485211830536,1057,234,48,40,23,16,25,24
0.798976342129208,0.814873413216226,0.748351325240475,1065,226,35,38,19,19,16,19
0.713381347013944,0.751289229907301,0.620531528363807,1075,216,24,27,9,7,15,20
0.784250474383302,0.80442427052933,0.72150243902439,1059,232,51,41,32,22,19,19
0.811670036614023,0.827839834891755,0.744982078853047,1082,209,29,31,13,11,16,20
0.788008103797578,0.811085859946582,0.763750592697961,1093,198,37,37,16,16,21,21
0.773354480570975,0.799259045697219,0.723374295954941,1070,221,30,31,18,17,12,14
0.728560922213861,0.747270536895818,0.653426878354204,1058,233,47,43,24,18,23,25
0.723771580345286,0.742880853198235,0.630244960150023,1041,250,36,27,16,6,20,21
0.779014634146341,0.809153326353908,0.781413210445469,1075,216,41,31,23,17,18,14
0.772823173153296,0.810376483379922,0.758072362420189,1078,213,32,26,18,14,14,12
0.660478048780488,0.685145068235912,0.649407428819194,1059,232,41,33,15,8,26,25
0.72457757296467,0.75383678983348,0.669139556096078,1065,226,31,26,14,10,17,16
0.718281176746367,0.750852942277333,0.714244451200973,1083,208,27,26,11,11,16,15
0.759611215493568,0.776189718518258,0.748256820628013,1060,231,33,34,15,14,18,20
0.688739192009541,0.714948205245995,0.70787959274015,1076,215,43,36,18,16,25,20
0.753490194648976,0.776576484083399,0.728596724214254,1076,215,44,36,24,16,20,20
0.732851682278321,0.763279133929328,0.735818133756278,1055,236,38,30,16,13,22,17
0.758992747784045,0.780211117332393,0.739808153477218,1044,247,50,40,31,23,19,17
0.752611613100004,0.772248503380021,0.704502349239191,1057,234,42,37,22,15,20,22
0.772947279586974,0.798186549234204,0.729057859703021,1090,201,32,31,19,15,13,16
0.69716146473335,0.721973799820082,0.701871960185499,1080,211,39,28,16,10,23,18
0.694647201946472,0.711222458949926,0.701676067687349,1057,234,58,50,25,21,33,29
0.76526787908577,0.779936798245425,0.731615586878745,1064,227,39,37,19,15,20,22
0.708174066451044,0.736300784115631,0.689637853555379,1053,238,38,30,17,14,21,16
0.697589853057982,0.741666397120122,0.620429252782194,1078,213,32,33,17,13,15,20
0.709290841643783,0.749797506081947,0.689058234758872,1052,239,33,35,15,14,18,21
0.669334532374101,0.692956345480739,0.667970882620564,1069,222,40,35,15,11,25,24
0.718027752502275,0.73885332666096,0.668778801843318,1073,218,35,31,14,11,21,20
0.737743311219655,0.764501486367947,0.667379435850773,1054,237,44,35,23,16,21,19
0.737638999205719,0.761620825415199,0.736242018850715,1060,231,32,26,16,12,16,14
0.684323360793949,0.70496330028292,0.719060419866872,1051,240,33,31,13,12,20,19
0.711387407065149,0.741530589745134,0.674927591671676,1089,202,38,29,15,10,23,19
0.718921520439092,0.745458369108554,0.69933598937583,1070,221,39,36,17,12,22,24
0.755561874431301,0.785757090992735,0.735586597407459,1084,207,35,34,16,13,19,21
0.713776846516501,0.726562495047733,0.705674801528962,1046,245,46,38,17,15,29,23
0.703004439846545,0.734275074302082,0.730782447792757,1078,213,37,30,16,16,21,14
0.726171519563239,0.758346937960901,0.675955823856989,1077,214,35,34,16,14,19,20
0.741264786169245,0.759617595750922,0.706463036741921,1051,240,35,36,15,14,20,22
0.717618664521319,0.741276479993123,0.720946341463415,1074,217,48,41,19,19,29,22
0.76831797235023,0.796041851073007,0.708522323624242,1054,237,31,29,14,10,17,19
0.719082719082719,0.742133998187364,0.695403960109842,1063,228,37,33,18,16,19,17
0.749491163621922,0.780286413098628,0.673761417791898,1074,217,32,32,17,10,15,22
0.772609977881543,0.786568496178748,0.690900350639068,1070,221,39,28,20,11,19,17
0.668648232724385,0.712550982318994,0.70412000904875,1073,218,32,28,16,12,16,16
0.737300159872102,0.765661693592298,0.633973201159323,1072,219,40,38,19,14,21,24
0.712313918196271,0.752378047836608,0.664552720413026,1063,228,33,32,18,15,15,17
0.789578665500847,0.825896094020824,0.720986460348162,1069,222,29,22,16,7,13,15
0.774403348037553,0.82684942372325,0.672190499834492,1094,197,28,19,15,8,13,11
0.713317073170732,0.728785969222599,0.62281976744186,1079,212,41,43,18,13,23,30
0.74867206115965,0.777359731144154,0.686298598063304,1062,229,32,33,15,14,17,19
0.766776873053172,0.803006195088199,0.71085308056872,1073,218,29,25,18,12,11,13
0.729288192458729,0.741372133401654,0.651426051161423,1061,230,42,38,17,13,25,25
0.787954727710141,0.8181116475185,0.779177422557585,1045,246,44,32,27,21,17,11
0.741580487804878,0.761757501454261,0.716797697599326,1067,224,41,34,20,17,21,17
0.729697900665643,0.763470225985185,0.673314829500396,1074,217,31,30,18,13,13,17
0.742688005989985,0.771622669794403,0.722259925347811,1071,220,34,28,17,12,17,16
0.729039778216491,0.756339238107967,0.698744042891184,1076,215,38,32,18,13,20,19
0.729192852068419,0.743224077141934,0.669098518267164,1078,213,29,28,12,9,17,19
0.72847721822542,0.748045187948437,0.705227198277879,1064,227,40,34,17,13,23,21
0.790210484511517,0.824147510704197,0.704982817869416,1046,245,32,30,21,17,11,13
0.762898089171974,0.789163983254533,0.662765216678955,1058,233,35,39,20,17,15,22
0.780584192439863,0.801774935485548,0.659180145335209,1092,199,30,27,14,7,16,20
0.768334943504012,0.788175440235567,0.75406992260475,1060,231,38,42,20,21,18,21
0.735446890719545,0.75280407550829,0.703966826538769,1071,220,44,40,20,18,24,22
0.712357916997092,0.745866421760625,0.611815156169995,1058,233,30,31,14,10,16,21
0.73300487804878,0.750762591070861,0.762745730738682,1076,215,41,32,17,14,24,18
0.762018592297477,0.786222622360617,0.725773932036796,1056,235,36,38,20,18,16,20
0.753736322391246,0.779995862843014,0.735691537761601,1080,211,42,35,21,17,21,18
0.737497770643838,0.763359225562971,0.723081534772182,1073,218,45,40,22,17,23,23
0.668699839486356,0.695412293177162,0.631155075939249,1066,225,45,40,16,11,29,29
0.777700309871625,0.802426305553205,0.723263566315099,1059,232,36,29,20,13,16,16
0.767323351002787,0.784418035523053,0.721383327677864,1084,207,29,28,12,8,17,20
0.779603806994245,0.799952077760369,0.748440391223896,1069,222,36,30,17,15,19,15
0.736398849048251,0.756876659452124,0.705112881806109,1060,231,36,36,15,13,21,23
0.801837096060204,0.835064671610127,0.757188498402556,1063,228,36,39,21,22,15,17
0.730614575059571,0.762657826913251,0.693946620417209,1062,229,32,33,16,13,16,20
0.713340467273051,0.734855705948766,0.628301823545186,1077,214,45,48,16,14,29,34
0.732585365853658,0.764508381478121,0.690500693073466,1058,233,41,38,21,14,20,24
0.762087966640191,0.797459416386165,0.728687359965025,1066,225,32,29,18,12,14,17
0.656232939035487,0.683169535459493,0.70204162425065,1054,237,35,28,15,10,20,18
0.766759185831351,0.801264834705268,0.696902201740911,1094,197,30,31,17,15,13,16
0.754976667990468,0.771846063701696,0.67326942653546,1080,211,32,28,13,10,19,18
0.758680799288689,0.775235602911509,0.756578176277543,1072,219,34,27,17,13,17,14
0.74331797235023,0.780601245977203,0.685727086533538,1066,225,31,31,15,12,16,19
0.752167943344414,0.771513893459815,0.657533084492704,1059,232,33,28,14,9,19,19
0.73299131645777,0.769958861686464,0.699424399831532,1056,235,39,34,22,17,17,17
0.714369723190658,0.737265212277678,0.679500396510706,1062,229,38,30,16,13,22,17
0.708325059571088,0.74620689705519,0.61173835125448,1073,218,32,31,13,8,19,23
0.763581223628692,0.794525691356596,0.73234114191561,1085,206,27,22,11,6,16,16
0.813120532168388,0.834690792731964,0.752585765488991,1079,212,32,31,19,15,13,16
0.753956834532374,0.783819379800112,0.678180854651443,1078,213,40,33,18,11,22,22
0.736546341463415,0.759264286106439,0.679437804338203,1063,228,41,36,21,14,20,22
0.750915350565605,0.776100914762125,0.697474833163669,1056,235,29,28,12,10,17,18
0.79852748423036,0.82120623586513,0.752663414634146,1053,238,39,41,26,24,13,17
0.700250227479527,0.727314737296933,0.641866064336775,1038,253,35,32,18,12,17,20
0.687476372495484,0.719388173077518,0.681312219095224,1074,217,38,38,13,11,25,27
0.722695957990076,0.747737310626518,0.750079302141158,1079,212,33,30,14,13,19,17
0.761958635022794,0.773338132988601,0.742604878048781,1074,217,48,41,23,17,25,24
0.769517743403094,0.782881828250554,0.741594465278676,1054,237,35,37,18,21,17,16
0.777198241406875,0.793234971838889,0.745586897179254,1062,229,40,35,23,20,17,15
0.767640846588215,0.807931949802094,0.664595909963031,1088,203,37,34,19,15,18,19
0.67019512195122,0.690118745092878,0.645971419884463,1060,231,41,26,14,6,27,20
0.691933159023867,0.708502388058535,0.699626160373,1071,220,48,38,18,15,30,23
0.743636564851704,0.787743582242322,0.669067921199647,1070,221,36,38,20,17,16,21
0.784747314159079,0.80696084001341,0.688081483733658,1051,240,33,26,20,12,13,14
0.706449907480835,0.734789827686375,0.716834385687977,1084,207,30,24,10,8,20,16
0.762869704236611,0.775817524994526,0.700838398206819,1060,231,40,37,22,17,18,20
0.715834146341463,0.743958950983734,0.719005914467698,1062,229,41,35,19,17,22,18
0.648066424021838,0.669943130844379,0.629083665338645,1080,211,35,36,9,7,26,29
0.783883768561188,0.811375843009384,0.661456733230927,1079,212,31,31,16,12,15,19
0.749170557876628,0.782487346185558,0.757040450588838,1083,208,39,31,18,13,21,18
0.786111470321997,0.810519177983764,0.734344598054275,1090,201,37,31,22,15,15,16
0.728637090327738,0.755934245240222,0.673170095408468,1078,213,40,43,20,17,20,26
0.719914802981896,0.745332698564187,0.73886882009493,1082,209,39,38,16,14,23,24
0.710647579257803,0.727694332154054,0.66205035971223,1044,247,39,40,17,17,22,23
0.679928741092637,0.709478090900282,0.677921049655016,1067,224,28,28,11,10,17,18
0.775175163983303,0.799237633716634,0.751831210191083,1069,222,43,35,22,17,21,18
0.78944967008283,0.80950838670942,0.725440751756541,1069,222,34,37,19,15,15,22
0.712091422954043,0.739957895421157,0.622268239037859,1058,233,39,34,22,14,17,20
0.753287370103917,0.786536405529017,0.685680682152308,1057,234,40,38,21,14,19,24
0.808040660981837,0.847176785486759,0.819757910268321,1075,216,33,29,23,20,10,9
0.763810973523979,0.789194603627348,0.608575609756097,1046,245,47,41,28,17,19,24
0.776930673989498,0.794324359916603,0.740232974910394,1089,202,33,31,16,12,17,19
0.812582606397039,0.823939032183662,0.801246579507449,1088,203,30,26,17,14,13,12
0.724237943585077,0.76248519010209,0.635447100486941,1047,244,35,36,17,15,18,21
0.736487383798141,0.763400184132087,0.690322429687865,1069,222,36,34,15,14,21,20
0.732040491355778,0.758637183470085,0.69448734147597,1051,240,35,34,19,13,16,21
0.738199922410449,0.777843953615233,0.665173194584959,1090,201,37,33,17,13,20,20
0.715849821112979,0.74921516580983,0.62059787059787,1062,229,37,33,17,13,20,20
0.740595611285267,0.749510439377552,0.701606425702811,1068,223,44,46,22,20,22,26
0.776571491810536,0.796086689434212,0.674471262706557,1068,223,36,33,19,13,17,20
0.74548414843942,0.794356171750718,0.715733071271468,1075,216,39,34,24,20,15,14
0.763859587435537,0.780531003900399,0.707527429023866,1070,221,27,28,11,11,16,17
0.75920726285741,0.77798705968978,0.697664316918189,1055,236,34,32,18,13,16,19
0.796513401197148,0.826331641153684,0.704993591639554,1061,230,42,49,23,22,19,27
0.736432561851556,0.755232250647476,0.697819831783975,1068,223,38,36,17,14,21,22
0.747921274678463,0.778728248814201,0.723864806130619,1048,243,39,42,20,19,19,23
0.726719995311767,0.77910406172398,0.728625592417062,1099,192,27,25,13,13,14,12
0.808895056833201,0.846684712344263,0.799863180297963,1054,237,30,26,19,15,11,11
0.671544539191598,0.705154747634908,0.624530795664816,1077,214,33,30,12,6,21,24
0.716970559075822,0.733487322819471,0.630491673275178,1073,218,37,30,14,9,23,21
0.752301903497123,0.774981745216106,0.705161484234111,1074,217,36,29,16,10,20,19
0.695217896969282,0.724961201724794,0.697966984500357,1063,228,47,38,20,15,27,23
0.753018049695265,0.779184182610981,0.632817857632698,1075,216,27,23,13,10,14,13
0.782006557627054,0.803927101317192,0.723362147406733,1072,219,42,35,25,18,17,17
0.728469468675654,0.747248142641296,0.665424987199181,1085,206,30,31,10,8,20,23
0.737783648726141,0.762420815727087,0.720334644056689,1071,220,39,39,17,18,22,21
0.741730670762929,0.776505599484513,0.674994344531162,1054,237,31,28,16,13,15,15
0.695109190172885,0.73732694872719,0.651059946651692,1086,205,35,34,16,12,19,22
0.718585077343039,0.739818101444788,0.744533965244866,1059,232,35,25,16,11,19,14
0.736123748862602,0.760942157787627,0.689561982310824,1072,219,35,34,14,10,21,24
0.718603364320496,0.741191831713465,0.662377688693478,1038,253,36,37,12,11,24,26
0.732364475774424,0.753727113161521,0.635871723590151,1067,224,32,32,13,8,19,24
0.748305277525023,0.783006894115441,0.691333030027298,1072,219,35,35,20,17,15,18
0.714467109035799,0.734013154262885,0.710656734569778,1064,227,39,26,21,13,18,13
0.741135520547285,0.760535091268301,0.716009071533964,1050,241,33,29,14,10,19,19
0.719470046082949,0.756760419377033,0.665145636373572,1085,206,31,29,16,11,15,18
0.652575039494471,0.678175800637998,0.627022494080505,1079,212,25,24,8,6,17,18
0.755539031854821,0.781422766558026,0.748757599788528,1049,242,37,30,18,13,19,17
0.773234619480626,0.795279869022593,0.732677434030937,1059,232,39,35,21,15,18,20
0.729723502304148,0.766184174973776,0.637035386092443,1089,202,31,23,14,7,17,16
0.697107960129159,0.726389973343507,0.650615377415883,1055,236,34,34,17,14,17,20
0.725435227854583,0.760593439280941,0.647221159626209,1020,271,31,29,16,9,15,20
0.725836938715504,0.751309279485785,0.634783089862771,1062,229,38,36,17,11,21,25
0.725962815405047,0.754080147632714,0.703417818740399,1069,222,36,31,16,13,20,18
0.741107114308553,0.771925946493687,0.693960877907249,1061,230,40,34,20,13,20,21
0.700539568345324,0.719522932611542,0.660812306330234,1066,225,40,36,14,12,26,24
0.765320746132848,0.793745957403874,0.704437400950872,1060,231,35,29,19,12,16,17
0.698745519713262,0.730841550290758,0.720948616600791,1057,234,31,26,12,8,19,18
0.677068345323741,0.697810235074051,0.604162529785544,1072,219,40,32,15,9,25,23
0.784537406415651,0.807002113485792,0.716664845073501,1070,221,29,29,15,15,14,14
0.720285261489699,0.776104753203507,0.680488004809006,1087,204,29,29,12,10,17,19
0.797370021283065,0.828309756064073,0.740301003344482,1091,200,26,26,15,13,11,13
0.780646278340745,0.806488691939345,0.738619596699273,1057,234,44,29,23,13,21,16
0.766809756097561,0.795827029460932,0.690647482014388,1065,226,41,40,24,22,17,18
0.794277028813111,0.820553801364867,0.692170901773597,1069,222,30,34,17,15,13,19
0.741431210234658,0.762896953136955,0.70138015174044,1079,212,47,42,22,16,25,26
0.817597922223782,0.820460078719234,0.772204599524187,1067,224,34,30,17,13,17,17
0.734805427547363,0.758162590160858,0.639048848292295,1084,207,31,32,12,9,19,23
0.670488066505766,0.687399079152412,0.632593924860112,1076,215,48,40,17,13,31,27
0.80311868542453,0.82273064259718,0.795302099334357,1077,214,42,31,22,14,20,17
0.696565059144677,0.717361563419294,0.685429936305733,1081,210,35,35,14,11,21,24
0.762879696243006,0.774027648791399,0.72329401163267,1078,213,40,39,17,17,23,22
0.811569201747419,0.823092504801569,0.73064415790069,1070,221,32,28,18,14,14,14
0.735638204993889,0.758881095740927,0.704540681312219,1053,238,46,38,21,15,25,23
0.760452358387403,0.781354396231793,0.745320308019988,1041,250,44,39,22,18,22,21
0.773487382183034,0.787971917727666,0.711648745519713,1075,216,26,31,10,12,16,19
0.721364567332309,0.74095645358219,0.686099021947681,1067,224,31,34,13,14,18,20
0.708706022659511,0.727846650553907,0.65345723421263,1054,237,43,40,19,14,24,26
0.741716626698641,0.783383771874751,0.619371687826452,1055,236,40,42,23,19,17,23
0.734920401562566,0.759993310885627,0.704440919904837,1063,228,38,30,17,13,21,17
0.742562724014337,0.776380276428994,0.685330261136713,1082,209,31,31,14,12,17,19
0.751686419200954,0.804990048005418,0.695557998189577,1046,245,43,37,26,19,17,18
0.746576433121019,0.772265475984351,0.71068091152522,1057,234,35,29,15,10,20,19
0.710253658536585,0.740269241829417,0.71861933704039,1044,247,41,37,25,21,16,16
0.698366816013875,0.717365620876411,0.660746488879174,1035,256,33,29,16,15,17,14
0.74183925387464,0.777438837162858,0.723884514435696,1069,222,23,21,14,11,9,10
0.816758747697974,0.837526355646936,0.768052869116699,1096,195,24,22,15,9,9,13
0.768910366388349,0.789777564220821,0.732612435487835,1063,228,42,39,22,19,20,20
0.74089706320811,0.757536251939682,0.67507420988301,1058,233,43,46,14,14,29,32
0.708917473623356,0.72828379465154,0.62611344882234,1078,213,33,29,14,5,19,24
0.786710507298743,0.805877566448498,0.700884039119333,1042,249,33,33,19,15,14,18
0.705799045915325,0.729230191636005,0.650682450722483,1042,249,43,42,23,16,20,26
0.744018336314848,0.7754387370907,0.701471758154336,1068,223,43,34,20,13,23,21
0.781949499545041,0.800497822587481,0.724247915011914,1084,207,35,32,17,13,18,19
0.76192662827641,0.793724072430256,0.691855023632365,1064,227,32,34,19,16,13,18
0.709833242323686,0.726958279119595,0.70078150591979,1066,225,38,34,13,12,25,22
0.789757672110613,0.813891531669064,0.707075670363611,1066,225,33,34,17,10,16,24
0.785955766192733,0.813174382038783,0.714533581070004,1091,200,25,29,13,12,12,17
0.738991665462254,0.763901559801809,0.627179080824089,1065,226,33,29,14,12,19,17
0.753374885983582,0.785654693650667,0.602308602999211,1073,218,26,24,10,5,16,19
0.764517073170732,0.786063790579454,0.701865332120109,1068,223,41,35,20,11,21,24
0.753079566481628,0.786661922830528,0.6677727784027,1051,240,30,21,13,6,17,15
0.717260345730749,0.742107520964921,0.695635700827394,1049,242,46,39,22,17,24,22
0.747202238209432,0.778532157269784,0.689647041302621,1077,214,40,32,20,13,20,19
0.697872714486639,0.714796416734829,0.681048144707361,1072,219,27,29,9,9,18,20
0.724939564867043,0.748713815584741,0.705068614431164,1058,233,50,36,23,15,27,21
0.75263766440237,0.789830569026013,0.675923650364545,1075,216,33,39,18,16,15,23
0.732568206280126,0.761712228940527,0.670430107526882,1069,222,34,31,19,13,15,18
0.81647465437788,0.831809726058077,0.822247295651551,1074,217,31,22,18,12,13,10
0.779915514592934,0.805873992485456,0.756988396624473,1056,235,31,27,16,12,15,15
0.697421425409473,0.731768938655281,0.647698096502877,1062,229,36,36,20,15,16,21
0.790126382306477,0.827632709534443,0.690741866828823,1083,208,25,26,14,10,11,16
0.698601000909918,0.727179314300769,0.635605316112125,1077,214,35,34,13,10,22,24
0.716487455197133,0.747154801327907,0.634991795593061,1072,219,31,27,13,8,18,19
0.802102700309872,0.820212691908297,0.752655877680699,1066,225,36,32,17,14,19,18
0.770321951219512,0.792886177803298,0.711863057324841,1059,232,41,35,20,14,21,21
0.692322097378277,0.718175822288451,0.748930855315747,1086,205,45,40,15,14,30,26
0.741251118067978,0.753290099495503,0.713162118780096,1054,237,43,45,19,19,24,26
0.746051581467636,0.766857445836079,0.746069072020216,1041,250,38,34,21,20,17,14
0.793455575432319,0.809195516490199,0.738738738738739,1088,203,43,33,23,16,20,17
0.676720979352558,0.695015514818385,0.665979944400318,1083,208,37,32,10,10,27,22
0.769942452412572,0.790054958448099,0.723173756376059,1077,214,36,34,14,13,22,21
0.714370731707317,0.74048093458923,0.705538287058428,1061,230,41,38,20,17,21,21
0.780760707231295,0.801356012025104,0.757403466099118,1055,236,33,26,18,14,15,12
0.640200116643581,0.662018216656462,0.683506951736884,1067,224,44,38,15,11,29,27
0.83015368309486,0.850796035167885,0.790238660784979,1057,234,33,28,22,16,11,12
0.822055811571941,0.837202895206938,0.756645175885081,1066,225,31,28,18,14,13,14
0.707290718835305,0.726816896239503,0.607043886438186,1052,239,35,28,13,6,22,22
0.792738911159964,0.828061292689391,0.757609190172884,1092,199,37,35,23,19,14,16
0.799079934364744,0.830484659034444,0.720288712110821,1079,212,27,23,17,12,10,11
0.715079444891392,0.725474157298263,0.704261702444842,1052,239,48,43,19,14,29,29
0.769264588329336,0.784903710486949,0.743489309866846,1057,234,40,38,20,20,20,18
0.801663624877159,0.826697341020126,0.809284028324154,1044,247,34,20,19,12,15,8
0.763849174577757,0.78299531189619,0.754392971246006,1056,235,42,39,21,18,21,21
0.741364359011418,0.751540480072007,0.720080332258593,1055,236,33,29,15,12,18,17
0.760238780778396,0.797827278724174,0.668524730334122,1068,223,32,24,18,11,14,13
0.720796228391828,0.736948072686256,0.704446171294157,1069,222,46,38,17,14,29,24
0.716147082334133,0.743490882328097,0.664705375231691,1066,225,40,37,20,14,20,23
0.734825891544504,0.755598961575924,0.697145417306708,1071,220,38,31,18,15,20,16
0.731743943606037,0.770718779290066,0.687924871073605,1053,238,32,27,14,10,18,17
0.739322450805009,0.756131837826643,0.719588572529749,1053,238,43,33,21,12,22,21
0.738416265382558,0.764147764547633,0.744191559981034,1051,240,45,37,21,17,24,20
0.812461977631148,0.839548208839827,0.735850683219104,1049,242,34,37,22,17,12,20
0.732448780487805,0.762585148827928,0.665847723337545,1071,220,41,34,18,13,23,21
0.724967732327244,0.753178696550581,0.684331797235023,1085,206,32,31,8,7,24,24
0.76610343061956,0.807771206148373,0.586152248756763,1074,217,31,29,17,13,14,16
0.710681454836131,0.73317717772073,0.647406733393995,1069,222,40,35,18,13,22,22
0.750038125738686,0.774079944410829,0.703934898301378,1069,222,42,44,20,16,22,28
0.731187069422364,0.747813318808161,0.640301003344482,1073,218,33,26,13,8,20,18
0.758632342098796,0.780672501667904,0.742857142857143,1075,216,39,35,19,17,20,18
0.741179725542275,0.768440416281045,0.666916466826539,1092,199,36,40,20,17,16,23
0.811246525019857,0.827612762263055,0.809075706901794,1065,226,32,26,20,18,12,8
0.674549502247238,0.692224455289287,0.67358872069512,1080,211,38,29,12,11,26,18
0.759492682926829,0.792489644560832,0.603630531457316,1063,228,41,44,22,17,19,27
0.623601119104716,0.641766704846,0.563567315329627,1065,226,40,32,12,8,28,24
0.750806691818904,0.775083323037909,0.674233022239873,1061,230,32,32,13,9,19,23
0.748051528991263,0.768941777177898,0.670617141205377,1068,223,32,33,13,11,19,22
0.820489731437599,0.845650244854935,0.739456178850638,1072,219,25,23,17,13,8,10
0.723243951518555,0.744247393976645,0.681986799633858,1045,246,34,33,13,12,21,21
0.824881141045959,0.847058216042631,0.746885075687196,1078,213,29,29,18,13,11,16
0.739873170731707,0.757606012045166,0.710099781572677,1059,232,41,32,18,14,23,18
0.68610715979137,0.721317558198608,0.594422310756972,1070,221,37,36,17,12,20,24
0.712645628322588,0.742270997554166,0.731627172195893,1068,223,28,25,9,8,19,17
0.700940681717574,0.720156154054308,0.701928026580561,1073,218,36,34,12,13,24,21
0.681669010782935,0.704034647127126,0.637152303404558,1067,224,27,29,13,12,14,17
0.747111657722123,0.772135736537518,0.620660522273425,1038,253,43,31,23,10,20,21
0.759743700920172,0.777646727185903,0.725600486470052,1086,205,33,26,15,12,18,14
0.741725682902153,0.761255279231395,0.695281473391581,1064,227,33,32,15,14,18,18
0.777336585365854,0.794657741252882,0.746415770609319,1065,226,41,31,18,15,23,16
0.731798784430364,0.756520998344337,0.663683373110581,1062,229,37,34,16,11,21,23
0.73494715410641,0.756339693489399,0.723026171903477,1055,236,54,44,26,21,28,23
0.745573598742797,0.76652628782732,0.726107317073171,1060,231,46,41,21,19,25,22
0.691652330629966,0.713115629830167,0.643623724114756,1053,238,39,38,17,14,22,24
0.746352259686322,0.782106534757552,0.746267390566678,1062,229,29,28,16,14,13,14
0.709529528384613,0.732043345640966,0.692868292682927,1057,234,42,41,19,17,23,24
0.747830898627711,0.782620189859383,0.713530465949821,1056,235,36,31,15,12,21,19
0.628120604781997,0.659785186947365,0.659652448657188,1051,240,27,25,10,8,17,17
0.762173528109783,0.795056125114455,0.727634051163463,1067,224,36,33,19,14,17,19
0.727552911763438,0.760006441127598,0.660457208101668,1078,213,37,32,18,12,19,20
0.798479781088477,0.808077172041277,0.646080760095012,1073,218,26,28,13,9,13,19
0.675360448922749,0.692249163043265,0.669246440122653,1057,234,39,38,13,14,26,24
0.751937984496124,0.778162378964147,0.627633593351316,1058,233,43,44,21,13,22,31
0.770433653077538,0.798864760074425,0.751582558654272,1062,229,40,36,23,20,17,16
0.701149080735412,0.726188680325817,0.659790548598688,1077,214,40,43,17,17,23,26
0.770030987162461,0.797269601386528,0.767286409915892,1071,220,36,36,20,20,16,16
0.80228604050834,0.827662650320265,0.741845878136201,1070,221,32,31,16,16,16,15
0.706749530278942,0.739490543802859,0.63510900140647,1077,214,33,27,13,7,20,20
0.73404603915786,0.748948701109916,0.664720942140297,1054,237,39,31,16,11,23,20
0.730903093721565,0.758953244251082,0.653927723108246,1072,219,35,28,17,11,18,17
0.744601060390534,0.772008667548509,0.699143619261547,1048,243,37,34,16,15,21,19
0.747150101033208,0.768335192126879,0.708211598052236,1075,216,42,36,21,17,21,19
0.750327680838863,0.789759555225639,0.747324628776242,1089,202,39,31,22,16,17,15
0.776236100079428,0.790849445206055,0.705376344086021,1060,231,32,31,17,11,15,20
0.77456839309429,0.799305506345437,0.693459963603275,1043,248,36,35,22,18,14,17
0.733563149480415,0.751561346993892,0.600299760191846,1072,219,40,40,15,9,25,31
0.722214054689797,0.737929260527291,0.710598939832778,1081,210,38,29,15,9,23,20
0.702239862850328,0.724636391863478,0.675024390243902,1075,216,43,41,15,12,28,29
0.750861091275675,0.772653965488605,0.696701546860783,1077,214,38,35,21,17,17,18
0.797759326660601,0.8240818292032,0.727536735504369,1060,231,35,32,21,17,14,15
0.747591926458833,0.777089213170218,0.62826420890937,1053,238,40,31,20,10,20,21
0.69626216077829,0.732027765256824,0.625173749007149,1067,224,31,32,9,8,22,24
0.718813310918574,0.747306291965423,0.651676907322068,1055,236,37,31,17,12,20,19
0.720417784734645,0.742154360919677,0.690809790689695,1068,223,43,42,20,16,23,26
0.733975387907972,0.752527851744651,0.66642685851319,1066,225,45,40,22,16,23,24
0.710369632580788,0.74387266397856,0.713833276778645,1082,209,36,28,13,9,23,19
0.747920168972801,0.783882245408227,0.735655441537794,1044,247,37,33,19,18,18,15
0.686363636363636,0.701426571463749,0.647706707386042,1063,228,26,28,9,6,17,22
0.727296122612376,0.751397430733624,0.662534121929026,1085,206,42,35,19,12,23,23
0.70931899641577,0.729948797100943,0.721085436302828,1070,221,31,26,13,9,18,17
0.732977677944686,0.759471366869555,0.676710246275464,1072,219,34,26,17,10,17,16
0.753071253071253,0.780812239187992,0.781571654790182,1063,228,37,28,18,12,19,16
0.782278066357808,0.806344647721352,0.741461853558628,1078,213,34,31,16,13,18,18
0.715569636622268,0.752625017749649,0.6991007804547,1061,230,37,28,21,12,16,16
0.767574147853032,0.788254740374727,0.72931387608807,1043,248,36,31,20,14,16,17
0.696682926829268,0.73327651240926,0.688911022576361,1050,241,41,36,23,19,18,17
0.727599429284823,0.748842795774501,0.697423838270392,1066,225,45,34,19,13,26,21
0.762886597938144,0.790007396781409,0.666219290263876,1063,228,30,35,17,14,13,21
0.751044482673875,0.769433124253881,0.727578574590527,1064,227,39,36,20,17,19,19
0.793999741368162,0.836303935332445,0.766428760243193,1065,226,37,30,23,15,14,15
0.735735643483247,0.772790414690238,0.669561194818927,1078,213,39,30,19,11,20,19
0.734234234234234,0.752837749748358,0.69918065547562,1067,224,37,40,16,16,21,24
0.764733061704541,0.786998609392875,0.732989377135102,1072,219,38,34,19,14,19,20
0.716013851841452,0.751027270779451,0.699215647339158,1055,236,34,32,13,12,21,20
0.785063414634146,0.808903215713702,0.727737809752198,1052,239,41,40,25,20,16,20
0.751354643592221,0.786529262197511,0.73855554118712,1078,213,38,37,19,15,19,22
0.765656593256462,0.815676868969513,0.685464654487689,1074,217,29,32,19,18,10,14
0.725504994036971,0.747227649159061,0.670281716505218,1059,232,43,34,18,12,25,22
0.806427440334804,0.827059660182295,0.741471571906354,1052,239,28,26,15,13,13,13
0.754183266932271,0.779138999057468,0.76739336492891,1081,210,36,25,18,12,18,13
0.712391193036354,0.743807779955376,0.64749408050513,1096,195,31,24,13,10,18,14
0.721205535857257,0.751075966390041,0.711780575539569,1079,212,42,40,19,16,23,24
0.751974723538705,0.795226063522203,0.688972074976775,1063,228,25,29,12,12,13,17
0.778333498808578,0.799872880364393,0.746338965693804,1072,219,32,31,18,17,14,14
0.658037388654477,0.725852329552648,0.684504620674833,1086,205,27,22,11,5,16,17
0.70089756097561,0.727509464367563,0.622875166002656,1048,243,41,36,18,13,23,23
0.666116804717114,0.691895046221636,0.617137548499918,1067,224,34,29,11,8,23,21
0.764012738853503,0.797491115365158,0.769137224782386,1065,226,35,31,16,14,19,17
0.750400962309543,0.781886104716168,0.72201239008793,1069,222,44,40,25,19,19,21
0.766835947975329,0.795319229367804,0.744281473720971,1023,268,48,46,31,26,17,20
0.728390243902439,0.752778796830023,0.707859703020993,1059,232,41,31,19,13,22,18
0.801536098310292,0.826836419873838,0.723536431278956,1058,233,31,34,19,17,12,17
0.736474670747035,0.766622216973549,0.683143767060965,1084,207,29,35,14,15,15,20
0.707146986558751,0.732716471120265,0.643778348543636,1082,209,33,29,14,9,19,20
0.693952247383184,0.714677977263357,0.626958433253397,1059,232,47,40,20,14,27,26
0.79294674859191,0.824864419236148,0.800089605734767,1073,218,31,31,18,17,13,14
0.739308684122291,0.757420982552764,0.702991379900116,1068,223,53,47,22,19,31,28
0.715214017845597,0.747258356784952,0.678705133604755,1074,217,37,34,16,14,21,20
0.782001252589488,0.802041013408287,0.706982076840283,1048,243,33,34,19,16,14,18
0.689082315503767,0.717130206805623,0.65614591593973,1060,231,34,30,14,12,20,18
0.749231998033915,0.768571600272657,0.742677931387609,1066,225,39,31,18,11,21,20
0.66535941223193,0.686654639013537,0.58162833729844,1053,238,32,30,11,8,21,22
0.767180581910183,0.795758025551024,0.739849022074803,1062,229,51,42,28,21,23,21
0.773426511954993,0.799994339597264,0.762907787424362,1073,218,27,24,15,13,12,11
0.742755795363709,0.763344942400135,0.720711725550435,1066,225,40,31,20,15,20,16
0.75529756097561,0.785477313575192,0.704206602768903,1041,250,41,39,24,20,17,19
0.733713029576339,0.762805064800952,0.721512789768186,1056,235,40,40,18,13,22,27
0.696519563239308,0.722073798571635,0.677782183452286,1068,223,35,30,17,12,18,18
0.733839429491603,0.755037805181761,0.679951219512195,1083,208,49,41,27,18,22,23
0.706053911834789,0.729283695693069,0.731650957737914,1064,227,32,26,13,12,19,14
0.742944802624138,0.774939128290283,0.723904893449092,1067,224,28,24,13,10,15,14
0.689993446383223,0.718567813269742,0.667975805435376,1060,231,39,38,15,16,24,22
0.765199930155404,0.796760343543768,0.731095123900879,1058,233,46,40,26,21,20,19
0.783470636411813,0.825606964287369,0.708023581135092,1089,202,33,40,19,18,14,22
0.77740419845683,0.793438414614929,0.719477644975653,1065,226,37,36,19,17,18,19
0.751903251387787,0.791951954794461,0.687443827650013,1071,220,30,30,18,13,12,17
0.729186793800143,0.75324654842749,0.746760822081017,1043,248,38,32,18,15,20,17
0.796743517821714,0.829382739378411,0.805787959274015,1068,223,47,36,27,22,20,14
0.736632780453005,0.758736347064469,0.704924745462594,1074,217,45,36,23,17,22,19
0.71199393615124,0.728366605927771,0.646560836917693,1056,235,45,44,20,15,25,29
0.683083631484794,0.713304807356453,0.611879980174616,1067,224,43,42,16,16,27,26
0.809434146341463,0.829789538133909,0.794608735213831,1065,226,41,35,24,19,17,16
0.708982823669579,0.731405518694843,0.652310732745515,1080,211,32,26,13,8,19,18
0.673922812582606,0.727123495463601,0.641408114558473,1057,234,30,34,14,14,16,20
0.671857913537946,0.698109416020425,0.691718822195153,1061,230,44,38,21,18,23,20
0.715367328936867,0.731986515947499,0.689296952454847,1054,237,38,37,16,15,22,22
0.736160156946674,0.759025276906221,0.661412609736632,1065,226,45,38,19,11,26,27
0.688660145586897,0.713667581962507,0.687770403662788,1076,215,35,38,14,15,21,23
0.729917267147051,0.762002867916397,0.680623800832982,1072,219,42,34,19,11,23,23
0.769899609358592,0.788864776845405,0.726614021086235,1069,222,38,38,19,15,19,23
0.760181854516387,0.783752449127017,0.732716673893145,1088,203,40,33,15,13,25,20
0.762582606397039,0.778595665304487,0.665491030708422,1073,218,30,26,14,9,16,17
0.773341523341523,0.786539975645475,0.761890623232666,1065,226,37,28,20,14,17,14
0.765615607410241,0.817576645380994,0.64435631054331,1048,243,29,34,18,13,11,21
0.777624167946749,0.804729330359317,0.730602437880919,1089,202,31,27,16,12,15,15
0.723388234397041,0.748937674757791,0.725705186533212,1058,233,42,35,17,14,25,21
0.712639109697933,0.748913691393137,0.739360296061327,1054,237,33,30,12,10,21,20
0.720234146341463,0.747551759373101,0.688303842057836,1081,210,41,39,17,15,24,24
0.766928117553614,0.798877853168307,0.721993127147766,1085,206,32,30,17,15,15,15
0.748924797247481,0.765227649751169,0.762391387507514,1076,215,39,29,16,12,23,17
0.724180655475619,0.755067646644715,0.745718096307735,1055,236,40,34,19,16,21,18
0.809561935262496,0.817061804342337,0.753879477563688,1070,221,42,37,22,16,20,21
0.813336585365854,0.851195528719057,0.733985802495064,1081,210,41,38,22,14,19,24
0.760186079724451,0.78175490664564,0.712365591397849,1051,240,38,31,20,14,18,17
0.743131707317073,0.767382090664801,0.703834994618373,1054,237,41,34,21,14,20,20
0.791555524357714,0.829306234194662,0.693014785120048,1056,235,34,37,20,17,14,20
0.738964423707808,0.75671029193622,0.721513944223108,1079,212,44,36,20,15,24,21
0.778669520242554,0.803859356530271,0.734783887092032,1076,215,45,38,22,19,23,19
0.758140820840501,0.772839799644444,0.741445329791943,1070,221,39,36,17,15,22,21
0.780684252530768,0.800815434727908,0.760226370135028,1097,194,38,32,18,14,20,18
0.722833620363759,0.755103523342866,0.728904249871992,1047,244,38,31,21,16,17,15
0.742103162935271,0.771488432593337,0.657415832575068,1087,204,38,35,14,7,24,28
0.721349508050089,0.739506970224003,0.690017706949978,1058,233,43,36,19,14,24,22
0.819632580787959,0.832313016773832,0.785165856057708,1073,218,36,29,21,15,15,14
0.72560748360167,0.746942705303494,0.689119303635433,1054,237,43,31,22,14,21,17
0.833013589128697,0.86560294852714,0.716812053925456,1069,222,40,30,28,17,12,13
0.757004177930696,0.785317485658709,0.723736716091906,1052,239,39,38,25,22,14,16
0.72359496124031,0.742540742540246,0.696417707894614,1063,228,43,34,19,15,24,19
0.72995792119788,0.761389761204253,0.72609040444092,1069,222,29,30,16,15,13,15
0.760224390243902,0.773889107516018,0.72852593266606,1049,242,41,35,21,17,20,18
0.750377171429803,0.765716561701695,0.694214029697901,1071,220,37,31,17,12,20,19
0.778637090327738,0.81695873945978,0.76994711965932,1070,221,40,34,27,22,13,12
0.701424961392672,0.726529272295948,0.698549101043773,1051,240,34,29,15,10,19,19
0.730970275087922,0.757773128061164,0.713325652841782,1061,230,33,31,15,13,18,18
0.709849863512284,0.734657199707506,0.739165508339952,1076,215,35,32,10,11,25,21
0.728346750149076,0.755815632528204,0.679339477726575,1061,230,43,31,20,11,23,20
0.790354868061874,0.820556653900127,0.728367831693247,1079,212,35,28,20,14,15,14
0.653082135635827,0.684258413102722,0.664075829383886,1087,204,29,25,8,7,21,18
0.815345100825182,0.844295453438043,0.782579962992334,1059,232,29,30,18,14,11,16
0.797003718014143,0.821066660065525,0.746938496271465,1069,222,44,47,22,23,22,24
0.692994687915007,0.700611094151937,0.590388530709196,1071,220,36,28,8,4,28,24
0.70098235765838,0.727122182109573,0.646802557953637,1054,237,44,40,19,14,25,26
0.717086973788721,0.74491748103297,0.676209357652656,1050,241,32,30,14,11,18,19
0.727558420628525,0.745439898873639,0.659371273106738,1041,250,50,43,23,15,27,28
0.792675159235669,0.820960212320253,0.7856747121453,1083,208,35,33,19,17,16,16
0.663883487742575,0.685579192436995,0.640197841726619,1066,225,42,40,17,14,25,26
0.728039041703638,0.751137650059963,0.650749170765184,1060,231,49,42,23,16,26,26
0.707270865335382,0.73273707443151,0.679736597628286,1053,238,31,29,12,11,19,18
0.729946524064171,0.750494316953871,0.672715148111751,1058,233,33,34,15,14,18,20
0.745753193878984,0.76301814993104,0.701109083251439,1060,231,34,34,14,14,20,20
0.734195824757424,0.757907111426136,0.697770700636943,1072,219,38,35,17,14,21,21
0.749579723263934,0.765184696707278,0.684561752988048,1048,243,37,36,19,16,18,20
0.690261116731705,0.726245258553326,0.633764062024932,1086,205,33,26,13,7,20,19
0.724540529419833,0.752533598632314,0.728090863952334,1063,228,23,19,8,8,15,11
0.760623510722796,0.786093816972356,0.728628872120731,1061,230,32,32,19,16,13,16
0.687206345101082,0.704639320548751,0.651944949954504,1072,219,37,35,13,12,24,23
0.73960325700858,0.769621018279785,0.669845874355368,1093,198,29,27,13,10,16,17
0.737283934652356,0.774241487444675,0.66486298649722,1063,228,37,32,19,12,18,20
0.724502334725977,0.744198460978811,0.702471583399418,1061,230,39,30,16,13,23,17
0.811268487739076,0.841477032107068,0.747540849226734,1050,241,33,29,21,15,12,14
0.75697271748795,0.773740272209864,0.706721753398968,1092,199,34,27,13,9,21,18
0.734672855440826,0.761976758838489,0.68963217745332,1071,220,32,34,15,13,17,21
0.750061440157287,0.772654311515804,0.705141422151731,1046,245,39,30,22,14,17,16
0.769455458630716,0.823749105499838,0.759715821812596,1061,230,30,31,17,17,13,14
0.720014106523314,0.751150944493788,0.659618949092633,1075,216,42,37,19,13,23,24
0.761908262275801,0.789934317178875,0.710366686704192,1066,225,38,29,20,12,18,17
0.727506325110689,0.761120503899731,0.716341033833046,1047,244,51,39,29,20,22,19
0.764013118664281,0.781656252033027,0.718468292682927,1039,252,43,41,24,18,19,23
0.716259321522479,0.739903347677424,0.657699874310072,1051,240,37,29,18,12,19,17
0.770094786729858,0.812539370580218,0.714515939990624,1099,192,25,27,14,11,11,16
0.746597177448241,0.791337304251897,0.664117995264404,1051,240,22,24,12,10,10,14
0.714048272871802,0.746771713250535,0.621527777777778,1060,231,33,27,15,10,18,17
0.733332505957109,0.763615524739327,0.64142215173143,1036,255,32,30,16,12,16,18
0.674759524509598,0.701570228428428,0.676660932251987,1084,207,38,39,17,18,21,21
0.681949833324225,0.716157440064924,0.629647539222007,1099,192,29,22,10,5,19,17
0.818117073170732,0.83718448736769,0.746610555050045,1050,241,41,35,28,17,13,18
0.818742546213476,0.837639721014053,0.755908495125748,1077,214,43,39,27,21,16,18
0.736534365527976,0.756705293492506,0.699035389530597,1081,210,39,39,18,17,21,22
0.747951361353423,0.793990264516011,0.707640538400633,1080,211,30,28,13,9,17,19
0.774855785544622,0.812017272845895,0.766620101726485,1051,240,28,22,15,8,13,14
0.740605578840873,0.775308462938259,0.731586887944041,1083,208,33,23,17,11,16,12
0.692109340416113,0.719597892669021,0.698681515617,1086,205,36,31,14,11,22,20
0.768869426751592,0.798249341424313,0.714446206714248,1056,235,35,30,19,13,16,17
0.77869632580788,0.804199899136928,0.747030209933436,1065,226,36,31,22,17,14,14
0.798349636592164,0.818858983992559,0.682078853046595,1061,230,29,31,15,12,14,19
0.736214740673339,0.758441144558655,0.644582060852845,1074,217,35,28,15,9,20,19
0.791065028161802,0.823934524341491,0.655194290245837,1042,249,31,30,18,11,13,19
0.825904347419159,0.855714350864765,0.740348182283666,1061,230,34,31,23,18,11,13
0.720813689540772,0.751054423448393,0.696685848699962,1078,213,46,38,21,16,25,22
0.739377135102251,0.764797814248747,0.685607655950208,1056,235,34,34,17,16,17,18
0.744365567911041,0.773551354992105,0.630325140809012,1082,209,32,31,16,10,16,21
0.739637112787927,0.769820412027496,0.771943219092863,1079,212,32,28,14,14,18,14
0.705618744313012,0.727353657361508,0.676891759090271,1072,219,35,34,16,15,19,19
0.751276677747266,0.783429340393997,0.725860979462875,1068,223,33,25,16,11,17,14
0.709307317073171,0.743748985186027,0.627058432934927,1090,201,41,36,18,11,23,25
0.703616352201258,0.742767347573812,0.747958306468945,1063,228,19,22,9,9,10,13
0.702832251950135,0.729715050347898,0.720118514236161,1084,207,44,33,17,12,27,21
0.702370731707317,0.725653188939443,0.678220035778175,1079,212,41,43,17,18,24,25
0.779184074711231,0.792689909093069,0.676947764497565,1065,226,39,36,19,13,20,23
0.762151237306517,0.795506027367764,0.713156230234029,1048,243,49,51,28,24,21,27
0.811918990703851,0.838598626495161,0.695121951219512,1090,201,36,41,20,17,16,24
0.777318333840073,0.815481935043089,0.695264885138303,1076,215,26,27,13,10,13,17
0.716128298453139,0.74681870455668,0.701774340309372,1078,213,35,35,15,14,20,21
0.772723277074543,0.800072544110355,0.766100723547532,1073,218,27,22,13,10,14,12
0.7736324841588,0.790531084266758,0.735554383497421,1057,234,37,27,19,13,18,14
0.746156592598816,0.773742183176529,0.658269845170804,1059,232,38,39,20,16,18,23
0.767782769432355,0.789413877961177,0.672873830768568,1076,215,34,37,17,15,17,22
0.787460807712106,0.806333722113938,0.747811059907834,1072,219,34,31,19,15,15,16
0.717499054899819,0.756817731290769,0.657270916334661,1083,208,38,36,15,13,23,23
0.759258339952343,0.772213143231097,0.702115559599636,1081,210,32,35,14,12,18,23
0.728550740477622,0.753844617362198,0.736087546657618,1081,210,29,28,9,11,20,17
0.701341716047598,0.738653544933932,0.596075978161966,1079,212,33,35,18,12,15,23
0.740357713828937,0.774191778819305,0.648883897234311,1070,221,40,34,20,15,20,19
0.811328487895514,0.84110644807063,0.70512385476756,1052,239,29,28,15,11,14,17
0.765838030543913,0.812412099191101,0.676600102406554,1056,235,33,31,22,17,11,14
0.778581122186345,0.804353887834478,0.679385267620562,1064,227,34,33,17,14,17,19
0.833399209486166,0.859097151107323,0.756285161744022,1072,219,26,27,15,12,11,15
0.783471774413902,0.807608455273033,0.79706597750076,1054,237,29,26,15,17,14,9
0.805413522637013,0.839009329413741,0.737122011251758,1061,230,32,27,20,12,12,15
0.698593757311994,0.738707035920504,0.628633380215659,1081,210,34,27,13,10,21,17
0.742069598888006,0.763008270851484,0.750890736342043,1055,236,32,28,12,12,20,16
0.772670250896057,0.798587372650473,0.701916327390145,1075,216,31,34,15,14,16,20
0.802107997895291,0.834402867987024,0.822612470402526,1058,233,24,24,15,15,9,9
0.78416600581549,0.811914174000509,0.740298704731694,1090,201,30,30,17,16,13,14
0.717572562691645,0.732202359104832,0.719178515007899,1074,217,38,25,16,11,22,14
0.781876503608661,0.805331249604581,0.793896445591739,1062,229,44,32,22,15,22,17
0.758560661915295,0.78703107884209,0.677437187845514,1052,239,39,42,22,20,17,22
0.720130588756087,0.732895979564374,0.705448385157659,1038,253,36,29,14,13,22,16
0.689574601339307,0.704039535006034,0.703925455987312,1055,236,33,30,11,8,22,22
0.815667555805138,0.85087062082487,0.791792228390166,1059,232,34,30,22,17,12,13
0.72803231518371,0.757104651457437,0.737685216604456,1056,235,36,28,17,12,19,16
0.740392313851081,0.757365969748748,0.687494879986893,1089,202,42,39,18,13,24,26
0.751272480488633,0.787540521846995,0.697776900815575,1064,227,28,24,16,10,12,14
0.743141463414634,0.780490114041094,0.739126478616924,1094,197,41,35,21,15,20,20
0.758263389288569,0.778584126943115,0.739618535586278,1073,218,40,31,22,16,18,15
0.742453100679938,0.765790457436956,0.747393764892772,1079,212,39,32,16,12,23,20
0.708182253540398,0.729112208824785,0.65067981337027,1062,229,47,44,21,15,26,29
0.681075697211155,0.713961977080854,0.724628776241679,1077,214,36,31,12,15,24,16
0.719218481199312,0.745639332134163,0.701603517392991,1064,227,39,37,18,17,21,20
0.771724335554123,0.795390000034856,0.706777251184834,1074,217,22,25,10,9,12,16
0.746239575059571,0.758736463878531,0.702278545826933,1064,227,32,31,13,13,19,18
0.714492826495039,0.73694642523685,0.679242639768956,1041,250,48,37,23,16,25,21
0.707370517928287,0.732241102765891,0.710129159062193,1063,228,36,34,16,14,20,20
0.795731560437443,0.816469586057512,0.725547937177684,1053,238,33,27,15,12,18,15
0.758175609756098,0.786908180114698,0.733206357008274,1075,216,41,39,21,19,20,20
0.694444444444444,0.724294795593209,0.652921646746348,1074,217,40,36,20,16,20,20
0.722998710736052,0.753236955772956,0.667777061394083,1066,225,27,22,11,5,16,17
0.763898999090082,0.788657690987006,0.726169706582078,1056,235,35,30,20,17,15,13
0.735918007308775,0.758559814735102,0.690999206978588,1059,232,38,30,16,12,22,18
0.641417733522997,0.667206862065033,0.633689671105137,1062,229,37,38,11,9,26,29
0.754924745462594,0.791139970532148,0.693457108816521,1043,248,36,32,20,13,16,19
0.659922520076915,0.684141627763597,0.569949177550686,1087,204,28,29,9,7,19,22
0.722804355157296,0.746030207465411,0.684126984126984,1055,236,33,31,12,11,21,20
0.790012161751292,0.819667547258765,0.700816984534674,1079,212,26,29,15,14,11,15
0.747913322632424,0.768213901877192,0.720389833035182,1063,228,45,43,22,19,23,24
0.676798165566943,0.708019971275012,0.524784054805401,1085,206,34,32,9,7,25,25
0.727839414388654,0.75506482816143,0.706810035842294,1060,231,42,31,18,13,24,18
0.765383354281655,0.807104409337223,0.702235632972158,1064,227,29,23,16,11,13,12
0.707810681494892,0.73781119117624,0.726543022195196,1068,223,37,26,18,13,19,13
0.693095996360328,0.717049749558661,0.646256304151041,1076,215,35,37,13,11,22,26
0.737699355276552,0.758881220132638,0.641933985463687,1070,221,28,29,13,9,15,20
0.74247042766151,0.767582559406445,0.696429699842022,1080,211,35,25,20,12,15,13
0.679216467463479,0.695613538201762,0.630920761398849,1088,203,36,36,11,9,25,27
0.731600236779795,0.777274670997197,0.639138672095917,1050,241,24,28,13,10,11,18
0.769420656090599,0.791117493857276,0.723314829500397,1069,222,34,30,16,11,18,19
0.810881122045017,0.833130961795367,0.740787734602168,1046,245,28,30,19,20,9,10
0.677459654296715,0.702946997329394,0.680589680589681,1062,229,39,37,15,13,24,24
0.705965227817746,0.726667491086535,0.725028353005419,1090,201,40,38,15,16,25,22
0.789229540427623,0.81112102947745,0.80877600708278,1077,214,39,36,23,22,16,14
0.726792828685259,0.761612146097692,0.680716362675126,1053,238,36,30,19,13,17,17
0.759687804878049,0.79143397265027,0.724680255795364,1079,212,41,40,19,15,22,25
0.716013851841453,0.7478485490866,0.70104923766326,1048,243,34,29,17,15,17,14
0.722196620583717,0.765684408347657,0.692201276983886,1047,244,31,26,16,12,15,14
0.675747940453823,0.688369559112389,0.712016574585635,1079,212,33,24,12,10,21,14
0.680922359015091,0.72085536369807,0.625484999180283,1079,212,32,29,18,13,14,16
0.746543526968687,0.783289823102886,0.745707337083919,1082,209,29,27,15,12,14,15
0.781563860511229,0.799151715926728,0.786796193497224,1058,233,37,30,20,15,17,15
0.767596777721076,0.791526908470868,0.786260343596421,1056,235,44,38,25,21,19,17
0.744989008146903,0.76964157476046,0.727657641819034,1050,241,37,27,18,13,19,14
0.719881710646042,0.764040136184994,0.690385361437993,1069,222,35,37,18,17,17,20
0.677434705621957,0.714713063696007,0.584052903618121,1060,231,36,26,17,9,19,17
0.675931707317073,0.697474594902909,0.667692613185068,1083,208,41,32,13,11,28,21
0.728492501973165,0.768551419861316,0.681235201262825,1067,224,24,24,11,8,13,16
0.767037890424987,0.806368478223546,0.748756762664626,1079,212,31,29,17,14,14,15
0.732528880247055,0.754766600612648,0.661097576343092,1090,201,42,38,19,13,23,25
0.799192447679709,0.810430682247525,0.717211436061276,1053,238,35,39,21,19,14,20
0.739575059571088,0.761021009224676,0.756585059292858,1061,230,32,29,15,13,17,16
0.680593958013313,0.716748259465062,0.620067928891458,1065,226,31,33,14,12,17,21
0.720318725099601,0.747891248346457,0.741882256588139,1076,215,36,33,17,14,19,19
0.7395244531826,0.762040358188964,0.734639220894201,1086,205,39,36,16,13,23,23
0.715067406819984,0.741452385796749,0.669504567116759,1056,235,30,32,16,14,14,18
0.767548785624035,0.799196897320195,0.712826420890937,1066,225,34,31,21,17,13,14
0.788950715421304,0.82485481389722,0.733983808320464,1078,213,33,34,20,17,13,17
0.683623101518785,0.71576009245996,0.605854274884178,1068,223,40,34,18,12,22,22
0.75371143189437,0.771361018517864,0.740897479888673,1057,234,47,42,24,23,23,19
0.758880266681239,0.793663243781315,0.658960384435068,1064,227,29,27,13,11,16,16
0.7784,0.822770208950469,0.669843902439024,1065,226,41,41,25,20,16,21
0.776127992633518,0.809237691317905,0.784237415992319,1061,230,24,23,13,10,11,13
0.736755743084857,0.803243341150587,0.722960112545515,1062,229,27,19,16,10,11,9
0.808245411186588,0.826215351466273,0.714077025232404,1055,236,33,36,21,19,12,17
0.745698924731183,0.805138036487132,0.776810659789383,1096,195,31,22,16,11,15,11
0.760214696768482,0.793691533099615,0.752661752661753,1062,229,36,33,19,16,17,17
0.768206766609323,0.803913224634628,0.723594927231036,1061,230,39,34,23,16,16,18
0.769506369426752,0.796539628116542,0.742608885731461,1078,213,35,29,17,13,18,16
0.757101408582526,0.780803500941157,0.756230633023462,1059,232,34,36,18,19,16,17
0.778119409660107,0.799837066974182,0.782435472187274,1086,205,43,42,23,21,20,21
0.724636155178062,0.745472536605299,0.706773729150119,1039,252,34,32,16,15,18,17
0.774677407596413,0.794491098830401,0.752058278374068,1074,217,44,37,22,18,22,19
0.779088083336834,0.801369573285822,0.756235154394299,1077,214,38,28,19,12,19,16
0.739391513210568,0.778579862708107,0.685103120930819,1063,228,42,38,24,19,18,19
0.697670250896057,0.738658172014483,0.676206314535346,1040,251,31,32,14,14,17,18
0.738612217795485,0.764029173231014,0.702692485403453,1083,208,36,38,14,14,22,24
0.726056270173917,0.753116302221812,0.636509517485613,1074,217,33,36,15,14,18,22
0.724003984063745,0.752568026357966,0.626034242647661,1056,235,36,39,19,17,17,22
0.685010997238991,0.723455346536983,0.71028447008257,1085,206,34,28,11,9,23,19
0.666724583002383,0.682813364012603,0.640292028413576,1073,218,32,24,10,7,22,17
0.751816692569412,0.768496179714728,0.733096703733122,1076,215,38,32,16,11,22,21
0.695289564985322,0.71409663018571,0.64990243902439,1064,227,42,41,15,12,27,29
0.777822045152722,0.80555605776964,0.77232770745429,1056,235,36,27,19,13,17,14
0.754657534246575,0.777191646992785,0.728366260844208,1081,210,50,44,26,21,24,23
0.735739488385769,0.760910724654886,0.655427547363031,1071,220,38,31,16,9,22,22
0.800693741870212,0.836885259599784,0.752119766825649,1085,206,33,33,23,19,10,14
0.780765387689848,0.79092508780768,0.760975887170155,1051,240,40,35,20,18,20,17
0.729049719326383,0.752899595542574,0.736797255422753,1084,207,44,36,22,20,22,16
0.760031847133758,0.785390209760613,0.67632802124834,1086,205,35,36,17,15,18,21
0.768675654242664,0.811009002904345,0.752234721799939,1094,197,30,26,15,11,15,15
0.742546341463415,0.761715452093729,0.733648255813954,1061,230,41,43,19,20,22,23
0.743210862619808,0.767514275008803,0.722443559096945,1068,223,39,36,17,15,22,21
0.71638689048761,0.742899018913147,0.687508082244924,1040,251,40,37,20,17,20,20
0.77173775671406,0.813114273605535,0.752657385818132,1069,222,25,23,13,11,12,12
0.690268562401264,0.734623395646995,0.68957182320442,1075,216,25,24,12,10,13,14
0.740975609756098,0.772503260229687,0.69174973091862,1032,259,41,34,22,15,19,19
0.666955725779255,0.693997480474787,0.703945570796218,1054,237,33,29,13,12,20,17
0.727233586760197,0.754988712857161,0.71400076506913,1066,225,38,29,20,15,18,14
0.761270983213429,0.795466360818371,0.732967194522619,1076,215,40,38,25,22,15,16
0.748865759274086,0.780722961790695,0.720986312859812,1068,223,42,42,21,17,21,25
0.690924177766283,0.715166386077639,0.658075781386415,1075,216,37,46,16,18,21,28
0.765757808499744,0.780615872748032,0.724887989593872,1076,215,31,33,10,9,21,24
0.720672864099159,0.740827924066193,0.654674704276615,1062,229,36,35,13,13,23,22
0.820358931161963,0.843726144187606,0.761939038919778,1058,233,34,32,21,18,13,14
0.800647835583797,0.834748635407495,0.802072729329261,1065,226,32,28,21,18,11,10
0.747171018945212,0.786591706079351,0.75688584153774,1093,198,31,27,14,11,17,16
0.731139011424047,0.755392013012307,0.734312796208531,1070,221,28,25,13,9,15,16
0.717794380460683,0.7494347012988,0.654697900665643,1091,200,32,31,17,13,15,18
0.687226965845909,0.708567124816049,0.62612711077108,1059,232,32,29,10,6,22,23
0.808330023828435,0.810517016433475,0.802987047316944,1052,239,32,30,18,17,14,13
0.745495495495495,0.759969214011075,0.677313086754892,1058,233,33,28,18,13,15,15
0.737782204515272,0.771803072737439,0.663888888888889,1059,232,36,31,20,14,16,17
0.696173572003218,0.714262862600608,0.642659232400629,1060,231,48,47,19,16,29,31
0.742026842584168,0.770533841334078,0.74047619047619,1075,216,35,31,18,16,17,15
0.742012779552716,0.767622636850359,0.673940687098582,1055,236,39,37,21,16,18,21
0.814708909985131,0.826066470220033,0.765648517042939,1068,223,42,36,26,21,16,15
0.716432591944915,0.736421941987092,0.672039362063115,1078,213,29,28,13,11,16,17
0.701230604601391,0.725664367274059,0.652738690301172,1042,249,45,38,23,15,22,23
0.737058371735791,0.759010646250768,0.651736228933379,1079,212,31,28,10,8,21,20
0.718630573248408,0.749557466916571,0.668533506768801,1059,232,35,33,18,13,17,20
0.76123619103625,0.780689103569922,0.753465367328937,1076,215,38,38,17,19,21,19
0.690423111919927,0.720919125483287,0.590642601126472,1070,221,35,31,12,6,23,25
0.743813634351483,0.785751688739138,0.703661115516786,1059,232,36,30,18,12,18,18
0.659412470023981,0.682779480322029,0.637461266046923,1068,223,40,36,13,9,27,27
0.752178257394085,0.776701881888629,0.708342084260932,1090,201,40,38,20,17,20,21
0.714840637450199,0.749397608356737,0.719162826420891,1068,223,36,31,18,14,18,17
0.748813374217667,0.780915860789747,0.713705641492266,1052,239,38,35,21,16,17,19
0.677158034528552,0.719630388337151,0.673966961486265,1063,228,36,34,17,15,19,19
0.810105227038774,0.833122414185403,0.798978404241562,1042,249,42,37,24,21,18,16
0.777398889770024,0.800683476874738,0.718969760900141,1063,228,30,27,19,16,11,11
0.777429023866078,0.798837451761425,0.812422850089151,1077,214,28,23,15,14,13,9
0.712820512820513,0.741857006782405,0.748971334522014,1065,226,30,23,13,12,17,11
0.713592640819927,0.740576052183462,0.681949833324225,1049,242,38,29,18,11,20,18
0.70360779105799,0.731911630565223,0.68030792269175,1096,195,36,34,15,13,21,21
0.658083533173461,0.676670985470376,0.673902945516148,1068,223,40,29,14,9,26,20
0.74711155378486,0.771197526223859,0.708621071270474,1084,207,36,36,17,17,19,19
0.762037156773999,0.786774787547988,0.729645783769495,1051,240,37,30,17,13,20,17
0.725523202911738,0.760008536820711,0.684869431643625,1080,211,35,31,19,16,16,15
0.826342129208371,0.836369759627676,0.814925755248336,1059,232,35,31,23,17,12,14
0.717361732259988,0.748565666563185,0.637385365853659,1065,226,43,41,22,18,21,23
0.75833819348254,0.787160364029368,0.700161717142017,1072,219,44,38,22,17,22,21
0.70987177687304,0.738360741352592,0.633960484511517,1052,239,34,32,13,8,21,24
0.78404276578737,0.803524865525818,0.747068839174102,1089,202,40,37,20,19,20,18
0.755357142857143,0.796156837976507,0.724027137736815,1082,209,35,31,21,18,14,13
0.731861443116423,0.754247059512017,0.740450297830483,1063,228,36,29,16,11,20,18
0.7622919596812,0.791660687686128,0.670807684670373,1088,203,27,32,14,13,13,19
0.755345293683952,0.775051749361215,0.702887360194675,1079,212,39,34,16,14,23,20
0.765132104003024,0.781679329023135,0.739730160782792,1078,213,38,37,19,17,19,20
0.734679867032808,0.770333914851103,0.643721495895409,1063,228,33,26,16,9,17,17
0.739746341463415,0.767295190673177,0.703252295357559,1081,210,41,37,17,11,24,26
0.746397117694155,0.762487467399426,0.694033652108186,1069,222,42,49,19,19,23,30
0.747083874940138,0.773356949155019,0.725402504472272,1064,227,47,43,22,21,25,22
0.688659793814433,0.718212818640819,0.694800851322591,1075,216,30,26,10,8,20,18
0.720817780794028,0.762377260073311,0.769838752312979,1070,221,28,30,14,14,14,16
0.805309362792456,0.838432297399097,0.73227760127085,1086,205,38,32,24,18,14,14
0.762595823420566,0.806875907761985,0.670330617699039,1095,196,30,37,15,11,15,26
0.744396087790725,0.769222709130008,0.656053396775046,1056,235,34,30,18,11,16,19
0.821796176903065,0.875202573122652,0.751349831271091,1083,208,28,21,19,13,9,8
0.661901934170343,0.687590094224113,0.674232887490165,1064,227,28,20,11,7,17,13
0.815424987199181,0.831850035884155,0.773206751054852,1074,217,31,27,17,14,14,13
0.752643419572553,0.781445528081373,0.699338225209162,1087,204,21,23,9,7,12,16
0.701775609756098,0.732183244750142,0.666154665355943,1062,229,41,39,16,13,25,26
0.794318407466243,0.80596364765747,0.743877954982468,1092,199,32,28,13,10,19,18
0.742327195089405,0.767759994529335,0.781299642573471,1063,228,42,32,20,17,22,15
0.748817106460419,0.76764803512906,0.690734866508062,1084,207,35,30,17,13,18,17
0.799105951427809,0.822740859268006,0.716396878161584,1077,214,42,33,20,14,22,19
0.707746023535497,0.739856238243484,0.672104120586549,1065,226,37,39,15,13,22,26
0.74815090167372,0.770798962364119,0.749578455460808,1040,251,42,33,23,18,19,15
0.735392951652875,0.75048170527733,0.707188353048226,1067,224,38,35,16,12,22,23
0.715272818918805,0.739578274047869,0.66327390144602,1079,212,38,34,14,9,24,25
0.769974020783373,0.786510796901738,0.681267060964513,1074,217,40,35,20,15,20,20
0.721528498825072,0.760630974977943,0.686891607471718,1058,233,29,24,14,12,15,12
0.723801040606266,0.74655620332127,0.718925808720112,1075,216,28,27,12,10,16,17
0.681331910246227,0.713800957036879,0.721160454665609,1077,214,32,30,15,16,17,14
0.699270444519851,0.73079088754837,0.664483609930051,1086,205,28,23,10,9,18,14
0.795256916996047,0.828886760633828,0.676563737133808,1052,239,26,28,18,14,8,14
0.784945481772661,0.798056266030846,0.753822478157268,1070,221,34,32,16,17,18,15
0.749419927206551,0.781299766049366,0.712347632442569,1067,224,35,27,18,10,17,17
0.752058689717925,0.779283077490553,0.711638701350278,1075,216,35,32,18,15,17,17
0.72751751639833,0.755748204241402,0.718570168437854,1083,208,43,38,21,19,22,19
0.79040404040404,0.810420191808284,0.743389897395422,1052,239,22,24,14,13,8,11
0.696872710030605,0.714997128189014,0.680990783410139,1087,204,37,31,13,10,24,21
0.73586427720413,0.772732574964559,0.694909154090548,1060,231,32,32,16,15,16,17
0.776540946394273,0.809274402239087,0.7419268748332,1077,214,46,42,29,23,17,19
0.731129499726971,0.753525334203227,0.728712237583205,1086,205,38,31,16,10,22,21
0.689139833035182,0.721780251756147,0.653259394449904,1072,219,43,34,18,12,25,22
0.722110866847709,0.747783313973471,0.657968244633931,1084,207,37,38,17,14,20,24
0.756901793858316,0.776513697032441,0.758044904422577,1093,198,26,28,12,12,14,16
0.703837106733314,0.722862205325682,0.69106529209622,1084,207,38,30,15,11,23,19
0.78743260665729,0.840469334404699,0.730529184247539,1080,211,27,27,18,14,9,13
0.745941719618745,0.771012427416269,0.739294210943696,1076,215,32,30,17,14,15,16
0.708893385363974,0.734918836298754,0.709369364446145,1086,205,33,29,14,11,19,18
0.727486751305807,0.748846808893713,0.682443208758998,1087,204,42,37,19,15,23,22
0.767390412564463,0.79638608981041,0.649115266136543,1085,206,27,22,15,9,12,13
0.727588615330889,0.764233303191394,0.67820487804878,1056,235,46,41,28,21,18,20
0.721547057796403,0.731299185459463,0.671063414634146,1082,209,46,41,17,14,29,27
0.72070892264711,0.740310305106044,0.674612660469234,1034,257,46,36,23,14,23,22
0.715777598710717,0.741842332664656,0.703145950657013,1057,234,50,48,25,24,25,24
0.73564693556836,0.753421125000868,0.759440062071641,1068,223,46,37,22,17,24,20
0.759900274606157,0.808073561316,0.666753867151956,1055,236,33,35,20,18,13,17
0.726000909918107,0.763756612301379,0.696584096821626,1071,220,35,28,20,13,15,15
0.752759713645554,0.780630687118276,0.677086179572654,1051,240,29,29,16,12,13,17
0.71702650480951,0.731614767253732,0.699398361495136,1055,236,38,31,16,11,22,20
0.720037683296469,0.747796073994514,0.667106460418562,1044,247,39,35,18,13,21,22
0.755335731414868,0.790286072671203,0.742076139884905,1074,217,40,36,22,19,18,17
0.743789808917197,0.776419880713907,0.668533506768801,1077,214,35,33,17,13,18,20
0.718223631704961,0.742326933107515,0.645387258789321,1080,211,38,30,14,7,24,23
0.762711213517665,0.794900091148357,0.711203366696997,1076,215,31,35,16,14,15,21
0.689058917122935,0.732673798518476,0.681314053067528,1066,225,34,34,17,15,17,19
0.792127467846318,0.809075291865132,0.709615766481334,1073,218,39,32,21,17,18,15
0.704174271140437,0.729218129067529,0.689145636971724,1060,231,34,26,13,9,21,17
0.751969336505419,0.789058671246288,0.76387326584177,1080,211,30,21,15,9,15,12
0.759520520915549,0.808019057166425,0.669591301087364,1074,217,24,21,15,11,9,10
0.785590969455511,0.809522214534329,0.73852762357917,1092,199,36,30,19,15,17,15
0.705365853658537,0.734263698999029,0.709108012394865,1090,201,41,36,15,15,26,21
0.747290712815558,0.770696815032408,0.730017921146953,1066,225,38,31,18,14,20,17
0.813616315520886,0.833194626578225,0.745958877537825,1060,231,44,37,30,18,14,19
0.710623293903549,0.736355824160285,0.707777621788572,1072,219,35,34,15,15,20,19
0.748300155648398,0.781636070254153,0.685381694644285,1075,216,39,40,20,16,19,24
0.732171314741036,0.751298042789835,0.707053330056525,1071,220,36,39,18,18,18,21
0.72459032773781,0.749894620998695,0.677701625070046,1045,246,40,37,18,15,22,22
0.735365748523643,0.768066330108258,0.667994687915007,1071,220,37,36,18,12,19,24
0.739225045626843,0.771445786643341,0.680343569474004,1082,209,34,26,17,13,17,13
0.780214634146342,0.801800388014727,0.78247567844342,1087,204,41,31,24,17,17,14
0.717757864816688,0.749428673535522,0.714697524454888,1056,235,33,29,16,14,17,15
0.744061916199626,0.772626030970908,0.718255918735152,1040,251,42,39,22,19,20,20
0.765708064698564,0.810328165930346,0.7077299305973,1069,222,28,29,15,12,13,17
0.703180501666758,0.734601305677277,0.717134137978329,1077,214,29,23,9,5,20,18
0.704855289057374,0.720036647618531,0.615824936511837,1079,212,44,39,16,13,28,26
0.757238521944404,0.787505833255438,0.747739888977002,1064,227,33,30,17,14,16,16
0.791321880119293,0.801906181860519,0.698215701823949,1065,226,38,30,21,13,17,17
0.723360920729342,0.756984418577701,0.660873521383075,1039,252,37,35,19,13,18,22
0.663549160671463,0.684469480735193,0.654209081550955,1093,198,40,42,12,10,28,32
0.790385605316112,0.812786035802455,0.666302621127879,1074,217,34,32,21,17,13,15
0.661986084756483,0.681962603632263,0.650851747964699,1062,229,51,47,17,15,34,32
0.678602931910782,0.704337398082967,0.615437483478721,1082,209,38,30,15,10,23,20
0.793082926829268,0.810563411117749,0.741537761601456,1062,229,41,35,23,19,18,16
0.681815518049695,0.723256725962843,0.651991486774095,1058,233,27,26,11,8,16,18
0.720671424795136,0.748927707443057,0.634498207885305,1063,228,30,31,13,13,17,18
0.778783570300158,0.809136706581412,0.724579058142594,1063,228,25,24,13,10,12,14
0.7348271155596,0.752954882038662,0.753565768621236,1056,235,35,29,17,15,18,14
0.754965877463876,0.777817694655947,0.716653658536585,1039,252,42,41,19,18,23,23
0.714569509297944,0.741445664771593,0.700773558368495,1050,241,39,27,13,9,26,18
0.678187403993856,0.711075372905881,0.610225087659767,1069,222,31,28,9,8,22,20
0.730084533276022,0.778457322237072,0.72397476340694,1061,230,22,23,11,11,11,12
0.732316048105522,0.748048361465029,0.692936951316839,1053,238,37,38,18,16,19,22
0.793614431164232,0.826265194222791,0.756401137980085,1085,206,36,37,22,20,14,17
0.77081752055661,0.783540499922648,0.761776030146637,1084,207,51,39,21,13,30,26
0.778926858513189,0.799093442072604,0.66803919325937,1069,222,40,42,23,20,17,22
0.78252688172043,0.786481484171113,0.71718717931176,1057,234,51,47,21,18,30,29
0.698830935251799,0.730037896175307,0.665678048780488,1099,192,40,41,18,15,22,26
0.737404767756205,0.763745625896688,0.804347232089185,1035,256,39,29,23,20,16,9
0.74669017288444,0.766086312245682,0.733848953594177,1059,232,35,35,18,18,17,17
0.719058947924927,0.744138039178284,0.673933944123968,1072,219,30,28,12,8,18,20
0.766227018385292,0.788949828925684,0.816381065490329,1060,231,40,28,20,15,20,13
0.780555555555556,0.802038510198882,0.735890776358276,1081,210,40,34,22,17,18,17
0.729621966464072,0.75379036933468,0.695976469420175,1085,206,37,32,15,10,22,22
0.67921989798306,0.697120711014724,0.694717792104966,1063,228,34,28,12,9,22,19
0.717516870639369,0.74192775659222,0.717950420540062,1068,223,42,36,19,18,23,18
0.741564680315681,0.768144311942649,0.673339114515585,1066,225,42,33,18,9,24,24
0.740230279461665,0.764994744284564,0.74226427622842,1035,256,42,36,20,18,22,18
0.669374700690976,0.689149313077713,0.666144200626959,1050,241,47,44,16,13,31,31
0.802195177434031,0.817896358969261,0.707973157415833,1076,215,35,35,19,16,16,19
0.712989080982712,0.745679699052782,0.647337429595494,1064,227,35,31,15,10,20,21
0.698540921288014,0.729055479308156,0.647721250662427,1095,196,43,33,15,11,28,22
0.737365853658537,0.758208344894256,0.649647406733394,1080,211,41,35,19,13,22,22
0.779661437648928,0.809393327733167,0.712575637990003,1053,238,32,24,18,12,14,12
0.7100747679254,0.734280615162914,0.622532153682313,1076,215,38,39,15,16,23,23
0.766745968807824,0.785086681521604,0.681899641577061,1057,234,30,31,16,16,14,15
0.694155080438526,0.725869659481114,0.65230006083579,1072,219,38,34,17,14,21,20
0.714894360048891,0.737140059509189,0.665408840190817,1046,245,46,43,23,18,23,25
0.764985365853659,0.786495694928155,0.621781164695177,1065,226,41,35,22,11,19,24
0.759652278177458,0.778620673684806,0.710222752585521,1090,201,40,34,19,14,21,20
0.717401612138454,0.746057442122187,0.666308243727599,1067,224,37,31,14,11,23,20
0.689768165806504,0.707673583974345,0.698202911737943,1077,214,39,35,12,9,27,26
0.695543540591464,0.716741418017846,0.656862745098039,1075,216,39,33,15,10,24,23
0.701216077828981,0.732431591698304,0.745370830023829,1083,208,31,32,12,13,19,19
0.737416998671979,0.768447195202803,0.757401533174729,1082,209,36,30,17,12,19,18
0.713095238095238,0.755966476784474,0.696876465072668,1085,206,31,27,13,10,18,17
0.803886471056203,0.812717927732011,0.758673230192217,1068,223,34,27,18,11,16,16
0.744784341303329,0.771737900594802,0.64849710602473,1078,213,27,24,12,8,15,16
0.743949114237807,0.763863654787347,0.67898406374502,1071,220,44,36,22,16,22,20
0.744549929676512,0.768031828513027,0.739422175339897,1084,207,27,27,14,12,13,15
0.793581616481775,0.836849591003728,0.774481364275668,1084,207,29,27,17,13,12,14
0.751573343678607,0.773048238380787,0.696882446386021,1074,217,37,32,15,13,22,19
0.747582938388626,0.783814832722052,0.693781241778479,1072,219,25,24,9,8,16,16
0.786542523384629,0.811617112847418,0.716884348463296,1081,210,37,37,16,15,21,22
0.703447242206235,0.728298912307092,0.720230190349712,1075,216,40,36,19,15,21,21
0.778713205183793,0.806154715590517,0.704487614523244,1069,222,33,28,18,11,15,17
0.76959507707817,0.787473282943126,0.72884786372783,1074,217,38,34,20,16,18,18
0.746540284360189,0.769584469787229,0.693001579778831,1076,215,25,25,14,10,11,15
0.763976793248945,0.800962511172712,0.729825949367089,1065,226,27,27,15,12,12,15
0.741602662570404,0.760102839343431,0.676656151419558,1058,233,31,23,13,8,18,15
0.742242948134668,0.772512553308647,0.780478456251652,1083,208,35,30,16,15,19,15
0.753380841291828,0.77413156812586,0.752624390243902,1070,221,44,41,21,21,23,20
0.688283977757662,0.711778297318112,0.71776382762131,1105,186,37,28,12,11,25,17
0.784149936824372,0.806579856784657,0.650053816275914,1070,221,34,34,17,10,17,24
0.744762708498809,0.767002173788175,0.710254372019078,1065,226,32,33,18,16,14,17
0.718913560666138,0.750033148911128,0.675039494470774,1056,235,30,25,13,11,17,14
0.7642585931255,0.788736510005605,0.729471004869411,1058,233,40,36,20,16,20,20
0.777937666713463,0.811385626050673,0.711388421914738,1074,217,34,37,22,20,12,17
0.717316147082334,0.746026978803667,0.680448780487805,1060,231,40,41,19,16,21,25
0.740319698173153,0.776246450234711,0.626245963779306,1059,232,32,34,20,17,12,17
0.774676145339653,0.800625643989193,0.670248480042294,1065,226,25,30,14,13,11,17
0.783310166799047,0.805546555220663,0.737899057464275,1072,219,32,26,17,13,15,13
0.737871561400973,0.775625250663148,0.682953637090328,1086,205,33,40,18,15,15,25
0.729638341664216,0.762406618365912,0.690514592933948,1073,218,38,31,21,13,17,18
0.713566507684155,0.746928424732332,0.763046907145796,1068,223,33,23,16,13,17,10
0.78067375141765,0.802141636775528,0.732210820446115,1041,250,38,33,19,16,19,17
0.681434852118305,0.711817337384715,0.656197432492253,1041,250,40,36,18,13,22,23
0.704038967196862,0.726676478693619,0.625398406374502,1053,238,37,36,16,13,21,23
0.823219512195122,0.85051897982196,0.752058689717926,1069,222,41,35,22,17,19,18
0.738800393672086,0.756807526687735,0.772734909900449,1064,227,44,38,20,19,24,19
0.770485796801586,0.796371633255533,0.737536346814697,1076,215,37,30,19,12,18,18
0.720160351739299,0.734697202981753,0.706960873521383,1052,239,37,35,16,13,21,22
0.801619512195122,0.812860161820441,0.708432934926959,1048,243,41,36,23,14,18,22
0.80068887302054,0.803972948320329,0.73294930875576,1087,204,38,31,18,11,20,20
0.724565960035566,0.748934717075805,0.693653305203938,1040,251,34,27,16,12,18,15
0.766129032258064,0.807866072241509,0.660363954314444,1079,212,31,29,19,14,12,15
0.714253023076552,0.727959735984536,0.6532254179313,1065,226,33,33,15,11,18,22
0.697210904355862,0.718292195642174,0.674158325750683,1044,247,38,35,16,13,22,22
0.719469181072115,0.742393280525323,0.619836214740673,1048,243,46,35,18,9,28,26
0.746884928514694,0.785633608256098,0.636857129486639,1084,207,32,34,20,14,12,20
0.742629510037905,0.784790507555559,0.715475689082316,1061,230,34,34,21,21,13,13
0.735371949426639,0.759118364017875,0.718061210164257,1048,243,38,34,19,16,19,18
0.724124203821656,0.746379317022811,0.714472484037701,1069,222,35,26,15,12,20,14
0.822324526287697,0.838720965907743,0.775539893960947,1051,240,42,37,25,20,17,17
0.711009780597409,0.730123729746581,0.636008704557092,1090,201,30,31,11,11,19,20
0.73928886461965,0.768211958664277,0.729681553210965,1079,212,38,33,21,17,17,16
0.725077467906153,0.756735803480537,0.656263414634146,1092,199,36,41,20,16,16,25
0.727797761790568,0.767362233174404,0.653419654714475,1047,244,40,36,20,13,20,23
0.724914089347079,0.763256114282125,0.638067653970162,1078,213,30,29,14,13,16,16
0.843317535545024,0.868843297739945,0.757925545908971,1078,213,25,24,17,14,8,10
0.747434600375777,0.778450810878098,0.711759888230476,1078,213,33,33,17,12,16,21
0.714170506912442,0.75358241092051,0.713259498011247,1062,229,31,23,15,9,16,14
0.794515956020381,0.818246362207037,0.689599298486408,1065,226,48,42,29,21,19,21
0.756967593857588,0.78068113245249,0.721785150078989,1059,232,29,25,16,14,13,11
0.788299064614854,0.823788435227642,0.753170480602742,1070,221,37,34,22,18,15,16
0.753350873709293,0.788691304984204,0.713225313878521,1064,227,32,28,16,13,16,15
0.772000885347499,0.792328404098358,0.760851760851761,1082,209,36,37,15,16,21,21
0.696362909672262,0.720148439666229,0.684684684684685,1073,218,40,33,13,11,27,22
0.703220600279424,0.73477127460609,0.629264214046822,1066,225,33,26,15,8,18,18
0.737097566969771,0.759101278957576,0.676018149623728,1072,219,39,36,18,13,21,23
0.761722588796855,0.780892031215042,0.69531490015361,1059,232,34,31,19,13,15,18
0.690458536585366,0.714616909829396,0.654127779984114,1046,245,41,32,18,13,23,19
0.702673170731707,0.727948886292612,0.706420515700313,1081,210,41,34,14,10,27,24
0.77953291783079,0.796245877593578,0.688481598687295,1083,208,22,27,11,11,11,16
0.757775609756098,0.790187302973244,0.626269362160138,1073,218,41,34,21,13,20,21
0.709545670071986,0.747749390099641,0.64581264892772,1043,248,37,32,15,11,22,21
0.706502410033226,0.735123506063601,0.648566878980892,1076,215,34,35,14,11,20,24
0.692463479415671,0.714927795407905,0.662169876886418,1050,241,36,32,18,13,18,19
0.753837334456456,0.770936217943489,0.751749900714853,1074,217,34,32,14,15,20,17
0.716992720655141,0.742754352762077,0.673698123182659,1085,206,35,30,13,8,22,22
0.744142705005325,0.782207454017765,0.694057104913679,1046,245,39,36,21,16,18,20
0.750996249413971,0.775005683528851,0.757926043131739,1088,203,27,27,10,8,17,19
0.719389255261058,0.751557884197015,0.671861107211381,1068,223,38,34,18,13,20,21
0.754536833484202,0.773442732360892,0.746072583693872,1087,204,37,38,19,18,18,20
0.784583191946612,0.819770083512805,0.719778048038918,1077,214,28,26,16,12,12,14
0.772392062215071,0.798520050716854,0.736873608602512,1061,230,48,38,30,21,18,17
0.767925659472422,0.780547538236166,0.673541395387911,1058,233,40,38,20,15,20,23
0.724703711985689,0.750884174304617,0.709008410801239,1074,217,43,36,20,16,23,20
0.791720865250277,0.820251937540306,0.732290718835305,1076,215,33,35,18,15,15,20
0.735441182809604,0.759550719279827,0.722105795635207,1062,229,37,33,16,16,21,17
0.786837904817911,0.819917609749708,0.677836217622441,1062,229,38,28,24,14,14,14
0.636049885347934,0.653996318874197,0.6222288202692,1091,200,34,28,11,9,23,19
0.688990757304711,0.711384557116164,0.703537170263789,1065,226,43,40,16,15,27,25
0.720673461231015,0.741709907929544,0.766555998229305,1054,237,40,36,14,13,26,23
0.748060261218156,0.772898695900887,0.725724781572677,1056,235,37,32,22,17,15,15
0.723526301876817,0.769580843789965,0.679471401781528,1058,233,30,27,16,12,14,15
0.757756166982922,0.779470181209431,0.754289145602196,1045,246,51,42,30,25,21,17
0.695715845909452,0.717796661547531,0.65314565159926,1046,245,32,30,14,13,18,17
0.769084874348032,0.802560060218078,0.740380980383921,1086,205,37,38,22,21,15,17
0.756886072675546,0.781566495251919,0.773183081810961,1048,243,37,32,18,17,19,15
0.682927941623594,0.724562913824524,0.668905365713876,1059,232,26,22,11,9,15,13
0.742964254210946,0.762687853949045,0.704677336328326,1066,225,38,34,20,15,18,19
0.713519184652278,0.73835492419972,0.666631662956273,1059,232,40,38,15,12,25,26
0.740015416486005,0.788488657134084,0.677289531564416,1071,220,33,34,15,14,18,20
0.744245560456962,0.786256850054982,0.735405898449377,1071,220,28,26,14,12,14,14
0.749952342826642,0.769684979860043,0.685503685503685,1063,228,42,33,19,12,23,21
0.731877051101735,0.774206772518502,0.639480085132259,1070,221,27,26,14,10,13,16
0.762578774470367,0.787528724537653,0.764777314086338,1065,226,48,47,22,21,26,26
0.778514160093107,0.815276675674097,0.730595996360328,1075,216,37,35,23,20,14,15
0.747862263184844,0.766432579585264,0.694286573036778,1064,227,31,29,16,12,15,17
0.733140772271207,0.762155664104235,0.662079058142594,1061,230,26,24,10,9,16,15
0.793250469721058,0.844863854038583,0.709402836380684,1073,218,33,27,23,16,10,11
0.67846392208942,0.707566386959035,0.732835652075557,1074,217,36,28,16,11,20,17
0.707176843774782,0.740555638160351,0.661812100942536,1070,221,30,26,12,9,18,17
0.756262152579206,0.786037738196055,0.697595991713639,1069,222,42,33,23,17,19,16
0.772709363134895,0.81479119153669,0.681152986056301,1075,216,22,24,11,9,11,15
0.726662980257229,0.755753545796343,0.677022529441884,1071,220,39,31,17,12,22,19
0.796750893566323,0.821587361167689,0.777360346184107,1069,222,32,20,21,12,11,8
0.721549901581979,0.741820430197299,0.653970795684166,1052,239,44,42,20,14,24,28
0.720871246587807,0.744831257318647,0.642258579409417,1092,199,35,38,14,13,21,25
0.657768723484689,0.691916124832762,0.710573618821042,1084,207,38,30,16,15,22,15
0.766916428407112,0.783197291582549,0.759011223068731,1063,228,49,39,26,19,23,20
0.755639009780523,0.773702616246249,0.716516084193805,1082,209,34,32,15,13,19,19
0.729608294930876,0.754676043325361,0.617242703533026,1054,237,31,31,14,10,17,21
0.844667534758684,0.86896629897917,0.766089061725571,1056,235,38,42,25,23,13,19
0.755453658536585,0.780111025341054,0.737750947634424,1044,247,41,34,25,17,16,17
0.755991637570585,0.77693468214692,0.639251691883271,1058,233,37,37,20,13,17,24
0.72892864472874,0.753825867767409,0.734545369460433,1048,243,47,34,24,17,23,17
0.693712771189683,0.728741599381035,0.69852338969986,1070,221,29,33,13,17,16,16
0.789912629070691,0.802505644841216,0.694387907069102,1074,217,32,32,17,17,15,15
0.735392951652875,0.764908367669632,0.767959549411162,1077,214,38,31,17,13,21,18
0.730298524533913,0.748660869107826,0.696698488464598,1063,228,42,34,18,14,24,20
0.775774826059456,0.795688732207452,0.820673461231015,1076,215,51,40,27,25,24,15
0.664899349109875,0.686269635454319,0.639309471803018,1052,239,37,32,11,7,26,25
0.750983078162772,0.771526824353877,0.73184835076428,1054,237,50,48,25,22,25,26
0.710587517633154,0.743666892440231,0.649525349687067,1079,212,42,38,21,15,21,23
0.734402951699463,0.758544571892788,0.728535209119677,1056,235,43,42,16,14,27,28
0.706532735944501,0.738169174358411,0.603456221198157,1064,227,33,31,15,9,18,22
0.768985008601622,0.78622946565702,0.680265787370104,1041,250,39,40,20,17,19,23
0.779050440815147,0.80296190617661,0.750177605333625,1090,201,33,29,18,16,15,13
0.749642962153988,0.776115559318389,0.715132244544009,1056,235,38,33,20,15,18,18
0.766679904686259,0.797508573339094,0.751201787128153,1065,226,32,28,14,11,18,17
0.762174673762484,0.774391173860023,0.732791057990261,1068,223,44,36,23,18,21,18
0.713147918641102,0.737830409252352,0.712210231814548,1082,209,44,40,22,19,22,21
0.696557303186696,0.722890632724173,0.656471792538671,1063,228,39,35,16,14,23,21
0.718339152549679,0.745268988293359,0.66177273629865,1061,230,37,32,17,12,20,20
0.786597542242704,0.805964172338255,0.755926779313876,1083,208,31,31,18,16,13,15
0.796837768069897,0.836056791783138,0.775786481668835,1052,239,32,33,21,19,11,14
0.726990445859873,0.768824780853967,0.64785373608903,1061,230,35,33,21,15,14,18
0.669098822324629,0.6920904349975,0.663286834789516,1025,266,31,32,11,9,20,23
0.744480572708891,0.761340734281789,0.747802390998594,1067,224,29,27,11,11,18,16
0.801449761478831,0.81775927929531,0.71895870962322,1064,227,43,38,24,16,19,22
0.742507746790615,0.776244344251768,0.729356361709303,1051,240,36,33,20,15,16,18
0.739708233413269,0.771288832608729,0.704068978426693,1071,220,40,34,19,14,21,20
0.688481598687295,0.708165393145525,0.676804969526488,1067,224,27,27,14,11,13,16
0.778121818798778,0.805733962740669,0.743964467368723,1084,207,28,22,16,12,12,10
0.690501999325529,0.732466561312587,0.664835325832161,1068,223,33,27,15,11,18,16
0.754173214597521,0.784403653997018,0.748928886461965,1038,253,46,38,25,20,21,18
0.76337260284418,0.784974872449193,0.723705179282868,1071,220,42,36,19,14,23,22
0.721887390959556,0.751124646417315,0.641782603777853,1082,209,30,28,12,6,18,22
0.694806899137608,0.737003669532255,0.664660667416573,1053,238,21,21,8,7,13,14
0.803032430155833,0.832113626445962,0.750818946436476,1064,227,34,36,25,23,9,13
0.735317516027891,0.747244296165988,0.681150264401703,1075,216,34,34,13,10,21,24
0.740541228367832,0.782787646313023,0.67498344918901,1077,214,28,19,16,9,12,10
0.740037969624301,0.764242172459298,0.71478543684777,1068,223,40,34,15,12,25,22
0.793685051958433,0.818724137772414,0.776846365081659,1048,243,40,33,23,17,17,16
0.680409756097561,0.714461654345654,0.664497565294378,1064,227,41,36,15,13,26,23
0.74073719875403,0.783954678749495,0.693396524486572,1067,224,29,25,16,11,13,14
0.74685937040306,0.774343828504875,0.722460481777252,1079,212,55,49,31,26,24,23
0.770111411485213,0.791528380409984,0.720533876590919,1061,230,39,38,20,15,19,23
0.759492682926829,0.778425420698554,0.710843588371678,1070,221,41,45,19,18,22,27
0.816346108849268,0.856519781886288,0.808851270849881,1066,225,34,32,23,21,11,11
0.736201431772228,0.750303382630014,0.693307086614173,1055,236,29,21,13,7,16,14
0.743050537168184,0.76860099592084,0.718586789554531,1075,216,33,31,15,13,18,18
0.722516641065028,0.746265796469374,0.741785431512272,1091,200,31,28,12,12,19,16
0.662703776521668,0.700652064435447,0.689923881100352,1069,222,39,33,19,14,20,19
0.689245313951582,0.719941237205527,0.615812339472102,1052,239,29,29,12,9,17,20
0.697660586835845,0.726309435851186,0.685117633751838,1055,236,30,28,11,9,19,19
0.759051959507708,0.797799578428768,0.680986684588566,1078,213,38,38,20,16,18,22
0.704624390243902,0.730884885057009,0.672045152722444,1061,230,41,36,18,15,23,21
0.709346341463415,0.735929459714633,0.699143619261547,1093,198,41,34,17,14,24,20
0.786627882555551,0.801925937803515,0.693484007401533,1068,223,38,30,17,11,21,19
0.726501526976586,0.756075845111372,0.698224331926864,1058,233,28,27,15,15,13,12
0.747737812464653,0.77816181508363,0.71596739490235,1098,193,28,19,8,4,20,15
0.760543117570462,0.782379177082972,0.714046366163622,1071,220,38,32,19,15,19,17
0.696270582452691,0.721318473279514,0.635771155595996,1069,222,39,35,13,9,26,26
0.787045570916539,0.804167245432863,0.725950136819702,1040,251,31,26,19,14,12,12
0.74968152866242,0.786533862240895,0.696584590945195,1065,226,35,32,15,12,20,20
0.704973755194284,0.728283579586112,0.676555214852775,1056,235,44,38,17,14,27,24
0.784370604781997,0.818729873150411,0.722573839662447,1078,213,27,27,15,12,12,15
0.735276019690577,0.78164575357786,0.594964594807238,1065,226,27,20,14,7,13,13
0.750783845757874,0.768647416936395,0.731676280963692,1065,226,34,28,15,11,19,17
0.807540946314832,0.828374161458681,0.73978604050834,1076,215,35,32,21,15,14,17
0.736720623501199,0.753444743176488,0.698782647189022,1057,234,40,36,18,14,22,22
0.771768268467037,0.793430749582465,0.678949066719619,1049,242,32,32,18,13,14,19
0.698204878048781,0.715104920830126,0.641027107400206,1075,216,41,42,15,14,26,28
0.789656938044035,0.806407730925638,0.816939621152328,1061,230,31,24,18,14,13,10
0.723627711376715,0.764459474587524,0.698680618744313,1033,258,36,35,21,17,15,18
0.690525927746375,0.714362802271376,0.661623808578237,1099,192,39,32,14,8,25,24
0.673509892048557,0.699237176525497,0.627899513058876,1096,195,38,36,16,14,22,22
0.667613927291347,0.712317666609512,0.75688584153774,1088,203,31,27,12,12,19,15
0.751445295562943,0.771671940902582,0.759727307503142,1071,220,33,29,17,16,16,13
0.761294748914557,0.780197994297274,0.741362192216044,1067,224,39,32,16,12,23,20
0.694263811789585,0.716450397495598,0.690837937384899,1057,234,30,24,12,10,18,14
0.709567222725117,0.73693347791914,0.633112109883648,1069,222,37,38,14,13,23,25
0.74470243902439,0.768608427558248,0.656963666171032,1057,234,41,42,17,13,24,29
0.770134306705976,0.803391976237492,0.729621095750128,1089,202,34,31,16,13,18,18
0.756130375777996,0.79108064214891,0.680376344086022,1077,214,34,31,18,14,16,17
0.74203013481364,0.765486686485922,0.688982992730764,1068,223,30,23,12,7,18,16
0.746531290648938,0.771335431285445,0.712660010240655,1084,207,33,31,13,12,20,19
0.794620671424795,0.818620039406346,0.778403383558023,1068,223,30,30,16,16,14,14
0.725982166800751,0.747086799808794,0.661744248261102,1069,222,48,45,23,16,25,29
0.768802124702145,0.80180009410449,0.697581284694687,1061,230,32,30,14,11,18,19
0.697775866306218,0.727103324677578,0.616847708952972,1083,208,39,37,17,11,22,26
0.680066024622716,0.696477547113874,0.694662058371736,1043,248,32,31,10,11,22,20
0.700676753308332,0.722383733862246,0.736679192561546,1056,235,37,33,17,16,20,17
0.710988364766665,0.74010319227139,0.722424076952157,1070,221,38,38,17,16,21,22
0.718260188087774,0.735858479239218,0.579012026380447,1044,247,44,37,19,8,25,29
0.680503633385139,0.706491719052556,0.679381386961036,1066,225,38,29,14,10,24,19
0.688579725972994,0.718487468757649,0.708023304787309,1091,200,32,34,14,14,18,20
0.721190243902439,0.751856555360416,0.687879696243006,1084,207,41,40,17,17,24,23
0.773895553307318,0.801392616901323,0.742088607594937,1085,206,33,27,17,13,16,14
0.734372156505914,0.754773517351818,0.625692537457243,1072,219,35,33,16,13,19,20
0.713414834532847,0.726399990714099,0.627843902439024,1079,212,49,41,18,11,31,30
0.701012283894449,0.738527740388536,0.640525477707006,1083,208,35,35,17,13,18,22
0.675826375386023,0.697029378383075,0.629111185785693,1077,214,42,38,17,13,25,25
0.749552522653541,0.798099537409163,0.669221534767753,1059,232,14,17,7,6,7,11
0.709974977252047,0.721566668891692,0.64803094233474,1063,228,35,27,14,9,21,18
0.750703574578905,0.782598293714514,0.693863052625827,1089,202,38,29,17,10,21,19
0.690796675104331,0.723443388882337,0.719315747469232,1063,228,47,38,19,12,28,26
0.783929096484227,0.808550441671386,0.706856240126382,1067,224,38,25,23,13,15,12
0.732204515272244,0.762876324257444,0.736482334869432,1054,237,36,31,17,15,19,16
0.77175073392047,0.799137585534594,0.75583222664896,1085,206,42,36,22,17,20,19
0.757967148673312,0.763677866230074,0.745519757744241,1092,199,34,32,12,9,22,23
0.662352790578597,0.690439920875099,0.624801901743265,1064,227,31,29,12,9,19,20
0.642775550670288,0.657141636284187,0.5854290118996,1084,207,37,33,12,10,25,23
0.651520561179485,0.677461675890208,0.5903170312116,1073,218,38,39,16,12,22,27
0.769554356514788,0.799882799211812,0.802124935995904,1082,209,40,31,20,16,20,15
0.721227802284809,0.755822134348142,0.640485818096578,1078,213,28,27,11,9,17,18
0.768995248627837,0.793741089843824,0.666046609574618,1071,220,39,34,18,12,21,22
0.747885835095138,0.773377799186077,0.67393084622384,1061,230,44,35,25,16,19,19
0.796407798803965,0.823536949834988,0.80540487804878,1057,234,39,41,26,27,13,14
0.780766606005459,0.806673894175421,0.738308720112518,1052,239,35,27,22,15,13,12
0.759703028521023,0.775819603897327,0.772349986782977,1063,228,38,30,18,14,20,16
0.704200612095349,0.732521501662161,0.618809000387948,1085,206,37,37,14,12,23,25
0.713613643046163,0.735688044870319,0.644758394758395,1075,216,38,37,18,15,20,22
0.728834407872412,0.761273504460145,0.630263338362364,1059,232,28,23,11,6,17,17
0.712936964762038,0.74924769336963,0.62507325363338,1075,216,34,27,16,9,18,18
0.785338944494996,0.811600471095528,0.717854217854218,1067,224,35,33,19,12,16,21
0.728680645823356,0.750390214439393,0.706796311146752,1073,218,47,44,19,16,28,28
0.744204145162612,0.773298220377333,0.655125899280576,1100,191,39,40,17,13,22,27
0.672099636032757,0.689430912353775,0.693618447180302,1078,213,35,32,11,13,24,19
0.766722000885348,0.791272420597956,0.74290600761189,1064,227,36,33,21,17,15,16
0.753821656050955,0.783341447511058,0.737532231598687,1083,208,35,27,14,10,21,17
0.739873837981408,0.763140665852634,0.749285497111584,1044,247,36,26,18,11,18,15
0.717248312152502,0.745945848986854,0.638351254480287,1036,255,32,31,13,8,19,23
0.734448780487805,0.757959963908041,0.668702325799055,1052,239,41,34,21,11,20,23
0.699868528815897,0.73662843186679,0.703745532168388,1076,215,37,32,17,15,20,17
0.743906952154375,0.792512179632402,0.692219152854512,1078,213,30,24,16,12,14,12
0.745097795869738,0.772851688913841,0.705844927044452,1067,224,32,28,14,12,18,16
0.761096824686941,0.787444413062446,0.752814298315621,1047,244,43,38,25,22,18,16
0.753190243902439,0.762210140869884,0.706317737245572,1068,223,41,30,15,8,26,22
0.771473284531709,0.789393182946321,0.704382470119522,1034,257,47,36,26,18,21,18
0.72355550500455,0.750916104976316,0.693446113528944,1073,218,35,34,17,15,18,19
0.691847641669494,0.723327036928558,0.62555672761369,1089,202,28,27,10,7,18,20
0.763079536370903,0.771378696553954,0.68172119487909,1061,230,40,37,15,12,25,25
0.766821845769214,0.802464410815605,0.707676928265164,1062,229,37,33,21,15,16,18
0.732264027329309,0.779233552409024,0.674940428911835,1084,207,34,32,17,13,17,19
0.752581892629663,0.768081079802717,0.69957648930694,1083,208,35,34,17,15,18,19
0.770507279344859,0.826383766321625,0.739396094659252,1064,227,35,37,22,20,13,17
0.741147564676976,0.756442435514633,0.702278545826933,1063,228,33,31,13,12,20,19
0.68429614873838,0.703313787366157,0.664062913031985,1065,226,36,30,11,8,25,22
0.762465753424658,0.796202822976767,0.785107900838238,1041,250,50,45,34,29,16,16
0.72540345703285,0.751225151413682,0.65517585931255,1063,228,39,40,18,16,21,24
0.795942140296979,0.81993178253447,0.750264970853206,1053,238,31,33,14,12,17,21
0.717395756533137,0.739833756089555,0.679742948134668,1036,255,39,35,16,11,23,24
0.779195584458167,0.809444413306924,0.702816180235535,1045,246,29,31,19,15,10,16
0.733388667552014,0.769175443631754,0.713914147620218,1074,217,36,39,17,16,19,23
0.769643975526329,0.797865273454108,0.728727144866385,1061,230,33,27,16,8,17,19
0.690900818926297,0.719658605142149,0.673116574147502,1075,216,35,30,10,8,25,22
0.763851992409867,0.792186167936418,0.718447703858914,1055,236,51,46,28,22,23,24
0.742253658536585,0.755962492853773,0.674946341463415,1048,243,41,41,19,16,22,25
0.772358541163851,0.794661946374583,0.770175609756098,1077,214,48,41,26,23,22,18
0.7217366764726,0.739968524527709,0.699872332225274,1046,245,47,33,22,15,25,18
0.741356097560975,0.769011498921272,0.719718030182685,1068,223,41,32,20,15,21,17
0.733412635474491,0.789495391815459,0.58634436575613,1045,246,30,33,20,15,10,18
0.734749704525525,0.758125829142655,0.683921883360085,1071,220,42,45,21,17,21,28
0.807994936457506,0.818285952179328,0.742178699436764,1050,241,32,31,22,17,10,14
0.749732477260567,0.770441260049506,0.708762128785651,1077,214,45,38,22,17,23,21
0.777763876251137,0.801187735829815,0.752050107453908,1094,197,35,28,19,13,16,15
0.754698478382689,0.773739107790199,0.659384086703674,1064,227,37,30,19,10,18,20
0.745411013567438,0.761068631791696,0.700816603491038,1080,211,38,34,15,11,23,23
0.724156488371005,0.741814542984142,0.72952497952498,1080,211,34,33,12,11,22,22
0.773811442385173,0.789147880118347,0.755048332923732,1031,260,50,39,31,23,19,16
0.792228390166534,0.821279159045441,0.740409311984261,1075,216,30,29,15,10,15,19
0.725662728355838,0.751808685035365,0.672247823860727,1067,224,32,31,15,14,17,17
0.79554763660195,0.812005688392687,0.729504094631483,1053,238,39,35,20,15,19,20
0.709178798908098,0.735190100408829,0.690899455605338,1035,256,35,33,15,13,20,20
0.74361189026476,0.760763390728223,0.68265134758745,1072,219,47,39,22,14,25,25
0.741434262948207,0.773764043856023,0.670724526369688,1070,221,36,31,19,13,17,18
0.735150221992327,0.756893473193359,0.739353736721419,1061,230,37,34,19,18,18,16
0.750876597669947,0.767975838308646,0.71776382762131,1088,203,28,28,13,13,15,15
0.753492370513647,0.788176647813824,0.625216365066876,1073,218,22,20,11,4,11,16
0.72305048902987,0.758428540867091,0.661406003159557,1041,250,30,25,15,14,15,11
0.789817892759069,0.814885998371274,0.727293292613958,1073,218,33,28,19,12,14,16
0.741420296191049,0.763762369626313,0.708905136857893,1062,229,29,21,14,10,15,11
0.768583912965936,0.794214378964237,0.753799049725567,1057,234,45,39,25,23,20,16
0.761551678561988,0.776513482183036,0.683528594122319,1080,211,30,32,14,10,16,22
0.738780778395552,0.767114372706959,0.725738038683407,1072,219,32,28,13,10,19,18
0.761797955897335,0.78415443879646,0.712512867436807,1071,220,49,42,23,18,26,24
0.753870458135861,0.79125033834637,0.671848341232228,1045,246,25,25,11,10,14,15
0.731854673547964,0.752830583946441,0.646868292682927,1069,222,39,41,17,15,22,26
0.814206285253828,0.8287622580968,0.744815800716422,1086,205,50,49,28,21,22,28
0.791316946442846,0.801835823796386,0.765184609568614,1043,248,40,38,23,19,17,19
0.805550039714059,0.825482508941827,0.778006994917755,1083,208,32,29,18,15,14,14
0.777253772835584,0.800136510932726,0.627722443559097,1082,209,32,36,18,13,14,23
0.742555949521522,0.760704735551379,0.736211775218427,1071,220,42,32,17,13,25,19
0.741541104943167,0.770460372211687,0.658666154633896,1078,213,30,31,17,12,13,19
0.791605410173478,0.822330072429821,0.75480900595661,1039,252,38,29,24,14,14,15
0.757955222398729,0.791317653057603,0.766445497630332,1081,210,32,25,14,13,18,12
0.719494961907102,0.744401746452523,0.700215858790098,1065,226,39,29,16,10,23,19
0.74147494398601,0.778254064848305,0.712886597938144,1077,214,29,30,16,14,13,16
0.733910499683744,0.75388116893428,0.657268265918859,1046,245,51,53,26,22,25,31
0.716921204072599,0.738015235899247,0.671518177163339,1048,243,36,31,13,11,23,20
0.765216112907968,0.778623318976562,0.703263071684124,1055,236,38,37,18,15,20,22
0.753375387339531,0.790617907809967,0.715662172878668,1045,246,36,30,20,14,16,16
0.774905732553691,0.796046141065212,0.678621659634318,1072,219,29,27,14,11,15,16
0.671615424212645,0.698805792491468,0.628751746398805,1094,197,34,33,12,8,22,25
0.763147393623724,0.78673269917404,0.772482157018239,1053,238,38,30,20,14,18,16
0.737724014336917,0.769411067852772,0.731787777439951,1061,230,31,26,14,11,17,15
0.680887804878049,0.706660190629765,0.653084372259713,1064,227,41,42,18,16,23,26
0.755379328575205,0.782639761414977,0.71162629070691,1078,213,30,32,18,17,12,15
0.76435434061535,0.795566640480761,0.734788264200029,1050,241,42,33,27,18,15,15
0.78862537888097,0.815586825297141,0.761718938189526,1051,240,39,33,21,16,18,17
0.761470823341327,0.777196962345531,0.71408809207614,1073,218,40,36,22,19,18,17
0.686048221111438,0.713061768799949,0.687285223367697,1082,209,38,30,16,12,22,18
0.768880124143282,0.800182637647891,0.737118193891102,1063,228,37,36,22,20,15,16
0.755915623804579,0.771132822412203,0.755311102341489,1087,204,29,24,12,10,17,14
0.708765496769687,0.731196684769335,0.692446941323346,1075,216,46,45,20,19,26,26
0.719556402064389,0.741054465118498,0.716032249537404,1070,221,39,30,13,8,26,22
0.794042846674426,0.821941805410133,0.680273937532002,1051,240,37,31,24,15,13,16
0.753345533569713,0.780022971774245,0.74763998448209,1091,200,42,37,21,18,21,19
0.761421389146948,0.803251911262815,0.657180720257938,1063,228,29,29,14,12,15,17
0.688375796178344,0.708092109002913,0.6410097299444,1084,207,35,32,14,11,21,21
0.739898081534772,0.754434778224179,0.720037683296469,1037,254,40,39,19,16,21,23
0.80773013375295,0.832943251837011,0.687960405156538,1090,201,20,24,11,9,9,15
0.739364763169544,0.765030568782554,0.761875511875512,1047,244,36,33,13,12,23,21
0.728777668585334,0.759517379846904,0.692017305734645,1088,203,34,28,16,9,18,19
0.723493080178429,0.743868567226399,0.708825135464359,1031,260,42,38,22,17,20,21
0.72860375805788,0.744031581375294,0.699842643587726,1073,218,23,20,10,7,13,13
0.783178904019842,0.803549385809752,0.748092607208629,1068,223,34,24,16,9,18,15
0.752692682926829,0.773808719093357,0.698555046834964,1060,231,41,38,21,17,20,21
0.724493084857009,0.746090024502871,0.755230596175478,1088,203,27,21,8,7,19,14
0.667649398661613,0.693032630614726,0.657496955369296,1086,205,34,22,12,8,22,14
0.817898629864972,0.839405972098581,0.725409626216078,1070,221,32,31,22,17,10,14
0.694042772240161,0.716084060670133,0.707893873982185,1071,220,34,29,14,11,20,18
0.745433208913019,0.767647792900947,0.641974971309908,1071,220,28,29,15,10,13,19
0.717431087727325,0.742776088257994,0.697249881460408,1075,216,42,37,17,15,25,22
0.740320746132848,0.767517623455274,0.690338355802273,1085,206,35,30,16,11,19,19
0.695257697315915,0.716501179390817,0.680635674697433,1058,233,38,28,15,10,23,18
0.755584789515489,0.77094556087235,0.688125568698817,1051,240,32,35,15,13,17,22
0.764358513189448,0.78653735029451,0.728839545334391,1066,225,40,30,17,11,23,19
0.703996718237225,0.726546109780009,0.694800851322591,1082,209,27,26,9,7,18,19
0.687400318979266,0.714304067285448,0.666013722886233,1091,200,37,36,14,11,23,25
0.770920653273594,0.813862162528193,0.814104739282887,1083,208,33,28,20,17,13,11
0.759531374106434,0.776941618836555,0.744521249359959,1058,233,32,31,14,14,18,17
0.745540061974325,0.778979120134826,0.721219718030183,1081,210,36,32,17,15,19,17
0.765946090205498,0.806615845361677,0.687649075730471,1048,243,42,43,25,21,17,22
0.755379890809827,0.79578810036382,0.760971609546431,1054,237,35,28,17,12,18,16
0.83026113671275,0.854069770628689,0.819905213270142,1064,227,31,25,19,14,12,11
0.692631395145801,0.715152428473202,0.642809485683785,1054,237,46,42,21,15,25,27
0.760078048780488,0.788438206189863,0.702934485896269,1066,225,41,35,21,15,20,20
0.794959988768777,0.822270920310476,0.680818519053813,1064,227,34,33,19,11,15,22
0.727701027921557,0.757963005221956,0.663329336530775,1062,229,44,40,20,16,24,24
0.781030789263662,0.821470715075537,0.789962271644162,1072,219,38,32,25,22,13,10
0.740328563857976,0.75776073928814,0.752745987897922,1073,218,33,24,11,8,22,16
0.767857142857143,0.789968084380172,0.658406026962728,1034,257,31,30,18,14,13,16
0.717353806130528,0.743084852124389,0.756795378534509,1084,207,28,26,12,8,16,18
0.775301929067162,0.797072082123973,0.66358166922683,1084,207,29,31,15,11,14,20
0.681933297663635,0.699333631596633,0.688731937931297,1065,226,45,42,17,14,28,28
0.737967914438503,0.772460955458326,0.738346405877681,1051,240,33,32,18,18,15,14
0.744664450546804,0.779637327302071,0.66580982711556,1061,230,33,35,16,12,17,23
0.71219011949349,0.737754006872275,0.692458728887872,1062,229,45,42,19,17,26,25
0.728921505237295,0.747884140431899,0.721940259053661,1046,245,37,30,15,10,22,20
0.745792791898332,0.78668048630961,0.763349193761565,1078,213,32,30,15,14,17,16
0.734716688800354,0.757937698171056,0.611853832442068,1030,261,36,33,20,13,16,20
0.752050375446526,0.787855102370559,0.712142623085115,1078,213,44,39,23,18,21,21
0.688778510522115,0.719554953274603,0.620038224051749,1064,227,38,38,19,15,19,23
0.747642762284197,0.76832200390486,0.666145339652449,1084,207,36,25,15,6,21,19
0.74156050955414,0.759995228964638,0.715543219666931,1067,224,35,30,18,13,17,17
0.821792538671519,0.853536746098953,0.678802453060024,1069,222,35,38,22,17,13,21
0.73250028594304,0.750876541918882,0.694958327311268,1063,228,42,33,17,12,25,21
0.695037173940438,0.723763597506142,0.659011776753712,1055,236,38,31,17,11,21,20
0.780087094220111,0.807322596718112,0.736667680145941,1058,233,28,26,16,12,12,14
0.715136304448271,0.741521277071274,0.67820746132848,1041,250,38,35,16,13,22,22
0.724795268425842,0.76845647977569,0.67622970564147,1064,227,35,33,20,16,15,17
0.669457820581416,0.697263772303512,0.649112030690978,1069,222,45,37,17,14,28,23
0.773008883297114,0.797090728769224,0.685562015503876,1067,224,42,43,22,19,20,24
0.729328575204864,0.767614083907783,0.645349472648779,1064,227,30,29,16,10,14,19
0.689478417266187,0.72616604032641,0.683817679816557,1091,200,40,34,14,10,26,24
0.821773909985935,0.842615441576095,0.761607849790748,1079,212,27,28,16,13,11,15
0.760519172039362,0.777526657468324,0.738135860979463,1063,228,28,25,16,12,12,13
0.78182059064412,0.811825926504644,0.764368646721588,1086,205,33,33,17,15,16,18
0.719034772182254,0.746807060160766,0.706394884092726,1056,235,40,40,19,16,21,24
0.757620564149227,0.807931564203323,0.762202255603912,1085,206,35,34,19,15,16,19
0.7820885509839,0.809125819397399,0.742239677405805,1057,234,43,38,25,20,18,18
0.771858884200656,0.822018079640525,0.733538704581359,1067,224,27,25,18,14,9,11
0.703562074384494,0.725336118936426,0.64565131056394,1025,266,46,32,22,13,24,19
0.732751784298176,0.763082206741939,0.678782817627754,1108,183,30,27,14,13,16,14
0.714240978946861,0.735384537766471,0.672073578595318,1069,222,33,26,15,12,18,14
0.73023558317676,0.747017367725999,0.693140529770277,1085,206,33,27,12,9,21,18
0.670781020246578,0.700672317110386,0.663798275215598,1073,218,28,21,10,8,18,13
0.764282926829268,0.793979142092235,0.686033643204958,1067,224,41,36,24,16,17,20
0.78276347292813,0.798988181728548,0.675514049315966,1067,224,38,39,16,14,22,25
0.717854217854218,0.74036358583119,0.642871326449563,1043,248,37,32,15,12,22,20
0.81592039800995,0.868193473477278,0.804386951631046,1076,215,18,21,14,13,4,8
0.729036334913112,0.777710078431292,0.657781846002514,1091,200,25,29,9,9,16,20
0.761908503579536,0.782467580493448,0.756647204603688,1067,224,46,38,25,22,21,16
0.731381526441803,0.761634121650551,0.65171594076179,1067,224,38,29,22,14,16,15
0.726958831341301,0.747088545008542,0.71949499545041,1067,224,36,35,17,17,19,18
0.690719406041987,0.709521505138643,0.667025089605735,1076,215,31,31,8,7,23,24
0.738589139165357,0.764158209311714,0.68271382893685,1057,234,46,40,25,18,21,22
0.733975210270031,0.75875230880308,0.657040450588838,1083,208,36,31,15,10,21,21
0.778917073170732,0.798031599474344,0.719167027990557,1063,228,41,33,22,15,19,18
0.678862192216044,0.711114798346274,0.632206677960544,1083,208,32,29,13,10,19,19
0.761591709674777,0.785894283466233,0.724791636556342,1083,208,39,33,18,12,21,21
0.680204606440071,0.702818353762351,0.705785999903647,1074,217,43,33,16,15,27,18
0.744047619047619,0.777853643945918,0.693878983574337,1049,242,31,34,18,16,13,18
0.759408602150538,0.793773282311591,0.795218363588529,1073,218,31,24,15,11,16,13
0.764342629482072,0.791938068472957,0.719178643641729,1083,208,36,29,17,13,19,16
0.653419654714475,0.691468562391205,0.679685434840074,1073,218,36,30,14,13,22,17
0.678123399897593,0.719728309191958,0.596100554235946,1068,223,31,28,15,8,16,20
0.740557402322108,0.764554674713086,0.683443305723244,1061,230,33,34,14,11,19,23
0.721672576156163,0.746835219828227,0.648669326192688,1081,210,42,29,18,10,24,19
0.692868580578749,0.716516734176362,0.670185922974768,1050,241,42,36,19,16,23,20
0.747638841759982,0.784073436912928,0.710496922160445,1075,216,28,32,15,16,13,16
0.762851232899156,0.791697137012155,0.762150019857029,1059,232,39,32,25,19,14,13
0.716746794871795,0.737614316365306,0.680993539374891,1070,221,43,46,16,14,27,32
0.714961670631774,0.735661550323233,0.648441162681669,1075,216,30,27,11,9,19,18
0.758331707317073,0.790919086318567,0.670596703733122,1061,230,41,32,24,16,17,16
0.740435815515688,0.758863605548552,0.692919649960223,1047,244,39,34,20,15,19,19
0.788572230801628,0.808110361800192,0.727293841193508,1068,223,34,29,19,13,15,16
0.758460047704234,0.781061633643733,0.715817492133282,1076,215,43,37,24,20,19,17
0.703512046148626,0.729778289125745,0.624424493554328,1052,239,28,24,14,9,14,15
0.687778794464143,0.728667400357982,0.607971828349478,1064,227,42,34,20,15,22,19
0.742302684084513,0.761524558129269,0.693055354820061,1082,209,38,33,18,12,20,21
0.767148717027456,0.795426252112398,0.715095163261743,1055,236,54,46,31,23,23,23
0.755948532264322,0.777446012259803,0.71089626933576,1082,209,37,35,19,17,18,18
0.691533864541833,0.724224344651308,0.699312714776632,1056,235,36,30,13,8,23,22
0.803993220091857,0.820267088463225,0.753358728598345,1057,234,44,39,26,20,18,19
0.776442307692308,0.808648054100234,0.736033519553073,1075,216,43,38,23,16,20,22
0.768331165389989,0.799872235677338,0.725703001579779,1058,233,33,25,17,11,16,14
0.791306954436451,0.8134475289384,0.701119049354815,1071,220,40,44,21,17,19,27
0.679303208592735,0.703437288036662,0.642614634146342,1062,229,47,41,22,16,25,25
0.712515793907062,0.735565595171491,0.684027777777778,1077,214,34,27,15,10,19,17
0.731203073162214,0.753062336742573,0.724481658692185,1076,215,46,37,22,19,24,18
0.779053316123908,0.811061447273299,0.737279090548054,1080,211,32,32,18,16,14,16
0.740198270721527,0.771524636102829,0.72409008189263,1086,205,43,35,21,16,22,19
0.673992943251985,0.695920793758907,0.661149513568869,1056,235,38,31,14,10,24,21
0.714503328213006,0.740611078280478,0.65947592764632,1059,232,31,29,13,8,18,21
0.765410146989094,0.786833350714145,0.706650831353919,1062,229,37,28,16,12,21,16
0.80966787989081,0.828931679563927,0.711166445329792,1087,204,35,36,19,13,16,23
0.753497458877534,0.795504320972483,0.655182684670373,1076,215,29,32,16,13,13,19
0.761146496815287,0.790532685787865,0.74949414655297,1056,235,35,33,21,20,14,13
0.744465913386819,0.76987310032422,0.750329845313922,1094,197,38,35,19,18,19,17
0.742025518341308,0.761631293921966,0.742002697885051,1088,203,37,33,16,14,21,19
0.74249156076251,0.769060124188631,0.661085509472606,1072,219,32,31,16,13,16,18
0.694871668474153,0.708834636896182,0.643972807465189,1059,232,49,44,18,16,31,28
0.765280831070305,0.789934372355812,0.770657524613221,1067,224,37,27,20,14,17,13
0.738532784475154,0.760317690151793,0.69487401840343,1066,225,38,33,20,15,18,18
0.775213172596295,0.79542304944253,0.716837484773386,1070,221,38,38,19,15,19,23
0.753639024390244,0.776858674327411,0.706130573248408,1074,217,41,35,19,15,22,20
0.782073517367635,0.826562384704515,0.792780410742496,1070,221,33,25,18,13,15,12
0.74049135577798,0.807631900714996,0.72551778785726,1063,228,35,29,22,16,13,13
0.679792990468626,0.710904773878614,0.685076865391826,1063,228,32,21,13,7,19,14
0.75464807436919,0.782058167164228,0.781608280254777,1072,219,36,35,18,17,18,18
0.806350710900474,0.841380001498389,0.771128608923884,1055,236,25,21,17,12,8,9
0.769072080441554,0.801256609518116,0.716982622432859,1069,222,29,25,17,12,12,13
0.790669722719141,0.815127116156331,0.778089756188872,1065,226,43,34,23,19,20,15
0.739055299539171,0.766616055925427,0.709740946338885,1066,225,31,30,17,15,14,15
0.791455218762858,0.812739325157649,0.694208760852407,1045,246,23,24,13,8,10,16
0.755994340746624,0.784013488417551,0.708488858726388,1085,206,32,28,16,13,16,15
0.761098857595295,0.803558502545291,0.70240518268467,1048,243,28,32,18,16,10,16
0.737561055624408,0.753332699680621,0.679377880184332,1065,226,44,31,19,12,25,19
0.793835304822566,0.815238157304938,0.769289099526066,1052,239,35,25,17,10,18,15
0.733155156877202,0.76779730948407,0.713618513858706,1076,215,39,42,21,22,18,20
0.766824363070369,0.814128426866445,0.731714165379756,1062,229,39,34,21,16,18,18
0.638558986539984,0.658324536894418,0.655766192733017,1080,211,28,25,8,8,20,17
0.779761904761905,0.802482241009116,0.784349513285977,1078,213,31,24,17,11,14,13
0.736257439967162,0.765772533914136,0.70471026886502,1077,214,47,47,21,19,26,28
0.813727172213962,0.827928182197917,0.740958662011294,1056,235,42,37,26,20,16,17
0.741071428571428,0.775138874872739,0.665860215053763,1084,207,24,31,13,14,11,17
0.784031783734872,0.805726975437226,0.657727198207552,1088,203,28,29,15,10,13,19
0.757743362831858,0.777646951856524,0.768380847054968,1067,224,48,39,23,19,25,20
0.755389552899513,0.782727965010587,0.695317983995508,1068,223,36,34,21,17,15,17
0.663049560351719,0.698132466406978,0.676742852461702,1055,236,40,39,17,16,23,23
0.790516452281158,0.816318681177208,0.63588421887391,1063,228,33,30,14,10,19,20
0.749359432099802,0.77459256286843,0.724226683513501,1065,226,38,34,18,15,20,19
0.789831665150136,0.809787606771461,0.72355273592387,1082,209,35,30,21,14,14,16
0.762574752191366,0.781315230998563,0.686839949997845,1064,227,39,37,20,14,19,23
0.75904145839459,0.786005095009504,0.709930272825121,1076,215,38,34,16,15,22,19
0.765065369413196,0.802873846733019,0.740110584518168,1080,211,26,25,14,11,12,14
0.763786482334869,0.788525007274037,0.64123312152502,1051,240,31,32,18,12,13,20
0.680932069510269,0.695534981362004,0.636452550885541,1074,217,25,30,8,10,17,20
0.692299818016379,0.721788946702293,0.705645161290323,1069,222,35,31,15,11,20,20
0.766336241078509,0.806687790712369,0.834870641169854,1063,228,30,21,17,15,13,6
0.704790243902439,0.728172053246373,0.650615377415883,1051,240,41,34,17,11,24,23
0.730662681344317,0.767821001739717,0.675759984583514,1053,238,44,33,24,14,20,19
0.650553342186808,0.668409785437178,0.661668352844824,1056,235,36,33,12,12,24,21
0.669020866773676,0.696539173000239,0.708898643256185,1074,217,45,38,18,16,27,22
0.742488900383637,0.776674977088525,0.692260442260442,1042,249,37,33,23,20,14,13
0.710785091197462,0.734651095380259,0.636965842848196,1063,228,30,33,12,11,18,22
0.798011089175453,0.824855352343144,0.78630258786092,1076,215,38,34,23,17,15,17
0.799730211494918,0.81795234797795,0.744787529785544,1064,227,33,32,20,18,13,14
0.815779872301612,0.860741326018604,0.768183254344392,1072,219,26,25,16,12,10,13
0.768616367657901,0.79456229992104,0.713044428657304,1072,219,39,29,21,11,18,18
0.759045331503298,0.783900982148311,0.694146299409457,1059,232,42,37,19,14,23,23
0.623539807750334,0.653005811595061,0.606994404476419,1081,210,37,40,14,13,23,27
0.725570214669052,0.769679847490274,0.678443649373882,1078,213,43,43,23,20,20,23
0.714387664373625,0.74444224040725,0.725017374900715,1051,240,34,32,16,14,18,18
0.8044951350278,0.833429479833837,0.616219884628436,1056,235,32,28,17,10,15,18
0.748063001922859,0.788579408239668,0.739339441239679,1064,227,28,28,15,13,13,15
0.715356827823749,0.733973379331058,0.689674634794157,1075,216,38,36,14,13,24,23
0.739548361310951,0.760933086214644,0.716646682653877,1058,233,40,40,18,18,22,22
0.721796484806893,0.747987243832515,0.66436192615471,1047,244,42,34,19,14,23,20
0.721137671536078,0.74306934015364,0.679408710858517,1074,217,36,29,11,9,25,20
0.767256195043965,0.81502448033738,0.750794912559618,1061,230,40,33,22,16,18,17
0.744193404939454,0.759135401382058,0.718813145754699,1050,241,47,42,22,20,25,22
0.776532215819801,0.803031658691848,0.698114000084009,1054,237,46,38,26,18,20,20
0.72040708432461,0.755863490302503,0.665798453139217,1079,212,30,35,12,10,18,25
0.755172636751584,0.781516646521928,0.692872853198559,1065,226,37,34,18,14,19,20
0.800810379757748,0.829304899317288,0.771479774705581,1076,215,37,31,21,15,16,16
0.687730400589826,0.728521597218638,0.676597219305246,1074,217,39,38,17,14,22,24
0.775031210986267,0.792918070554421,0.685233281856896,1065,226,45,34,23,12,22,22
0.771808088818398,0.804082346976396,0.655534721324195,1073,218,30,37,18,17,12,20
0.768319121260298,0.792487361870155,0.692091824444766,1072,219,33,33,18,15,15,18
0.7012,0.730755991876308,0.670136643820854,1045,246,41,37,19,15,22,22
0.717709281164695,0.737546391703918,0.701331285202253,1053,238,35,31,16,11,19,20
0.807360173853368,0.827324211194532,0.747788853011372,1057,234,42,34,27,18,15,16
0.764439324116743,0.794042162919721,0.675032231598687,1060,231,31,27,18,12,13,15
0.751837096060204,0.780690243271376,0.719371778195308,1064,227,36,33,18,16,18,17
0.723526703499079,0.768822806745468,0.70253993191935,1066,225,24,18,13,7,11,11
0.75374203821656,0.774205940862816,0.695995241871531,1047,244,35,30,18,11,17,19
0.719438125568699,0.748941711766698,0.68653150096143,1053,238,35,28,17,9,18,19
0.757193448428508,0.785872066347591,0.73441712926249,1072,219,36,30,17,14,19,16
0.727420031263106,0.756703732656013,0.703406561095476,1052,239,42,38,21,17,21,21
0.735308056872038,0.764420670892256,0.703540519276161,1059,232,25,20,10,6,15,14
0.786199645861,0.801631628693906,0.730990783410138,1068,223,36,31,19,13,17,18
0.728725038402458,0.758207058141515,0.761049723756906,1058,233,31,24,17,15,14,9
0.755347515236756,0.80101426524476,0.699486977111286,1070,221,27,24,14,10,13,14
0.688131112873381,0.720436454542125,0.64073488045007,1099,192,30,27,12,6,18,21
0.715644045944679,0.73999553169011,0.675574940523394,1068,223,27,30,11,8,16,22
0.723771580345286,0.737746577298538,0.696507329776956,1070,221,36,38,13,12,23,26
0.817679816556694,0.839440412486118,0.776572490300016,1083,208,34,29,18,13,16,16
0.746549111165725,0.773396114358193,0.708511219221604,1063,228,39,32,19,13,20,19
0.731475494633389,0.754228019433463,0.710560401797515,1071,220,37,30,19,14,18,16
0.718253968253968,0.746905283260599,0.619569375375704,1069,222,31,29,13,11,18,18
0.69425630810093,0.725623306431758,0.627610362146445,1065,226,36,30,17,10,19,20
0.749061591329633,0.776598020003752,0.612932211101001,1066,225,30,35,12,9,18,26
0.732673860911271,0.741987893417937,0.731060005286809,1032,259,40,30,15,11,25,19
0.70240518268467,0.728199114044001,0.619249847910525,1077,214,32,34,13,13,19,21
0.811675677889735,0.831591103432792,0.764483220810167,1015,276,39,32,24,19,15,13
0.742117620751342,0.766131776191806,0.703833030027298,1090,201,43,35,20,14,23,21
0.733013589128697,0.755315850247256,0.731330234617087,1070,221,40,36,21,18,19,18
0.743725099601594,0.762528341230695,0.712142623085115,1064,227,36,39,13,14,23,25
0.741449052739375,0.766440105528797,0.69474004256613,1067,224,31,26,16,13,15,13
0.733784922083392,0.760227001209502,0.727320291173794,1042,249,34,35,16,15,18,20
0.706773618538324,0.752637256833047,0.695411392405063,1081,210,33,27,16,13,17,14
0.743086189345097,0.752592165894339,0.701328597737437,1093,198,28,24,8,6,20,18
0.78180672761369,0.804066831944744,0.765635715265396,1074,217,27,23,14,9,13,14
0.789054999314223,0.813122207257758,0.730711369009241,1068,223,23,22,12,10,11,12
0.76374277896017,0.782173195603673,0.625331327458987,1084,207,26,22,11,5,15,17
0.782419922995003,0.801833044532202,0.780840448768864,1059,232,39,32,22,18,17,14
0.735044525929806,0.769877776599025,0.664532954006638,1053,238,46,37,23,14,23,23
0.750205110173465,0.774397918571041,0.657783520826999,1073,218,27,26,13,8,14,18
0.763346341463415,0.786392140973225,0.650508293204922,1063,228,41,45,20,16,21,29
0.78094000136827,0.801536576646276,0.742883181780946,1024,267,47,39,28,20,19,19
0.721530531324346,0.752137880368683,0.689449680754029,1073,218,30,26,14,10,16,16
0.799249317561419,0.83155261521631,0.74456780333069,1092,199,35,30,20,17,15,13
0.71234076433121,0.740706459242911,0.703360802223987,1081,210,35,32,15,11,20,21
0.645020372159449,0.662522574133969,0.594585987261147,1056,235,38,35,13,9,25,26
0.780459603989016,0.814548473939868,0.66624056791104,1054,237,33,32,18,13,15,19
0.676853958143767,0.702315875399587,0.683548281326848,1054,237,35,29,17,13,18,16
0.742740150509075,0.781401828315154,0.682647760774954,1044,247,36,34,21,16,15,18
0.742220038373344,0.770038645594412,0.672270578875942,1032,259,34,34,19,18,15,16
0.6919595314164,0.722758011723153,0.716145339652449,1055,236,39,25,19,12,20,13
0.747098600776826,0.776487095215824,0.745020481310804,1060,231,34,31,19,14,15,17
0.732258064516129,0.751761405584718,0.670750847155342,1059,232,51,45,21,18,30,27
0.793180740549162,0.822876635650558,0.830913978494624,1096,195,37,31,19,16,18,15
0.833230926779314,0.845762634595279,0.786873599650254,1063,228,31,29,20,17,11,12
0.748487839711009,0.774585306088652,0.705748309320788,1051,240,38,38,16,11,22,27
0.778872009778244,0.783779796782679,0.728000713393972,1047,244,46,45,24,18,22,27
0.735223642172524,0.756243258126915,0.726018149623727,1082,209,39,36,14,11,25,25
0.659258416742493,0.679001358008871,0.652590837282781,1073,218,35,25,13,10,22,15
0.73283331178068,0.775897647857404,0.74289342180716,1072,219,37,39,19,20,18,19
0.771374420890074,0.793686001172676,0.751141779189833,1084,207,34,32,17,16,17,16
0.759606020362993,0.7799985383349,0.769824840764331,1069,222,36,35,15,15,21,20
0.742775234174823,0.771100704142367,0.696089950270507,1079,212,38,29,21,13,17,16
0.74398463418893,0.771161175620368,0.718969210736338,1064,227,46,38,24,17,22,21
0.715125803335154,0.736788256327189,0.685418641390205,1071,220,38,25,14,9,24,16
0.739237807100678,0.7690163114548,0.735644978367707,1064,227,44,38,24,19,20,19
0.702899513058876,0.732507543438357,0.693914922656961,1050,241,36,35,14,11,22,24
0.727979981801638,0.745487139475087,0.672992370360791,1065,226,35,37,12,12,23,25
0.722529088083337,0.745732830522908,0.651019181376032,1072,219,38,29,19,9,19,20
0.736087804878049,0.761440460228759,0.741368085017012,1069,222,41,38,21,20,20,18
0.739072804862279,0.775880280677609,0.711077108038691,1068,223,37,29,16,10,21,19
0.739557695737471,0.755189122655878,0.720225560391221,1066,225,45,34,19,13,26,21
0.739671566752282,0.76443041882837,0.636247040252565,1074,217,29,24,15,8,14,16
0.668565853658537,0.69897877390326,0.656979601867781,1080,211,41,39,17,15,24,24
0.737967229902714,0.76869044976474,0.676771653543307,1058,233,31,21,13,8,18,13
0.751186625782333,0.773979449244424,0.705195837548779,1062,229,38,33,17,15,21,18
0.797585560243788,0.819920899935318,0.830209155485399,1065,226,27,24,15,13,12,11
0.703285827395091,0.726733760689941,0.66310428701733,1071,220,28,26,14,12,14,14
0.691430665114876,0.716874561420776,0.663296178343949,1073,218,37,35,14,11,23,24
0.667148431854314,0.691849724229293,0.632256596906278,1069,222,33,35,15,11,18,24
0.719840803125131,0.736881884552442,0.694864984506419,1089,202,38,36,15,13,23,23
0.746968952240518,0.770681921624494,0.698351040283311,1056,235,39,36,20,15,19,21
0.741020153379704,0.762020252328397,0.679745067225423,1064,227,45,46,23,20,22,26
0.713470434432824,0.729556697302988,0.719271706641394,1055,236,48,44,21,18,27,26
0.714638289368505,0.750279654290282,0.651919603477969,1079,212,40,38,18,12,22,26
0.728031671357164,0.762020840489881,0.667410233199707,1062,229,38,37,17,14,21,23
0.664078737010392,0.68813664285776,0.586589058776807,1067,224,40,32,16,9,24,23
0.851255617234999,0.867695862094633,0.755546751188589,1075,216,30,29,19,14,11,15
0.786747157096729,0.815729024582492,0.781853026698388,1075,216,34,30,19,16,15,14
0.706985365853658,0.724689416957114,0.722791766586731,1071,220,41,40,17,16,24,24
0.714797136038186,0.756031719366897,0.709959563994374,1070,221,34,27,11,8,23,19
0.762286536934075,0.790421718779394,0.72972972972973,1069,222,32,33,17,15,15,18
0.72416067146283,0.756462229993528,0.638043768348012,1084,207,40,42,17,17,23,25
0.700612055303569,0.740514599108107,0.602880184331797,1070,221,29,31,12,9,17,22
0.774525316455696,0.805565877086318,0.769296854348401,1052,239,27,30,18,18,9,12
0.780361677725895,0.805606042424457,0.793074279672218,1072,219,39,30,20,11,19,19
0.737660469234174,0.766887432420737,0.721460189081371,1063,228,36,29,16,12,20,17
0.745239024390244,0.767232410482162,0.724730215827338,1064,227,41,40,21,19,20,21
0.788182438580528,0.816024127780729,0.740316511730854,1079,212,35,36,19,18,16,18
0.657075736023104,0.682768188687092,0.642857142857143,1059,232,37,31,15,10,22,21
0.776580560625205,0.793775356876239,0.702365467071349,1056,235,34,33,17,13,17,20
0.832753647777401,0.851325606764392,0.771495895408939,1083,208,28,26,18,15,10,11
0.651925630810093,0.673482975134902,0.647165409054805,1079,212,36,32,9,7,27,25
0.685427422557585,0.711680259144176,0.642201151707705,1081,210,32,32,15,14,17,18
0.727300065612014,0.754352672845162,0.700818926296633,1077,214,44,35,20,16,24,19
0.749139837797985,0.784972013490842,0.70129583735876,1066,225,39,38,23,14,16,24
0.808155164447431,0.825223462096338,0.796915131974425,1056,235,38,29,23,17,15,12
0.798513754396107,0.81671610611715,0.802114949173773,1057,234,33,33,19,19,14,14
0.717436716637995,0.737898329431243,0.692837755627311,1051,240,39,34,19,17,20,17
0.781986390557399,0.818729057623587,0.694394154920471,1090,201,38,37,20,13,18,24
0.743521644162033,0.754859267164999,0.703745724809261,1068,223,32,24,15,11,17,13
0.817554982448599,0.842846984641628,0.771473601260835,1069,222,22,22,15,12,7,10
0.713475738396624,0.732865924820353,0.7143232095988,1076,215,27,21,9,5,18,16
0.714695565976591,0.727691950009611,0.690836728693241,1065,226,42,38,17,13,25,25
0.775727934485896,0.805615647113731,0.680003743740933,1062,229,35,34,17,11,18,23
0.711415581223888,0.738234708521817,0.648287324757913,1066,225,39,33,16,11,23,22
0.734626216077829,0.775182735499857,0.695730901401004,1050,241,31,30,17,12,14,18
0.7229088639201,0.748708460067471,0.694087804878049,1055,236,45,41,23,18,22,23
0.780495896629998,0.803127546116192,0.73810476952991,1069,222,46,42,26,18,20,24
0.75017548785624,0.782265284072671,0.667268873151226,1071,220,34,33,20,15,14,18
0.732158608812534,0.753294247056408,0.750573801847096,1073,218,38,29,16,9,22,20
0.678602399190634,0.69800185071734,0.655224743460038,1054,237,33,33,11,11,22,22
0.712254866224393,0.743871080212747,0.729072373809216,1097,194,44,37,21,16,23,21
0.807489821704338,0.844766198939002,0.79116345155473,1093,198,34,29,19,14,15,15
0.754940711462451,0.786988863251287,0.687387288922892,1054,237,26,29,15,14,11,15
0.783191085822665,0.807780369464285,0.752308153477218,1053,238,37,40,19,19,18,21
0.817146023028376,0.853165714801523,0.787611344882234,1103,188,33,29,20,17,13,12
0.775601638504864,0.79912320429802,0.688743556390615,1066,225,31,33,17,15,14,18
0.772656960873521,0.79300395895196,0.676980778246601,1070,221,35,27,20,12,15,15
0.787881219903692,0.803566491286827,0.713697651951107,1089,202,45,38,22,17,23,21
0.741570731707317,0.764364550589172,0.793614581870935,1066,225,41,34,19,19,22,15
0.75608228549405,0.797989008599602,0.661055438349742,1046,245,33,27,20,10,13,17
0.746946981731533,0.78524197688832,0.624802058590657,1062,229,32,28,14,10,18,18
0.808066075745367,0.823867983008702,0.815336585365854,1085,206,50,41,29,25,21,16
0.733453237410072,0.747439996775865,0.729347540121021,1102,189,40,24,15,12,25,12
0.741242690857424,0.762575191569768,0.688480550182678,1078,213,29,22,10,6,19,16
0.780219008844588,0.829577212202183,0.754676145339652,1066,225,34,25,22,15,12,10
0.769431068307473,0.791423996115733,0.695834146341463,1054,237,45,41,24,17,21,24
0.803885436238377,0.837205512836909,0.747856946920861,1071,220,33,23,18,11,15,12
0.761035576292192,0.769468650178901,0.730038671519563,1052,239,44,35,20,14,24,21
0.725699383594121,0.762047029670053,0.762730645083586,1054,237,37,33,19,19,18,14
0.746204878048781,0.775480068034601,0.723875595710882,1034,257,41,32,20,14,21,18
0.704416138626665,0.737238677409064,0.70315059144677,1078,213,37,35,19,18,18,17
0.758453718566078,0.78027238446971,0.70673339399454,1108,183,45,35,19,12,26,23
0.74922988752776,0.776626612267432,0.703238054301884,1056,235,22,22,9,11,13,11
0.851519062748213,0.867015568161364,0.715883141382049,1089,202,32,32,18,16,14,16
0.766094176524113,0.792891202134509,0.701329155402638,1059,232,35,39,21,19,14,20
0.746591511297394,0.782085193278078,0.710688684075781,1062,229,33,31,17,16,16,15
0.755783359809373,0.784251012583838,0.678105142970612,1075,216,32,32,17,12,15,20
0.694669634981308,0.712542694752451,0.649369189907039,1062,229,38,36,13,12,25,24
0.776015156656487,0.812576113368529,0.698635289060821,1064,227,28,22,15,12,13,10
0.765657474020783,0.796107473332446,0.703745801589252,1074,217,40,39,23,19,17,20
0.765735411109551,0.793220860909331,0.772058376406202,1078,213,34,26,18,13,16,13
0.69875856717962,0.744197838140536,0.661289279710332,1049,242,37,37,20,18,17,19
0.792137707872532,0.813262738741189,0.714401226530012,1057,234,39,38,23,20,16,18
0.737329390354868,0.756871495163995,0.779053316123908,1078,213,35,32,17,16,18,16
0.733934169278997,0.760504925860889,0.703678048780488,1054,237,44,41,23,18,21,23
0.739331768038163,0.778152530162501,0.717974379503603,1051,240,43,42,25,23,18,19
0.670343999062354,0.720597529239368,0.614815017214056,1070,221,27,29,11,9,16,20
0.748281786941581,0.782019389158813,0.765181674565561,1070,221,30,25,12,10,18,15
0.644435104961421,0.661593209304917,0.674353906962603,1070,221,37,26,12,10,25,16
0.692352172164119,0.70941803921937,0.68252688172043,1060,231,48,31,16,10,32,21
0.680845371856608,0.704538012653789,0.658400214018192,1060,231,45,45,18,15,27,30
0.652445766136719,0.684340635180679,0.639188598089961,1034,257,42,44,16,16,26,28
0.742711404370818,0.775545588246274,0.593484007401533,1065,226,34,30,20,13,14,17
0.707832234148024,0.729800710829143,0.66303457688808,1087,204,37,35,16,13,21,22
0.740081458040319,0.770896293392209,0.666844025539678,1050,241,27,26,14,9,13,17
0.769363889571557,0.790291554053792,0.690273170731707,1065,226,39,41,20,17,19,24
0.741528446584626,0.756449805729406,0.698953594176524,1060,231,45,35,23,16,22,19
0.747099636032757,0.786698312575684,0.744218009478673,1059,232,35,25,20,13,15,12
0.701560909399389,0.71405933791969,0.617330173775671,1063,228,28,25,11,6,17,19
0.764459423737774,0.7849854503964,0.708909952606635,1067,224,30,25,19,13,11,12
0.748332327701797,0.78261722628495,0.762320143884892,1074,217,48,40,21,19,27,21
0.737177687304039,0.784421596598611,0.670678725613422,1056,235,34,29,16,10,18,19
0.775579536370903,0.807995582229809,0.788517665130568,1069,222,40,31,22,16,18,15
0.790111481501721,0.812253247976151,0.709053661115517,1067,224,29,30,15,12,14,18
0.644884092725819,0.673786651227526,0.635546820160045,1077,214,40,34,15,13,25,21
0.711274177129284,0.75038063799625,0.626026147765278,1052,239,28,26,13,8,15,18
0.742868516833485,0.761211192159875,0.72856577310259,1075,216,35,28,15,11,20,17
0.768696926591664,0.792987855725129,0.719125033042559,1069,222,37,30,20,14,17,16
0.78366524419156,0.822418030367349,0.730030832972009,1085,206,37,33,22,15,15,18
0.67914691943128,0.703791593793175,0.783320240900759,1062,229,25,18,10,11,15,7
0.745975669697714,0.767674594208538,0.694223168136212,1051,240,39,26,19,10,20,16
0.737989608313349,0.760113208903871,0.733337124658781,1054,237,40,35,19,15,21,20
0.77452636968766,0.804243356460275,0.669504567116759,1048,243,31,32,16,12,15,20
0.739785303231518,0.759756930041638,0.681451969898185,1074,217,36,36,15,13,21,23
0.686868134870758,0.707692293082521,0.699079130262113,1074,217,29,32,11,12,18,20
0.770442009540847,0.805060698774603,0.715180421062774,1058,233,43,33,25,16,18,17
0.746286016389109,0.771240220097484,0.665412186379928,1067,224,30,31,15,13,15,18
0.773009338903908,0.805517229177954,0.67126619085382,1057,234,39,30,18,9,21,21
0.754863703200995,0.783967907654539,0.723145218002813,1074,217,28,27,17,13,11,14
0.717089611419508,0.752985057368527,0.67426335174954,1065,226,30,24,16,11,14,13
0.793127147766323,0.834133850903215,0.75640481845945,1067,224,30,28,17,13,13,15
0.795767232907483,0.81577210357253,0.71598263291554,1076,215,34,39,16,15,18,24
0.719389373513085,0.749812066490884,0.718120063191153,1067,224,30,25,14,9,16,16
0.779926877117888,0.804580918600576,0.694429268292683,1063,228,45,41,23,16,22,25
0.69208802103539,0.704270719487524,0.637647209421403,1082,209,37,31,13,7,24,24
0.830730115914559,0.848341242636969,0.804384689922481,1050,241,44,43,30,26,14,17
0.705925259792166,0.72883268952388,0.687346341463415,1089,202,40,41,12,11,28,30
0.704906782568912,0.730072873828053,0.746085657850364,1040,251,42,33,19,17,23,16
0.724570132296313,0.750140311241649,0.686495107547739,1065,226,42,37,22,16,20,21
0.753562074384495,0.782625535776756,0.738593289344377,1059,232,46,34,24,19,22,15
0.761551678561988,0.784189683145936,0.75926435877262,1040,251,30,20,17,9,13,11
0.679106005459509,0.701584317831333,0.614979643408676,1058,233,35,34,13,10,22,24
0.766656674660272,0.791681491478398,0.741549135577798,1053,238,40,35,24,14,16,21
0.758060692271219,0.782653570323,0.666016283663343,1071,220,37,33,14,11,23,22
0.800760109455762,0.833429485079992,0.693477496483826,1080,211,26,27,14,10,12,17
0.776190129036961,0.795032603276218,0.692663414634146,1084,207,44,41,23,15,21,26
0.70365816462694,0.735437685943191,0.708246132848044,1041,250,42,35,17,15,25,20
0.721300850203973,0.746837198871022,0.747897299690128,1076,215,42,36,19,18,23,18
0.755273724691777,0.79193224635725,0.656666666666667,1072,219,28,25,13,11,15,14
0.730595150323585,0.761926842146939,0.683251433251433,1066,225,39,33,21,14,18,19
0.709329188894023,0.730186357244668,0.689041038350065,1075,216,38,38,14,9,24,29
0.769768195508788,0.801958095932622,0.773070945520225,1058,233,42,38,28,23,14,15
0.800780849974398,0.819446802348105,0.754414485857785,1070,221,31,30,18,16,13,14
0.774585484511517,0.794105853682636,0.66221284575715,1063,228,32,27,19,12,13,15
0.730817598600277,0.751222104034178,0.709252597921663,1053,238,44,40,19,17,25,23
0.678408587870739,0.70526479249933,0.697938144329897,1076,215,36,30,15,13,21,17
0.792549923195084,0.812251632142999,0.713023202911738,1066,225,31,35,17,15,14,20
0.770285524568393,0.794459998883726,0.725033042558816,1075,216,36,30,16,10,20,20
0.74599887687772,0.774964520184348,0.71719702297234,1068,223,34,27,17,13,17,14
0.745483613109512,0.777713370906766,0.702393753200205,1079,212,40,31,21,16,19,15
0.725500454959054,0.757485032086451,0.690044322397264,1078,213,35,33,17,14,18,19
0.748990807354117,0.779783953568903,0.710074137789793,1089,202,40,39,19,15,21,24
0.773162939297125,0.785666334194501,0.712217565158742,1078,213,39,33,20,13,19,20
0.7474902339648,0.776016738316438,0.711726569608735,1059,232,38,35,18,16,20,19
0.739492682926829,0.762699510760309,0.718209736123749,1043,248,41,35,23,18,18,17
0.758315131056394,0.787589551259837,0.778979137365213,1074,217,32,27,17,16,15,11
0.737824390243902,0.767868508493775,0.718448428508189,1046,245,41,36,22,15,19,21
0.745135688684076,0.79843238225711,0.736379037105853,1054,237,31,29,16,14,15,15
0.725896414342629,0.754346314083969,0.71452892985151,1083,208,36,31,16,15,20,16
0.690752630640271,0.714511084285634,0.685880856933489,1082,209,45,37,16,10,29,27
0.765319079216843,0.786326344363279,0.712085484511517,1058,233,39,32,19,15,20,17
0.73099520383693,0.768628267861995,0.71137462111903,1070,221,40,39,19,16,21,23
0.719224620303757,0.740430461131106,0.684112709832134,1058,233,40,40,16,16,24,24
0.768607825295723,0.78527914649809,0.682626406310617,1066,225,35,37,19,14,16,23
0.766146247021445,0.785335562198972,0.685588760921366,1066,225,32,32,13,11,19,21
0.790867036743325,0.820748850935574,0.769156143120232,1070,221,30,24,17,13,13,11
0.732079954124682,0.75217735577669,0.712936585365854,1071,220,39,41,15,15,24,26
0.709757964569512,0.745477504009285,0.668692682926829,1050,241,44,41,22,17,22,24
0.742231536349183,0.760146981966741,0.632967633042097,1040,251,33,32,15,11,18,21
0.750762056414923,0.777255493109103,0.684838489535942,1071,220,35,35,16,14,19,21
0.697986993645751,0.74304034203271,0.674572381004427,1063,228,32,29,17,15,15,14
0.752432020628223,0.788297066263477,0.692114978902954,1063,228,27,27,14,11,13,16
0.69350376272687,0.714567021611567,0.706925720327782,1075,216,36,30,12,9,24,21
0.781977164330106,0.800636531993743,0.679012514345046,1071,220,33,29,17,14,16,15
0.767185302390999,0.796603822808235,0.644751724917996,1074,217,27,28,15,11,12,17
0.684686195587358,0.709050871420387,0.687432647958964,1065,226,43,37,14,10,29,27
0.796092884328178,0.811213467101038,0.680121596616442,1073,218,33,30,19,12,14,18
0.758746587807097,0.784627389066735,0.740148981453329,1070,221,35,26,16,10,19,16
0.736276715410574,0.786300858501202,0.660792320366788,1059,232,21,22,9,8,12,14
0.738565853658537,0.751389953531351,0.707939997413682,1056,235,41,37,19,16,22,21
0.762450592885375,0.796877420194114,0.765801762694028,1071,220,26,24,15,14,11,10
0.761888670434996,0.78812436873389,0.713523657870792,1080,211,39,35,16,12,23,23
0.762252683305315,0.792823601656404,0.68138969342587,1071,220,37,29,20,12,17,17
0.688911022576361,0.719256813920755,0.623597597299444,1065,226,36,32,15,11,21,21
0.693679855820431,0.707491011694306,0.699101455868972,1079,212,39,35,13,14,26,21
0.698870080228504,0.741315801758605,0.689746543778802,1054,237,38,31,19,16,19,15
0.742789416203336,0.762712922965849,0.664058890242366,1082,209,32,38,16,15,16,23
0.74585243209961,0.770015065777975,0.645942571785268,1074,217,47,45,21,17,26,28
0.811987840338356,0.827841023445648,0.712572210398298,1062,229,30,26,19,12,11,14
0.677275153456098,0.699311380592411,0.697728477140242,1059,232,42,33,16,12,26,21
0.75567487340667,0.783959555312229,0.717613180724648,1065,226,46,44,20,17,26,27
0.770440329626688,0.797494276452125,0.744533965244866,1081,210,32,25,16,10,16,15
0.755226518384413,0.788366616137451,0.72220942140297,1045,246,37,31,20,14,17,17
0.72002793783831,0.737781040007375,0.72750243902439,1075,216,46,41,17,16,29,25
0.681393963463066,0.709484183412287,0.658492267337013,1094,197,32,29,12,9,20,20
0.720929339477727,0.746643526576983,0.714289155465626,1080,211,31,33,13,12,18,21
0.788183980967486,0.801569809609003,0.747302114949174,1063,228,30,33,17,17,13,16
0.699146514935989,0.729428280315252,0.705017921146953,1062,229,37,31,19,14,18,17
0.747305202274146,0.769995285930672,0.727675921075607,1078,213,49,46,24,20,25,26
0.762790355777712,0.781312649641129,0.684326038560087,1045,246,38,38,20,13,18,25
0.75915512275408,0.794389007829728,0.677732823669579,1067,224,23,32,10,12,13,20
0.730207042356201,0.75608362503825,0.69188800354139,1052,239,44,36,24,17,20,19
0.737342254756186,0.774465996644579,0.726706911881698,1056,235,42,34,20,16,22,18
0.754352098834761,0.774376723359476,0.701438069085128,1078,213,34,33,13,12,21,21
0.746839164951485,0.768292994064886,0.749125635280616,1072,219,38,29,18,14,20,15
0.777877616014559,0.80709164781189,0.753685961080222,1070,221,35,32,21,18,14,14
0.726092384519351,0.748011932276226,0.730803965220313,1033,258,45,38,22,19,23,19
0.767800272975432,0.795585335472046,0.753694131955002,1076,215,35,26,20,13,15,13
0.680137943076654,0.719968407299132,0.656185051958433,1069,222,46,40,24,17,22,23
0.768585131894484,0.800947676030186,0.758764940239044,1075,216,40,36,23,20,17,16
0.750466333030027,0.769303173024121,0.743209736123749,1050,241,35,35,15,17,20,18
0.707208101667991,0.733942388238576,0.673806696075105,1068,223,32,28,14,13,18,15
0.765501427301231,0.79043418978086,0.701283753873395,1074,217,34,36,17,16,17,20
0.754299363057325,0.773168136325222,0.674655016400859,1081,210,35,28,20,14,15,14
0.750132485426603,0.77787660065281,0.628008192524321,1077,214,33,31,17,10,16,21
0.798463059801555,0.814807167393865,0.746582707589123,1070,221,48,44,28,25,20,19
0.784000578118225,0.803570509541571,0.728852762357917,1038,253,33,30,17,12,16,18
0.789447077409163,0.820606932507599,0.76554999314223,1104,187,25,23,13,9,12,14
0.702805465861762,0.725512986579991,0.660898965791567,1082,209,34,34,15,13,19,21
0.794194644284572,0.825424020894628,0.690131056393963,1049,242,40,32,28,15,12,17
0.728997058219881,0.758841010719473,0.728512004827794,1067,224,47,37,24,18,23,19
0.799743155363681,0.8419304159418,0.752022934868943,1068,223,29,32,18,17,11,15
0.769882670862694,0.792930423302196,0.738092576028622,1071,220,47,43,27,22,20,21
0.734412268932618,0.757625675774523,0.723015873015873,1059,232,43,31,20,13,23,18
0.789248953738265,0.830106733997107,0.708894154818326,1076,215,28,25,16,11,12,14
0.753109783089863,0.776228128390262,0.743138760880696,1066,225,36,31,15,11,21,20
0.747286226318484,0.78786384047344,0.720829117887941,1103,188,31,33,17,18,14,15
0.777860383544931,0.811047000429742,0.672194898776164,1070,221,42,42,25,21,17,21
0.644581358609795,0.691641705457299,0.587264150943396,1062,229,25,19,10,6,15,13
0.685163086714399,0.707488853643586,0.648220686123912,1067,224,34,31,10,9,24,22
0.669415688561639,0.686663966921371,0.662549960031975,1074,217,44,40,14,13,30,27
0.673496198568873,0.694866082169663,0.67428524617023,1068,223,43,39,15,14,28,25
0.760319539025668,0.779727326601534,0.671991480298189,1047,244,46,39,24,18,22,21
0.652711376715361,0.67463495603862,0.680619559651818,1068,223,36,31,14,11,22,20
0.786362602365787,0.810307667639684,0.724891159101686,1053,238,35,37,21,19,14,18
0.716862795810164,0.764167839860139,0.707159823549372,1069,222,37,28,18,14,19,14
0.775852407431355,0.79964298036457,0.77053961477363,1070,221,37,32,21,18,16,14
0.72597689850086,0.755667748117963,0.675064535345512,1078,213,39,32,18,13,21,19
0.802858079676485,0.826954476032645,0.810866983372922,1072,219,29,28,16,15,13,13
0.713027372469178,0.736774611073993,0.705038671519563,1087,204,28,35,13,13,15,22
0.681814634146342,0.706507019407537,0.629197379197379,1087,204,41,37,15,9,26,28
0.702137373285629,0.722258585607104,0.665593721565059,1050,241,43,35,18,13,25,22
0.749277688603531,0.768186949545571,0.721910862022952,1070,221,45,42,15,11,30,31
0.764827557958548,0.794377827416983,0.793415227976981,1062,229,39,36,24,22,15,14
0.711841522797698,0.738593277713279,0.64653607791058,1078,213,36,36,14,11,22,25
0.742376065905478,0.765280043817591,0.727046188403763,1087,204,33,34,18,17,15,17
0.709485896269336,0.730028278977954,0.686103065741297,1050,241,35,29,17,13,18,16
0.79957034372502,0.822767980610096,0.696019935420469,1071,220,40,34,22,15,18,19
0.784030544488712,0.804826859296358,0.747919596812002,1073,218,36,27,18,13,18,14
0.664951484857395,0.697633889813024,0.634734138477513,1086,205,38,29,17,10,21,19
0.765817346123102,0.795998213174898,0.686699857752489,1057,234,40,37,23,20,17,17
0.742019512195122,0.76407527392511,0.658269845170804,1068,223,41,39,17,13,24,26
0.718165008197034,0.735685529280694,0.735764249412536,1059,232,42,29,18,9,24,20
0.748836156730894,0.778174120825223,0.668093967897421,1050,241,37,34,20,16,17,18
0.751434146341463,0.779927541111936,0.711471415970093,1081,210,41,38,19,19,22,19
0.737959632294165,0.763869102221941,0.704569542804837,1052,239,40,33,17,14,23,19
0.726169064748201,0.760291670871303,0.705926927172933,1059,232,40,39,20,17,20,22
0.663256559332141,0.679834971492708,0.697478905545998,1072,219,43,39,12,11,31,28
0.787270183852918,0.807063229600924,0.802970082381847,1067,224,40,33,22,17,18,16
0.732767092517198,0.760298390133173,0.737871561400973,1059,232,34,33,16,14,18,19
0.811918990703851,0.828843150240384,0.797294010337489,1069,222,36,26,21,13,15,13
0.737793888752355,0.758588362071227,0.696701546860782,1054,237,39,35,15,12,24,23
0.774500581514675,0.788896500225962,0.745182990459153,1061,230,47,43,24,18,23,25
0.730629348513599,0.751247233568633,0.708476693700336,1044,247,51,39,25,18,26,21
0.719423933427098,0.751743034419418,0.690195733708392,1083,208,27,27,9,12,18,15
0.756612227200462,0.771057104016626,0.734631263431738,1086,205,33,28,14,12,19,16
0.766741340270752,0.783845553214232,0.712854944400318,1072,219,33,32,14,14,19,18
0.739782527184102,0.791727301046012,0.714146805693479,1121,170,21,19,11,8,10,11
0.7553881632829,0.776528311883946,0.677927657873701,1096,195,37,40,18,13,19,27
0.733623101518785,0.768320882525434,0.695970034205328,1061,230,40,33,17,14,23,19
0.788820492454329,0.812860862183465,0.682024848004229,1070,221,32,30,19,13,13,17
0.728504765687053,0.764455558250409,0.675513022888713,1066,225,32,24,15,7,17,17
0.802985633394169,0.839320265972625,0.8094726062468,1079,212,34,31,21,16,13,15
0.754424519456165,0.775857841208205,0.742062407781846,1069,222,27,29,14,13,13,16
0.701326774001192,0.725428615759794,0.684315537446969,1072,219,43,38,18,15,25,23
0.776460952931541,0.797539673642667,0.684906159132963,1073,218,33,30,16,10,17,20
0.749947131905895,0.765370773770131,0.736887599624942,1076,215,30,27,12,11,18,16
0.747253938430409,0.771420826210721,0.731801320036614,1060,231,33,33,16,18,17,15
0.665903054448871,0.692017691785993,0.686978752978554,1037,254,36,32,15,12,21,20
0.780869104398516,0.809663027608749,0.760394265232975,1056,235,33,31,20,16,13,15
0.756688963210702,0.799095966359231,0.680746015002344,1079,212,26,27,14,12,12,15
0.750409727729315,0.783247918495593,0.710002057330956,1087,204,30,23,14,11,16,12
0.842819279742062,0.853351630284372,0.782831573172404,1049,242,29,23,19,12,10,11
0.729848269321954,0.752167115358431,0.668405723334464,1050,241,37,28,17,12,20,16
0.654460555419022,0.678607328372526,0.572352669382955,1069,222,39,38,15,12,24,26
0.692551403077719,0.721290588372638,0.697758206565252,1065,226,37,42,15,18,22,24
0.765350277074639,0.781283026052208,0.752747801758593,1063,228,47,40,24,20,23,20
0.775244675935649,0.806349502532254,0.752950811774341,1058,233,38,33,19,16,19,17
0.790807325576511,0.811557111178033,0.791761814932486,1047,244,38,32,22,18,16,14
0.754083461341526,0.78617471172304,0.737190363081099,1068,223,31,28,15,11,16,17
0.746602478972997,0.781080233068671,0.70721110100091,1064,227,36,35,17,16,19,19
0.79100102406554,0.829266070084728,0.714929777583475,1078,213,31,29,18,13,13,16
0.71605552645364,0.749137907698998,0.695189292900931,1072,219,46,34,24,19,22,15
0.743509984639017,0.772824317797483,0.703571847163619,1069,222,31,27,13,10,18,17
0.704877112135177,0.743950494724671,0.675813586097947,1084,207,31,25,13,9,18,16
0.714961670631774,0.731347457416437,0.583164715517657,1062,229,30,33,12,9,18,24
0.791620080500894,0.813909284059271,0.770647721454173,1049,242,43,31,27,18,16,13
0.730770731707317,0.74176716830455,0.679036770583533,1047,244,41,40,18,13,23,27
0.800982922954726,0.820612410942085,0.770288994457641,1060,231,32,28,19,13,13,15
0.774768639776497,0.80650008881846,0.684642286171063,1056,235,46,40,29,20,17,20
0.774931506849315,0.809695164305394,0.767825739408473,1070,221,50,40,28,21,22,19
0.769251249283198,0.786772934384005,0.719500210585427,1075,216,39,34,19,14,20,20
0.757519007155635,0.781439452577285,0.746876792004587,1073,218,43,39,20,17,23,22
0.751650615567911,0.783213569449787,0.756810035842294,1066,225,32,31,15,14,17,17
0.742720655141037,0.758690545897169,0.701919834272775,1068,223,35,33,17,12,18,21
0.668744519425064,0.692155584302434,0.693289353958144,1051,240,42,35,15,14,27,21
0.740012393380477,0.764463711729882,0.742945388179138,1069,222,44,34,22,17,22,17
0.796638728828357,0.809631395294554,0.794502268481452,1057,234,46,42,27,24,19,18
0.766793642991726,0.777720815506034,0.763021198933034,1071,220,39,34,20,18,19,16
0.735623003194888,0.766026569455707,0.686730540111199,1071,220,39,32,18,12,21,20
0.798107569721116,0.807343440371854,0.7035848047084,1084,207,36,45,21,20,15,25
0.670701047542305,0.692541837434264,0.652150417412045,1048,243,50,43,20,17,30,26
0.768578314380645,0.807715169576247,0.737045570916539,1087,204,34,31,17,15,17,16
0.690317745803357,0.715411054085789,0.672304367606915,1066,225,40,35,13,12,27,23
0.798719918074757,0.833659174348067,0.743047845625165,1068,223,31,30,22,19,9,11
0.746912470023981,0.759491314258061,0.743758300132802,1056,235,40,36,17,15,23,21
0.726006673453229,0.757955111728009,0.740794469517874,1061,230,28,22,15,12,13,10
0.648069321982366,0.670240335140537,0.649940991345397,1054,237,26,20,9,6,17,14
0.766706317737246,0.783322659781555,0.727660841938046,1056,235,30,32,15,16,15,16
0.774742676167854,0.802168223765397,0.700106415323807,1069,222,28,26,17,12,11,14
0.827425323817076,0.850691699384264,0.774810098912509,1070,221,30,29,16,13,14,16
0.726960557819129,0.749249652724579,0.681890389197776,1064,227,38,32,19,15,19,17
0.75246012894469,0.77399380966123,0.711659048288795,1073,218,28,27,12,11,16,16
0.718649220195612,0.750905648926969,0.716493788091889,1052,239,30,27,17,14,13,13
0.658148828435266,0.677362724491167,0.653540175019889,1063,228,32,34,10,11,22,23
0.757233848953594,0.789919685578836,0.750216105550501,1051,240,35,35,18,18,17,17
0.742210793082886,0.773502315197615,0.658364787067749,1069,222,43,42,21,18,22,24
0.752373251564666,0.769146684814874,0.652438049560352,1057,234,38,40,19,15,19,25
0.701610901509134,0.718381869083847,0.641565112847697,1070,221,32,29,12,9,20,20
0.715107166290005,0.739454127338219,0.695698090434933,1058,233,44,37,20,14,24,23
0.773799114705722,0.788016563668844,0.722369668246445,1071,220,29,25,18,13,11,12
0.770543565147882,0.797377800456312,0.736609235818096,1076,215,40,27,21,13,19,14
0.752385211687537,0.785564504923745,0.709668292682927,1072,219,43,41,21,17,22,24
0.73091461802802,0.750797092492154,0.687221636193155,1071,220,30,27,14,10,16,17
0.800094786729858,0.824738285064146,0.715764670112496,1076,215,25,26,13,13,12,13
0.743738819320215,0.771090139439668,0.716196542311192,1060,231,43,35,22,16,21,19
0.728343028032469,0.75048367621308,0.704928191295473,1074,217,49,44,22,19,27,25
0.711998610007943,0.736765515762102,0.686135342320909,1077,214,32,30,14,13,18,17
0.736346394241131,0.764531297210408,0.667119104173736,1061,230,37,28,17,10,20,18
0.770486935866983,0.806215228306493,0.745013681970204,1057,234,28,26,12,9,16,17
0.782843324771846,0.809543219297661,0.717834520981789,1071,220,29,28,14,10,15,18
0.761792783939351,0.782402863069965,0.667709281164695,1069,222,34,35,18,12,16,23
0.8061199645861,0.848499725059285,0.813443917851501,1073,218,36,25,21,16,15,9
0.725531707317073,0.743908860584853,0.684805180610962,1060,231,41,29,17,12,24,17
0.710569421095737,0.741229832163877,0.689126478616924,1082,209,37,35,16,12,21,23
0.779516386890488,0.794774878537426,0.689619512195122,1059,232,40,41,21,17,19,24
0.750078048780488,0.767564523939762,0.718884892086331,1036,255,41,40,21,19,20,21
0.781545343806444,0.795586723127999,0.69332347588717,1063,228,38,35,21,16,17,19
0.768381976446493,0.811150643851805,0.755527143981117,1065,226,31,20,18,10,13,10
0.709858384073339,0.725577516309556,0.689975637417566,1065,226,47,38,17,14,30,24
0.764146341463415,0.797483399732583,0.759978157267673,1059,232,41,32,27,21,14,11
0.631396343067614,0.671231708808316,0.58416087388282,1071,220,24,19,6,5,18,14
0.738284804367607,0.752141211402401,0.708862876254181,1042,249,35,26,18,10,17,16
0.718025579536371,0.73945495224912,0.694303462860164,1064,227,40,30,19,12,21,18
0.741856514788169,0.766483961926034,0.706748907863384,1074,217,40,32,20,13,20,19
0.807727513609866,0.835133858437444,0.749494470774092,1069,222,33,25,22,17,11,8
0.764061258935663,0.791973916305432,0.744250594766059,1064,227,32,30,17,15,15,15
0.837097495527728,0.845071515765734,0.791902187269599,1059,232,43,39,27,21,16,18
0.813614649681529,0.826453287705711,0.753788809699353,1065,226,35,39,21,18,14,21
0.756086764054892,0.780333088741094,0.687226965845909,1041,250,36,32,21,16,15,16
0.760274202198981,0.782534509508089,0.749580616874452,1044,247,48,42,29,26,19,16
0.692486745118324,0.727431154393992,0.664911788104263,1073,218,37,34,13,11,24,23
0.77772694345953,0.796754140996328,0.715344964314036,1052,239,42,30,24,15,18,15
0.717498599077547,0.743640526554736,0.625295723384895,1064,227,37,35,17,12,20,23
0.714978881737731,0.736880112706867,0.706821829855538,1064,227,48,45,19,15,29,30
0.786963434022258,0.812597416388425,0.754918301546533,1088,203,33,29,20,16,13,13
0.769651716277822,0.791193593522778,0.705993366121469,1063,228,48,42,23,15,25,27
0.784265786338364,0.802214784782557,0.748688452920925,1074,217,32,29,15,13,17,16
0.748805732484077,0.77587637734191,0.690604198668715,1069,222,35,31,17,16,18,15
0.712211049784141,0.748972790242469,0.673889474917956,1087,204,29,27,12,11,17,16
0.704917073170732,0.721419606228488,0.69269588313413,1064,227,41,36,15,10,26,26
0.802560581972347,0.83212674360484,0.738811003516886,1080,211,33,33,18,16,15,17
0.7076,0.719853449359083,0.62600028078057,1077,214,41,34,15,11,26,23
0.714072361131185,0.741152559391588,0.649490925188136,1053,238,33,36,13,13,20,23
0.672141040562093,0.696320738914648,0.637435464654488,1050,241,37,32,15,9,22,23
0.752613576142988,0.79245637897767,0.724044233807267,1060,231,33,25,19,13,14,12
0.773871181938911,0.789333567336798,0.674231647915858,1042,249,36,37,18,13,18,24
0.752058218171126,0.783977083921291,0.691322478157268,1062,229,38,32,20,14,18,18
0.745607028753994,0.773925311003149,0.697196620583717,1085,206,39,31,19,12,20,19
0.772460243729166,0.795447438614368,0.711621941594317,1071,220,29,24,15,9,14,15
0.756349206349206,0.76954604273433,0.72291856232939,1070,221,45,35,22,15,23,20
0.767334011989594,0.797142491558247,0.713959212376934,1088,203,28,27,14,11,14,16
0.806270173917233,0.818903266183135,0.732398873527906,1080,211,33,31,17,15,16,16
0.776571491810536,0.798045039327262,0.677235502434706,1068,223,36,36,17,9,19,27
0.76521617311091,0.781093499250854,0.72946038522637,1061,230,37,32,20,14,17,18
0.669752779984115,0.692568786141925,0.639387013595874,1043,248,32,27,12,8,20,19
0.715460380699424,0.741653503596527,0.713940092165899,1073,218,36,31,13,12,23,19
0.784160955213587,0.812086840324488,0.728381970365343,1068,223,37,28,22,13,15,15
0.711981119875857,0.74152153848354,0.601433121019108,1053,238,37,35,17,11,20,24
0.78420761398849,0.812954549021236,0.727611775121735,1076,215,36,36,19,19,17,17
0.704487804878049,0.742446809951067,0.69630367419212,1054,237,41,36,19,17,22,19
0.749075763957134,0.774067557681588,0.642337524690466,1083,208,34,33,17,11,17,22
0.757602805897425,0.784904866728544,0.685487834848857,1073,218,38,39,21,17,17,22
0.675332005312085,0.707150040527989,0.517011249619945,1060,231,36,26,15,7,21,19
0.681053680262541,0.708363517521112,0.684576259044344,1050,241,27,22,12,9,15,13
0.692744671928018,0.714658771404946,0.654459938025675,1072,219,42,36,18,15,24,21
0.720450175319534,0.756305396319527,0.690898617511521,1059,232,28,31,11,10,17,21
0.80639951108783,0.832708919325409,0.765628417292411,1048,243,46,44,27,25,19,19
0.801169064748201,0.816617025985029,0.720243902439024,1047,244,40,41,24,21,16,20
0.750029301453352,0.769473159564521,0.647119815668203,1064,227,27,31,13,12,14,19
0.754746503129332,0.780346951302458,0.664093526608419,1087,204,38,32,20,13,18,19
0.722735893788525,0.749659579872566,0.669665654959773,1063,228,37,33,17,12,20,21
0.709495351925631,0.727824694281544,0.710930478456252,1087,204,36,30,11,9,25,21
0.707797369562075,0.73475699334666,0.648170671167593,1051,240,33,32,14,11,19,21
0.749133497316637,0.769576960040359,0.663448173153296,1051,240,43,32,21,13,22,19
0.748121115768175,0.776642315543697,0.61640127388535,1051,240,33,35,17,11,16,24
0.719854116706635,0.756079433153068,0.689058917122935,1081,210,40,34,19,12,21,22
0.693327089289822,0.713243124012623,0.701495358508002,1049,242,49,38,18,12,31,26
0.763543266769073,0.806962280707956,0.670386135603527,1086,205,31,26,16,11,15,15
0.744541369283637,0.770480621151996,0.780320968166272,1058,233,30,24,15,13,15,11
0.776275907266323,0.803746934852929,0.738504864311316,1060,231,39,31,24,18,15,13
0.748405103668262,0.769862534057112,0.722954758556024,1073,218,37,27,20,13,17,14
0.744857156621863,0.781217238236942,0.662442911040508,1074,217,33,32,12,9,21,23
0.711324165175909,0.735335739317748,0.698481539043139,1051,240,43,38,19,16,24,22
0.678315231965674,0.699980890423327,0.696663414634146,1048,243,48,41,17,14,31,27
0.79790243902439,0.805689920709817,0.775960170697013,1081,210,41,37,21,18,20,19
0.749810426540284,0.78539955255482,0.743669314796425,1077,214,25,19,13,10,12,9
0.774027137736815,0.815828714753914,0.663897679324894,1096,195,31,27,14,8,17,19
0.786198492668141,0.813928828276015,0.700665976981766,1064,227,39,37,19,15,20,22
0.661409915891988,0.68496518167537,0.629972277061368,1044,247,36,38,13,10,23,28
0.717467551560465,0.739553845282497,0.704986596505163,1075,216,38,32,18,15,20,17
0.684311729442371,0.713426922600121,0.665710536182977,1077,214,28,21,11,7,17,14
0.753984139692707,0.784424968495445,0.685112195121951,1095,196,42,41,21,17,21,24
0.782280083399524,0.82097885591376,0.767243905297703,1083,208,32,27,19,15,13,12
0.795100379053769,0.820204934965169,0.696117520642461,1063,228,34,28,17,13,17,15
0.700231265909232,0.720045225987386,0.681182915921288,1079,212,52,43,19,16,33,27
0.818217979315831,0.833407706359266,0.752143508665248,1036,255,34,26,21,13,13,13
0.729435563939635,0.747964273617194,0.689275848460931,1065,226,32,24,12,6,20,18
0.77717709798406,0.805170335895159,0.721029860875467,1068,223,27,28,13,12,14,16
0.642662716192128,0.667731351484186,0.690766998923675,1062,229,33,34,9,9,24,25
0.787174162522542,0.816247784135827,0.705471847739889,1039,252,29,30,15,13,14,17
0.723588960524827,0.769905545858989,0.697726671953476,1063,228,28,30,13,12,15,18
0.790152592784172,0.817087702313723,0.747144273460063,1068,223,37,37,21,17,16,20
0.701727415026834,0.721183836057053,0.631438798672953,1056,235,43,46,19,14,24,32
0.72278768309233,0.747574907165803,0.658448540706605,1080,211,34,31,13,9,21,22
0.742397078353254,0.765583555327568,0.764055299539171,1082,209,36,31,17,16,19,15
0.775491949910554,0.796722649378629,0.728997706234128,1055,236,43,39,24,19,19,20
0.740731707317073,0.762431186202536,0.68162993120876,1064,227,41,34,18,15,23,19
0.670792758195035,0.702329685274348,0.564187979081596,1079,212,23,22,8,7,15,15
0.829315358181338,0.847895309769202,0.723735317516028,1071,220,30,34,17,16,13,18
0.675976889990523,0.696779466296738,0.628444630750164,1057,234,44,44,19,16,25,28
0.72800144877807,0.747163356772132,0.709560213382619,1082,209,42,38,15,11,27,27
0.71944376177603,0.749910234170285,0.656507304116866,1081,210,39,36,16,11,23,25
0.755648696825167,0.786888444408026,0.7655808166497,1055,236,33,28,19,16,14,12
0.712521527281892,0.746120642161054,0.666873510722796,1080,211,38,32,17,12,21,20
0.738715491111657,0.76869399429689,0.709067930489731,1073,218,39,25,16,9,23,16
0.752299762093577,0.782014893594886,0.703323570293884,1072,219,30,32,15,13,15,19
0.681169036334913,0.702699716970494,0.696557828481511,1063,228,25,20,11,8,14,12
0.780050637331936,0.794927945455045,0.772263559361692,1066,225,46,34,26,18,20,16
0.7336445317984,0.752595846724676,0.771404711673699,1069,222,34,27,16,16,18,11
0.729820293884035,0.767026513689974,0.673611111111111,1094,197,32,27,16,11,16,16
0.709602695493472,0.751259972274891,0.698593996840443,1080,211,34,25,15,10,19,15
0.65476618705036,0.68434581009707,0.67468152866242,1066,225,40,35,16,13,24,22
0.749990007993605,0.795165372001422,0.749024425495014,1040,251,40,33,22,16,18,17
0.693320591739476,0.726776713846354,0.598888006354249,1063,228,32,32,15,13,17,19
0.66039176626826,0.676787591583503,0.660813219636749,1065,226,36,33,9,8,27,25
0.756617775449625,0.7752223116514,0.700870727186517,1073,218,46,37,23,16,23,21
0.765445859872611,0.790954446921259,0.756323604710701,1073,218,35,31,17,14,18,17
0.660236830455954,0.679763997761516,0.650466640190627,1069,222,36,32,11,9,25,23
0.772468640889694,0.800175501599594,0.757309868943606,1060,231,37,32,21,17,16,15
0.712092027822365,0.735907424788521,0.694816498730237,1073,218,45,39,21,16,24,23
0.764874551971326,0.801466836149062,0.753944689514761,1064,227,31,28,16,16,15,12
0.78418503439562,0.807663678333845,0.708947540830174,1064,227,34,34,17,14,17,20
0.679011899600135,0.711838352281155,0.59626216077829,1094,197,33,31,12,8,21,23
0.771453774100055,0.786521565860047,0.749601275917065,1051,240,38,37,19,18,19,19
0.720528014645662,0.770760857662329,0.689349185861795,1076,215,33,32,14,11,19,21
0.652816180235535,0.693388145144916,0.630608229957921,1080,211,31,29,12,8,19,21
0.730715427657874,0.757104068457419,0.706274900398406,1080,211,40,36,19,15,21,21
0.704449101507925,0.738506058994258,0.631168369856276,1080,211,33,29,16,10,17,19
0.718499210110584,0.774440698906473,0.662204724409449,1100,191,25,21,10,6,15,15
0.676933575978162,0.696870852759907,0.699807987711213,1081,210,35,31,12,10,23,21
0.767903187998125,0.793821563080282,0.720797158642463,1090,201,27,24,12,10,15,14
0.736831328936592,0.773659012182995,0.724449329712488,1048,243,37,37,20,16,17,21
0.764526484751204,0.784089070928064,0.764653477512902,1062,229,45,39,20,16,25,23
0.752897927418694,0.78032282612918,0.712318330989217,1088,203,39,27,17,11,22,16
0.760406844770386,0.790356276972088,0.680439024390244,1065,226,46,41,24,19,22,22
0.70796812749004,0.738619540869935,0.669641228336881,1067,224,36,26,16,9,20,17
0.722607929876301,0.738184529757152,0.659640501745765,1064,227,39,37,17,12,22,25
0.757757051865332,0.787601197460704,0.643464123722608,1075,216,35,29,15,9,20,20
0.697217763509899,0.721925697214687,0.665687804878049,1076,215,45,41,16,14,29,27
0.804780579825258,0.82892782574265,0.713903970139124,1059,232,32,28,21,16,11,12
0.722266244057052,0.75931251604838,0.689274447949527,1073,218,29,23,14,10,15,13
0.75094831673779,0.7849237842386,0.699257552483359,1065,226,37,31,17,12,20,19
0.764323518292939,0.783768431990878,0.75147209421403,1067,224,38,31,17,16,21,15
0.763725265927027,0.790945422631672,0.729104702788913,1084,207,42,37,25,19,17,18
0.795226725960487,0.826825465803973,0.704071296176559,1056,235,44,37,27,20,17,17
0.728751945604981,0.770532734423545,0.669599431662932,1086,205,39,29,21,13,18,16
0.699670263788969,0.728206453955647,0.664490527393753,1091,200,40,31,16,9,24,22
0.790696591544049,0.808337611392385,0.764692682926829,1059,232,52,41,31,21,21,20
0.767791715160136,0.791161352986268,0.769595799007564,1063,228,37,33,16,13,21,20
0.736936585365854,0.755481353882675,0.737984395879133,1066,225,41,37,21,19,20,18
0.698441667836586,0.724404271013375,0.61146842029195,1063,228,34,33,14,10,20,23
0.792690985989955,0.820547114642568,0.7641952267843,1078,213,30,28,15,14,15,14
0.796879150066401,0.824469385119,0.767924476747363,1061,230,36,29,21,15,15,14
0.745966540905481,0.773246625365964,0.670225294418843,1075,216,32,31,12,9,20,22
0.771394449499545,0.811568042576544,0.766319115323855,1061,230,35,25,22,16,13,9
0.742429507545671,0.773384505761373,0.690219402590537,1073,218,32,30,17,10,15,20
0.737849980142971,0.761891599695594,0.731967335186656,1075,216,32,32,12,10,20,22
0.72895674612927,0.766621996521774,0.694871922160445,1094,197,39,32,18,13,21,19
0.744381904481875,0.763852982672713,0.71376999008578,1059,232,38,37,18,13,20,24
0.776255427213894,0.810203788684896,0.632074066719619,1069,222,39,32,21,13,18,19
0.797895814376706,0.815590863984658,0.77634152788792,1069,222,35,30,19,17,16,13
0.752308869337122,0.780735535800199,0.728593996840442,1092,199,29,25,14,12,15,13
0.704414667954803,0.721407169417702,0.724408553230209,1076,215,38,35,15,16,23,19
0.720053914674168,0.731697823612386,0.631133254406735,1056,235,27,24,11,6,16,18
0.688125568698817,0.714786738088762,0.665458343573359,1078,213,35,39,12,12,23,27
0.700679304897314,0.735542188929441,0.660078988941548,1077,214,25,25,9,7,16,18
0.730624164834691,0.763191634036908,0.711226114649682,1055,236,37,35,19,13,18,22
0.739600844864003,0.759493799535897,0.736422756155679,1088,203,37,32,17,15,20,17
0.805920894156188,0.834086081290425,0.739003436426117,1089,202,33,30,19,14,14,16
0.751505516211398,0.773890636544132,0.756371344606639,1059,232,33,33,17,17,16,16
0.73314348521183,0.756012654676524,0.75112027979671,1085,206,40,29,21,17,19,12
0.6677145059498,0.690590317311898,0.697435194074887,1067,224,33,23,14,12,19,11
0.748204309656824,0.777700578752709,0.69647406733394,1067,224,38,35,16,15,22,20
0.776423673225999,0.796212989464029,0.730882796672271,1077,214,43,37,20,14,23,23
0.720949535192563,0.750554661339469,0.691506099400836,1067,224,36,37,17,17,19,20
0.727479058449155,0.774701432640172,0.603463511358248,1077,214,34,37,15,12,19,25
0.663821716453295,0.682324672756049,0.66038909625608,1091,200,37,28,9,6,28,22
0.72836632780453,0.747299746395618,0.692800272975432,1074,217,45,35,18,11,27,24
0.712410948631421,0.752183200886224,0.709806999722966,1088,203,21,17,9,6,12,11
0.817358892438765,0.831868322106798,0.777412550176129,1056,235,39,39,23,20,16,19
0.662630445973139,0.683619124245323,0.566924476797088,1074,217,34,35,12,10,22,25
0.781892889087657,0.795285372557308,0.680674146147736,1087,204,43,32,23,12,20,20
0.81673910557017,0.843531589955088,0.809551812492124,1049,242,42,38,27,23,15,15
0.771775609756098,0.801481500285146,0.695336585365854,1069,222,41,41,21,14,20,27
0.751561699948797,0.785156266031784,0.780009121313469,1072,219,31,26,17,14,14,12
0.739611419508327,0.772227152788718,0.726913970007893,1033,258,30,24,17,10,13,14
0.740422973933002,0.761888696337821,0.713744075829384,1058,233,29,25,11,10,18,15
0.725889983909895,0.745072199189272,0.757123151859994,1066,225,48,37,22,19,26,18
0.80597609561753,0.838874982676653,0.744589868298814,1049,242,36,29,25,18,11,11
0.697701017957223,0.718597000407686,0.6580548046203,1070,221,42,39,13,12,29,27
0.770094786729858,0.78827885611927,0.670218911523259,1072,219,25,26,10,9,15,17
0.793072977283504,0.825387070644606,0.760846902303415,1055,236,37,32,24,20,13,12
0.746742605915268,0.772333782852398,0.756905710491368,1073,218,40,36,19,19,21,17
0.807510719275425,0.829934934530467,0.701689708141321,1071,220,33,31,19,14,14,17
0.822712070538158,0.85032946383996,0.83877441244621,1044,247,26,19,17,12,9,7
0.765404792947166,0.780891473400696,0.74050605629553,1048,243,52,37,25,19,27,18
0.771872139519198,0.799993273183881,0.739154850484346,1056,235,33,34,19,19,14,15
0.764390243902439,0.794363672576984,0.72841726618705,1079,212,41,40,25,22,16,18
0.731281295334363,0.764366402279642,0.707809413691767,1047,244,34,33,15,13,19,20
0.725104122794703,0.763589455366714,0.680769230769231,1063,228,34,30,18,14,16,16
0.710161160354553,0.729632410820624,0.653692553452937,1085,206,50,39,20,14,30,25
0.78643084622384,0.825038104332748,0.710675883256528,1065,226,35,31,21,15,14,16
0.786373271667389,0.85096233842553,0.650261601455869,1056,235,33,35,22,16,11,19
0.721110100090992,0.737266533875492,0.670200181983621,1051,240,35,35,14,14,21,21
0.719321378340366,0.754841693611082,0.692259083728278,1065,226,27,25,13,11,14,14
0.724165853658537,0.755271265669707,0.662126685428655,1066,225,41,38,19,12,22,26
0.811851556264964,0.831700045645304,0.725925698369788,1064,227,38,39,23,17,15,22
0.748519343050363,0.772735324627889,0.744074288191935,1075,216,38,33,21,18,17,15
0.777343039126479,0.788410657539247,0.713889831467029,1080,211,35,28,15,10,20,18
0.648290060619925,0.665030080707632,0.629265241128299,1062,229,42,35,14,12,28,23
0.736442205292046,0.772811855196902,0.729072598494909,1059,232,39,36,20,17,19,19
0.712649880095923,0.736110978715778,0.637544032112722,1059,232,40,39,17,13,23,26
0.699715758539288,0.73348604807071,0.664080901177675,1082,209,33,31,14,12,19,19
0.776153026951749,0.806884640903729,0.769322709163347,1078,213,39,36,21,23,18,13
0.803759873617694,0.827366953097181,0.733541352352215,1078,213,25,23,13,9,12,14
0.719706582077716,0.752155173003533,0.670370998755797,1065,226,30,28,17,13,13,15
0.804553324909916,0.828558909866461,0.739624636531853,1065,226,34,30,19,15,15,15
0.702496518391087,0.73093839349647,0.702097902097902,1091,200,39,26,15,8,24,18
0.757834839300011,0.777428669990221,0.73918776371308,1042,249,42,27,18,9,24,18
0.763300051203277,0.790236509405854,0.763925205229553,1075,216,31,26,16,11,15,15
0.733195604658822,0.755760801773817,0.660607736658621,1055,236,54,48,23,19,31,29
0.713998800959233,0.73436080340794,0.662549960031975,1063,228,40,40,19,14,21,26
0.73332319854059,0.759519651023587,0.625047816820591,1070,221,26,29,14,10,12,19
0.666355615880556,0.689488707833138,0.631319986426875,1078,213,28,28,9,8,19,20
0.698854313173933,0.729310979141008,0.71433910306845,1089,202,27,20,11,7,16,13
0.704975609756098,0.730802960043463,0.666158373461744,1058,233,41,45,19,18,22,27
0.756097352397893,0.777773121413543,0.730781147481228,1065,226,47,44,23,20,24,24
0.757634679171909,0.779727965533265,0.715138762511374,1066,225,42,35,22,16,20,19
0.720827799911465,0.752829468271791,0.698692007515537,1064,227,36,33,20,17,16,16
0.663512738592611,0.692997359440836,0.590368231342672,1074,217,39,39,13,11,26,28
0.735151049667179,0.755863804226678,0.757053815749468,1086,205,31,26,10,10,21,16
0.714823348694317,0.738179685836503,0.699612787926926,1067,224,31,32,14,14,17,18
0.697605500237079,0.727038656455648,0.676338102808691,1055,236,37,33,18,14,19,19
0.728274925643347,0.74848723391238,0.709690220174091,1074,217,37,31,16,11,21,20
0.765778758059043,0.798980982267348,0.74703557312253,1084,207,28,26,13,10,15,16
0.702809866941172,0.721281114417215,0.679703408587871,1068,223,42,36,17,14,25,22
0.723336900303193,0.74455989314025,0.643298461762776,1050,241,45,44,20,13,25,31
0.716364827553933,0.738156695969294,0.665296979006657,1088,203,34,31,14,11,20,20
0.689051363971492,0.723756510931164,0.682267820388961,1065,226,39,38,14,12,25,26
0.753831228624046,0.781497482239934,0.70698500394633,1047,244,24,24,11,8,13,16
0.678852762357917,0.69860192957032,0.714417258616154,1061,230,30,24,11,8,19,16
0.760778289810548,0.800640733030387,0.751270561232854,1051,240,31,29,16,14,15,15
0.758696495538601,0.789727490294645,0.700985663082437,1074,217,37,31,16,11,21,20
0.784849921011058,0.817114743622577,0.729887527759868,1073,218,25,22,13,11,12,11
0.79439287132645,0.806863285762419,0.767421708726057,1079,212,32,26,16,11,16,15
0.720777160983347,0.755402606147027,0.699901633969069,1070,221,30,29,13,14,17,15
0.753534635113582,0.782661676690175,0.667578028999754,1065,226,37,39,18,15,19,24
0.812318016378526,0.836199919747636,0.714156670039023,1074,217,35,33,20,14,15,19
0.700256016385049,0.727007622921768,0.688298834973419,1055,236,31,28,10,8,21,20
0.825495928739275,0.857255060026662,0.680480389176041,1081,210,29,26,16,12,13,14
0.722961410860835,0.750413248827908,0.64719093590775,1096,195,46,48,21,17,25,31
0.698932890109361,0.724257720051382,0.641139672429481,1067,224,33,35,15,12,18,23
0.752491927558613,0.766951428923832,0.706617044852339,1054,237,34,33,14,13,20,20
0.685051079787922,0.732512471170403,0.659403422561317,1070,221,37,37,13,12,24,25
0.749910394265233,0.773338666129379,0.639782294133123,1081,210,31,24,14,9,17,15
0.707822137302226,0.723612053926171,0.709173015482919,1040,251,48,39,23,17,25,22
0.733908809207614,0.76777979708258,0.771850998463902,1087,204,36,31,18,17,18,14
0.73743072050673,0.767276519051351,0.640690748128313,1079,212,28,29,14,10,14,19
0.757489546963231,0.777207809889208,0.662281572676728,1072,219,37,32,16,11,21,21
0.780278942043648,0.79511324294119,0.690834613415259,1051,240,33,31,18,15,15,16
0.676998741850623,0.706477991012736,0.651136814932486,1077,214,42,32,18,14,24,18
0.72779512195122,0.746164922248948,0.700870727186517,1046,245,41,37,19,15,22,22
0.740654009324988,0.751734854102463,0.631554019457245,1072,219,38,31,14,9,24,22
0.74380118289354,0.763897272253084,0.719341361513885,1069,222,35,39,19,20,16,19
0.726478659785369,0.763870360366538,0.680392371167823,1078,213,39,29,19,12,20,17
0.773828541001065,0.782124870187106,0.652252047315742,1071,220,39,35,14,10,25,25
0.800342336287647,0.817710394882107,0.766363561890718,1066,225,38,39,22,21,16,18
0.713492063492063,0.7453132186179,0.687450514647664,1060,231,31,28,14,11,17,17
0.745229268292683,0.770603300967588,0.693113159242191,1080,211,41,31,19,10,22,21
0.733845366103431,0.758462466947615,0.638284804367607,1064,227,31,35,14,13,17,22
0.733138218432336,0.762790874230808,0.678009478672986,1072,219,33,25,17,12,16,13
0.755273512213782,0.782028617763857,0.709741423451101,1084,207,29,31,13,11,16,20
0.834054405610225,0.849079718721591,0.743886255924171,1083,208,28,25,19,13,9,12
0.710702419392578,0.735110635778406,0.660541559648068,1049,242,34,29,15,12,19,17
0.678428457051355,0.698208649430369,0.671682698366027,1087,204,42,38,15,13,27,25
0.699054593147167,0.728780590727821,0.668440255396777,1074,217,29,26,10,9,19,17
0.759045141398083,0.777969881428257,0.611998361998362,1062,229,33,33,17,12,16,21
0.764592037355616,0.791449830037445,0.707414068745004,1078,213,39,40,19,16,20,24
0.776528776978417,0.79733164651091,0.763296178343949,1058,233,40,35,22,15,18,20
0.796577144559174,0.821069641669651,0.741794674859191,1059,232,32,31,23,18,9,13
0.802037093341441,0.834229297509151,0.811973822678243,1060,231,26,24,16,14,10,10
0.799738082765846,0.823113330378273,0.8024883171942,1072,219,46,33,26,18,20,15
0.749988626023658,0.774804852730972,0.700064004096262,1073,218,35,31,14,10,21,21
0.731994026111673,0.764883286814626,0.663956282231599,1065,226,33,27,14,11,19,16
0.779037800687285,0.805628302249393,0.725947417436779,1087,204,30,22,16,9,14,13
0.80072908986647,0.825679724523408,0.756384676775738,1064,227,39,38,22,22,17,16
0.675100401606426,0.692252161673081,0.657659460902055,1067,224,46,42,15,11,31,31
0.690458688620994,0.72115290894113,0.65952855245684,1060,231,38,36,20,17,18,19
0.778259034948372,0.790923750587694,0.692409114183308,1075,216,32,31,18,14,14,17
0.769548751007252,0.789860832711605,0.739294499105546,1063,228,50,43,24,15,26,28
0.808197234667823,0.823340352912319,0.747907188353048,1081,210,33,35,16,15,17,20
0.721186472987914,0.753692049667559,0.740235539654144,1054,237,42,43,21,23,21,20
0.732360471070148,0.782918621135425,0.710352690787473,1075,216,31,26,13,10,18,16
0.728882961299078,0.748513354426725,0.70141952267843,1069,222,34,28,16,11,18,17
0.739611621190569,0.758667169195677,0.725863213811421,1072,219,37,36,20,16,17,20
0.697081474703572,0.731207965638232,0.650035405485987,1067,224,42,43,19,18,23,25
0.723771977834029,0.73622971222118,0.682835690588441,1063,228,47,46,21,18,26,28
0.725213239046439,0.743031889293731,0.650529218843172,1056,235,44,43,16,14,28,29
0.726323842832942,0.754594392654643,0.676943567482241,1069,222,29,24,13,10,16,14
0.795406813122191,0.819365941259141,0.662499397793516,1066,225,38,33,20,14,18,19
0.69902924314689,0.732238168696731,0.707798043880518,1069,222,33,30,16,12,17,18
0.715787373461587,0.759646971467017,0.704595494111623,1084,207,38,31,20,16,18,15
0.789262483036174,0.810533486904459,0.789426523297491,1075,216,34,31,19,17,15,14
0.764471094262594,0.782094141562696,0.700707775024153,1053,238,44,38,23,18,21,20
0.780493469588502,0.801111386449764,0.710126162018592,1082,209,29,36,15,16,14,20
0.707288850659458,0.739023968376701,0.68036703992761,1051,240,39,28,17,10,22,18
0.712972062333287,0.739610132140703,0.624499545040946,1057,234,34,35,14,11,20,24
0.798171870829997,0.815791099250087,0.755912195121951,1080,211,42,41,24,20,18,21
0.775358422939068,0.796094325666195,0.760547184773989,1071,220,31,30,16,15,15,15
0.710544292037816,0.737733163507288,0.675265571622444,1074,217,29,34,14,15,15,19
0.715927258193445,0.751731729913163,0.651471902303415,1071,220,40,32,21,15,19,17
0.693884892086331,0.724748555318697,0.626139370773302,1056,235,40,38,17,13,23,25
0.772501005631537,0.794756747034535,0.764167719593804,1071,220,48,34,24,16,24,18
0.673477305056252,0.706655971364603,0.619366839814685,1066,225,37,34,16,14,21,20
0.79798549556809,0.816303285484757,0.760963261955258,1052,239,50,47,27,22,23,25
0.759996719399286,0.777649893450788,0.731933884913536,1073,218,44,43,20,17,24,26
0.746498476324426,0.76347486628748,0.751182033096927,1073,218,27,22,12,9,15,13
0.721126398053255,0.73940851333259,0.764019366960543,1059,232,34,33,13,14,21,19
0.778990220166691,0.791399984792495,0.682897862232779,1065,226,33,28,15,10,18,18
0.761969617600838,0.784253145609483,0.751672984229491,1057,234,46,34,21,13,25,21
0.729190243902439,0.756999892096063,0.711226777016251,1060,231,41,37,21,17,20,20
0.733393680762102,0.753888971135723,0.671369741213908,1055,236,37,34,17,13,20,21
0.700696703802294,0.724946701913062,0.693097078743928,1053,238,49,47,22,19,27,28
0.724975431700126,0.750287195928498,0.715232974910394,1044,247,34,31,15,14,19,17
0.69914695177434,0.733026013150767,0.681225483857063,1088,203,35,37,15,13,20,24
0.722487804878049,0.747098947682071,0.690062071641019,1073,218,41,37,17,16,24,21
0.655525846702317,0.671692155015737,0.572990271377368,1056,235,33,31,10,8,23,23
0.729086170445433,0.75922007052882,0.739718902169101,1071,220,44,36,22,18,22,18
0.749008730794159,0.783314656165596,0.692692682926829,1063,228,42,41,22,16,20,25
0.670226725960487,0.710284663879271,0.65883227725333,1079,212,44,37,16,15,28,22
0.684443352174982,0.711222433819839,0.62025379696243,1091,200,39,40,13,9,26,31
0.763307552320291,0.786287790431141,0.691573926868045,1055,236,35,33,19,12,16,21
0.708893385363974,0.74560558297369,0.684870606953999,1071,220,33,34,12,12,21,22
0.702114723764208,0.729315195161468,0.71707103268861,1054,237,30,28,10,9,20,19
0.748555972240183,0.772002630453953,0.710428387248007,1064,227,37,27,18,10,19,17
0.67886690647482,0.711623079830413,0.695142496139267,1063,228,40,34,19,14,21,20
0.739329892684525,0.749819793272182,0.680849441457928,1061,230,39,42,19,19,20,23
0.770042194092827,0.79738739549518,0.76333276778645,1061,230,27,28,14,14,13,14
0.773463901689708,0.814981191590488,0.634193724534801,1080,211,31,38,20,19,11,19
0.739951305887561,0.777818853662835,0.771873534927332,1057,234,36,27,20,15,16,12
0.713071636267512,0.765686002436139,0.614657327019205,1066,225,30,24,16,9,14,15
0.756885533310712,0.791566530582199,0.732833464877664,1071,220,28,24,13,11,15,13
0.710281248537601,0.743759614916611,0.668762345232933,1053,238,34,33,16,13,18,20
0.788291421437489,0.799433916195836,0.762485823497291,1080,211,45,38,20,16,25,22
0.672402854877082,0.702801897025454,0.645718232044199,1068,223,30,24,13,6,17,18
0.760582352687616,0.780902283544199,0.725637417566262,1071,220,37,38,20,18,17,20
0.781498212867355,0.804366819114721,0.685183716627015,1070,221,32,30,17,10,15,20
0.701466532498509,0.725842454260178,0.669065453896915,1043,248,43,45,21,20,22,25
0.696058536585366,0.712092644067188,0.662528557265399,1058,233,41,37,15,13,26,24
0.771504920257889,0.793145508960915,0.725943830570903,1041,250,28,24,15,10,13,14
0.711266046923417,0.737443909311567,0.707688972394855,1062,229,36,33,16,11,20,22
0.664618305355716,0.681716799436655,0.640447864132075,1081,210,40,37,14,13,26,24
0.78516425002048,0.820207074354437,0.732684115671336,1058,233,39,39,25,20,14,19
0.777332804652392,0.804873963610603,0.691133912128387,1061,230,30,24,17,12,13,12
0.671666882193198,0.701613524355336,0.621915002560164,1071,220,37,31,16,11,21,20
0.748423035962972,0.76937371810372,0.742826648133439,1054,237,39,32,19,18,20,14
0.658397041302621,0.690851543555142,0.622758438818565,1058,233,32,27,12,10,20,17
0.721281771247021,0.749652325530961,0.658409682162651,1056,235,32,28,15,10,17,18
0.781310803891449,0.815215524756008,0.688521230668342,1049,242,31,29,19,14,12,15
0.747338247338247,0.773185519221125,0.662607047592307,1062,229,37,34,20,14,17,20
0.7903037109832,0.81502055024576,0.725257323832146,1077,214,34,28,19,13,15,15
0.787070563386353,0.807152639220489,0.701881720430108,1068,223,37,31,17,11,20,20
0.699987068408121,0.720585754889723,0.66340991810737,1066,225,37,35,15,14,22,21
0.705439889650416,0.726175002605827,0.648977490757639,1058,233,37,34,17,13,20,21
0.714427346006293,0.735906482323361,0.667845768880801,1067,224,37,35,15,12,22,23
0.777947641886491,0.795594523961097,0.701988409272582,1072,219,40,40,20,16,20,24
0.696825167413403,0.718496042297181,0.643640786338364,1056,235,33,32,15,10,18,22
0.753118830596043,0.77539583215095,0.725689082315504,1083,208,38,34,20,17,18,17
0.755985634477255,0.794225999074194,0.675039872408294,1060,231,38,37,23,17,15,20
0.753252957233849,0.77337398549815,0.684126984126984,1051,240,35,31,21,15,14,16
0.740692784417884,0.766296527543691,0.731230633023462,1062,229,36,36,17,17,19,19
0.71944376177603,0.741456184613596,0.733387149609247,1070,221,39,34,18,14,21,20
0.678548770816812,0.706929197485909,0.635394265232975,1061,230,30,31,13,10,17,21
0.736806797853309,0.76136427284634,0.709394801500065,1072,219,43,37,21,18,22,19
0.694608735213831,0.715032394138235,0.718919610855095,1042,249,35,31,14,14,21,17
0.726418082886106,0.748004731743688,0.749088637666912,1046,245,43,39,18,16,25,23
0.7357910906298,0.778197006316561,0.712279359527843,1065,226,31,29,17,12,14,17
0.672406733393995,0.694926814695916,0.606437670609645,1055,236,35,35,13,10,22,25
0.709150669971017,0.726880380218587,0.629486438309968,1055,236,38,33,16,11,22,22
0.792140296979007,0.815396835855299,0.790906687813904,1041,250,31,30,18,18,13,12
0.73614903179737,0.752385579408849,0.761132347100874,1073,218,38,32,16,16,22,16
0.802944188428059,0.828962748410713,0.730197132616488,1064,227,31,31,20,16,11,15
0.738718725178713,0.771894619541663,0.696021640526805,1066,225,32,29,17,13,15,16
0.766601151200337,0.80779554083718,0.677482750820043,1074,217,34,28,19,12,15,16
0.702854877081681,0.73676780324655,0.675217613927292,1067,224,30,31,14,13,16,18
0.747905844915532,0.786919709438296,0.689899792840969,1051,240,34,33,17,13,17,20
0.784727181081195,0.816078580874424,0.75728504765687,1075,216,38,32,22,18,16,14
0.706540036396724,0.736153691820801,0.594898228918847,1057,234,35,30,17,12,18,18
0.749307317073171,0.774247775523572,0.696634146341464,1070,221,41,41,21,17,20,24
0.805031924597142,0.828656314813728,0.692182632930761,1086,205,26,29,14,12,12,17
0.706687898089172,0.737300871114301,0.65636169579031,1068,223,35,32,13,8,22,24
0.704329483083477,0.726502753574125,0.68160138748374,1045,246,39,33,18,14,21,19
0.751353503184714,0.780169314068438,0.68899648311413,1055,236,35,33,17,12,18,21
0.725475137216351,0.736628388943798,0.684378544125678,1058,233,39,38,17,15,22,23
0.743299401425903,0.760652527177929,0.715913386819003,1053,238,42,38,14,12,28,26
0.749428113919707,0.770139445657755,0.718399279102155,1063,228,42,39,23,19,19,20
0.761380403300727,0.779917997381,0.746135885293344,1060,231,29,24,14,11,15,13
0.770473197136372,0.79084373363533,0.709707317073171,1059,232,46,41,22,15,24,26
0.755171042163882,0.771753765740239,0.71941884280594,1048,243,34,31,17,15,17,16
0.778632354013268,0.801449660735086,0.701926807189965,1057,234,44,37,28,19,16,18
0.742945695826785,0.759614496921592,0.696671623012696,1069,222,46,42,21,16,25,26
0.764862771137672,0.781468367723494,0.680043522785458,1072,219,36,31,17,12,19,19
0.67807752750131,0.697826484724999,0.718625498007968,1071,220,46,36,12,9,34,27
0.732133279699651,0.753713122210501,0.716863275169984,1076,215,48,39,22,19,26,20
0.766343883990943,0.79540554761782,0.618332011630981,1072,219,33,30,14,10,19,20
0.704058536585366,0.725326291606452,0.630749170222855,1063,228,41,37,15,13,26,24
0.742176258992806,0.758598303289721,0.710918884034948,1059,232,40,32,19,13,21,19
0.71492305702832,0.760832744313131,0.691088755408073,1040,251,37,38,19,19,18,19
0.733089862771138,0.762178731555764,0.702853961556493,1068,223,36,27,17,9,19,18
0.718878080769441,0.745992334712091,0.637556005203064,1080,211,29,33,12,10,17,23
0.730787959274015,0.750382107111052,0.744144858577848,1069,222,36,30,16,14,20,16
0.732503320053121,0.767058978062324,0.741003184713376,1058,233,36,35,20,16,16,19
0.757154213036566,0.783496375284104,0.678995658228885,1052,239,33,39,15,13,18,26
0.712935133067381,0.747429590879025,0.682304038004751,1060,231,29,28,12,10,17,18
0.811100044267375,0.829524249500741,0.767282365156566,1045,246,36,29,21,15,15,14
0.80816357555488,0.822871040084268,0.710941162681669,1064,227,26,27,15,12,11,15
0.758799932792876,0.772730884313012,0.798420221169036,1063,228,38,25,18,13,20,12
0.746841457960644,0.773335588396049,0.726753503279666,1054,237,43,43,23,20,20,23
0.712787744736627,0.735698904485383,0.637010919017288,1075,216,39,35,16,12,23,23
0.746051696814033,0.784025010486134,0.693597340656164,1080,211,29,33,15,15,14,18
0.728126181375226,0.754400933939752,0.689514380690851,1049,242,38,33,19,14,19,19
0.807171314741036,0.822956315501918,0.794200973882249,1063,228,36,36,20,20,16,16
0.727443902439024,0.763517836051061,0.701549635760162,1065,226,41,37,22,19,19,18
0.709920537396576,0.733930236280159,0.727581892629663,1053,238,39,35,16,16,23,19
0.72747511236191,0.753637580786937,0.670984986351228,1042,249,38,35,17,13,21,22
0.753859857482185,0.783686151904889,0.741781874039939,1061,230,28,31,15,14,13,17
0.74784473468684,0.768307374315977,0.681115166830455,1049,242,37,34,15,10,22,24
0.756982343499197,0.777273017306474,0.698031574740208,1076,215,45,40,15,11,30,29
0.762733320095314,0.810521843579553,0.721300563236047,1086,205,32,31,17,12,15,19
0.77098178939034,0.800896141480956,0.721717968955538,1051,240,28,24,15,8,13,16
0.757284796758481,0.782734584988833,0.714098468092078,1069,222,37,39,19,19,18,20
0.769126077949607,0.792027416364858,0.71947004608295,1056,235,33,31,18,14,15,17
0.735367002539527,0.774193398965124,0.699161728573493,1044,247,39,33,21,16,18,17
0.762903513465311,0.772012570682652,0.72880208929048,1066,225,45,42,21,21,24,21
0.792128784688099,0.801103966482739,0.763748079877112,1056,235,34,31,15,12,19,19
0.793753200204813,0.812510576763535,0.75463389656938,1073,218,31,31,17,15,14,16
0.758169866005796,0.798572555879137,0.727573830515007,1069,222,38,33,24,17,14,16
0.747531707317073,0.779787712638545,0.695704057279236,1043,248,41,34,23,17,18,17
0.739575653313672,0.764961068167206,0.719707746023535,1056,235,39,37,21,17,18,20
0.751387787470262,0.774844357746233,0.758658579465541,1070,221,30,27,14,12,16,15
0.764558817190396,0.788431696129613,0.727635389912017,1085,206,37,29,19,12,18,17
0.688223632038065,0.712159229193322,0.66837166270156,1077,214,30,30,10,10,20,20
0.730389552899513,0.741635816393368,0.718551429706116,1080,211,36,32,13,11,23,21
0.740878070973612,0.782416860280395,0.696818828397776,1063,228,35,37,17,16,18,21
0.735401678657074,0.779571889614779,0.712306463504547,1068,223,40,39,22,19,18,20
0.767379342210274,0.783515103273024,0.735450691333044,1071,220,38,33,15,10,23,23
0.727785671348161,0.749806864040152,0.685125497188314,1053,238,29,23,12,7,17,16
0.688897806313537,0.713025274365125,0.660257344900489,1079,212,45,44,16,15,29,29
0.688457281983178,0.717137961041453,0.669964222595802,1070,221,36,37,14,15,22,22
0.759430494287977,0.791188195820453,0.715907962668785,1071,220,28,32,15,14,13,18
0.690311921755221,0.729655937148081,0.634269790718835,1064,227,30,35,11,9,19,26
0.719284244129878,0.743922125580608,0.67848829690935,1021,270,38,37,18,16,20,21
0.734862560795672,0.779429632559132,0.689388871997568,1071,220,29,26,17,13,12,13
0.78235996069072,0.799833864579849,0.702312970340859,1062,229,34,36,18,13,16,23
0.720494641770789,0.746341395874575,0.709123028686415,1073,218,34,34,13,12,21,22
0.694792879003405,0.721621498152378,0.685555050045496,1054,237,37,35,15,14,22,21
0.683461054557932,0.710244719122691,0.69578853046595,1063,228,42,31,21,15,21,16
0.722052358113509,0.748725173597579,0.643541501191422,1069,222,40,32,19,12,21,20
0.733555325660589,0.760269522161594,0.729350928915719,1065,226,37,34,18,16,19,18
0.716787989080983,0.744075376701965,0.723701846703733,1089,202,35,32,16,15,19,17
0.76834320951968,0.793154215052904,0.746415770609319,1079,212,33,31,16,14,17,17
0.726933928094857,0.75844181505593,0.704266586730615,1059,232,42,40,21,17,21,23
0.790166129296683,0.804071160935869,0.705559289284664,1050,241,29,38,16,18,13,20
0.754897314375987,0.781302943484838,0.718957345971564,1050,241,25,25,14,13,11,12
0.679980992844365,0.7147282495809,0.662045570916539,1060,231,43,31,18,10,25,21
0.704991146525011,0.727708379879315,0.672377158034529,1053,238,36,36,16,17,20,19
0.807243565222143,0.822804111245786,0.738045007032349,1049,242,29,27,18,14,11,13
0.769489206445728,0.796169142934138,0.710816232570376,1076,215,26,24,14,9,12,15
0.684715821812596,0.729334049949965,0.59697315986873,1051,240,31,27,15,9,16,18
0.771317259629521,0.785459341653308,0.73449240607514,1066,225,38,40,15,13,23,27
0.771332275971451,0.785721615137249,0.763443917851501,1071,220,30,25,15,13,15,12
0.743391488236849,0.776882382463716,0.747446032228641,1073,218,30,26,13,10,17,16
0.735688684075781,0.761149075455685,0.663796516231196,1059,232,31,28,16,13,15,15
0.758948073868149,0.795406757231862,0.684285081894644,1089,202,32,36,15,15,17,21
0.777805711987128,0.810307362979573,0.687855770909726,1074,217,48,46,27,22,21,24
0.746702080566622,0.767015852623587,0.74292828685259,1049,242,36,36,16,15,20,21
0.751428856914468,0.788219490918377,0.704130262112788,1035,256,40,32,20,13,20,19
0.731186365648517,0.770336501823164,0.746028594122319,1070,221,36,32,19,14,17,18
0.774910394265233,0.798998347710265,0.742944802624137,1088,203,31,28,14,12,17,16
0.754977527617928,0.79719063959521,0.682180306381584,1059,232,38,39,23,19,15,20
0.722461179558212,0.746414231769484,0.698050993405301,1079,212,44,38,19,16,25,22
0.763277288497465,0.782439706130064,0.706562748212867,1076,215,42,32,22,16,20,16
0.776265280262373,0.805998601039338,0.702519505151084,1054,237,43,37,25,18,18,19
0.739069608735214,0.765074903700872,0.685051095688289,1077,214,35,29,16,14,19,15
0.709662368510349,0.744003873287416,0.69410155062329,1063,228,28,26,15,13,13,13
0.718770735114371,0.733251683834821,0.674928920317854,1044,247,46,44,16,14,30,30
0.735367002539527,0.755312770242802,0.641264786169245,1051,240,39,35,17,11,22,24
0.750651069013315,0.787756021184798,0.764619300575476,1059,232,38,36,21,19,17,17
0.817230331936214,0.849297201179026,0.758382620564149,1037,254,33,35,22,15,11,20
0.770944741532977,0.789002288624003,0.695852534562212,1071,220,33,31,18,16,15,15
0.763875235520603,0.7854557405995,0.750549592654856,1072,219,39,37,20,19,19,18
0.794955265258117,0.817387575418247,0.644608735213831,1058,233,38,35,23,12,15,23
0.805357581715409,0.831251710402536,0.753238170763944,1069,222,39,30,22,14,17,16
0.736117528458017,0.765644824629868,0.694271811918871,1052,239,38,33,20,14,18,19
0.768847395760213,0.811189670787826,0.70849127240395,1062,229,34,34,19,17,15,17
0.762306330234617,0.776258330357681,0.711736716891356,1069,222,36,30,19,14,17,16
0.744047619047619,0.768965045380293,0.706373718938649,1076,215,31,34,13,11,18,23
0.810899969595622,0.846125815588957,0.761436070491189,1047,244,26,21,19,15,7,6
0.682326250553342,0.715763923760894,0.688297923592041,1077,214,36,33,14,11,22,22
0.721977151905893,0.744131137369949,0.70203811161258,1052,239,28,22,14,9,14,13
0.703773793714033,0.73259064983698,0.62826224328594,1068,223,36,25,17,7,19,18
0.750591540964212,0.778051440042787,0.727073511437052,1039,252,49,46,26,24,23,22
0.757503492797611,0.786669906955579,0.756821414716151,1083,208,33,37,13,13,20,24
0.754387372926699,0.774885025941507,0.672126892179901,1053,238,45,29,24,11,21,18
0.754165236951466,0.788420856989923,0.680767182763988,1065,226,42,39,24,18,18,21
0.746012759170654,0.755010881237019,0.667846991376403,1072,219,37,33,15,10,22,23
0.730535571542766,0.751939372958155,0.720020259493944,1068,223,40,37,17,16,23,21
0.746221161495624,0.766183474926258,0.677313677313677,1077,214,34,37,17,12,17,25
0.777514064697609,0.795042146105209,0.724338310145911,1073,218,27,28,11,8,16,20
0.782445003621945,0.812523814272677,0.689729299363057,1051,240,42,35,19,13,23,22
0.672463603275705,0.684462112439497,0.710890827385673,1061,230,35,30,11,9,24,21
0.748536585365854,0.766486177668087,0.709591716721973,1074,217,41,38,20,17,21,21
0.683831341301461,0.719561994055008,0.634570195092628,1063,228,36,29,15,9,21,20
0.694638131641954,0.719986146556325,0.689538583929992,1040,251,38,34,15,12,23,22
0.727067977067977,0.761348611378352,0.673773244859507,1063,228,37,39,19,17,18,22
0.802629978716935,0.831196508841842,0.696381878990575,1068,223,26,26,14,11,12,15
0.685092335186656,0.715148316307781,0.649980873271763,1064,227,32,29,12,8,20,21
0.818321910427174,0.8499412194292,0.807372245663385,1076,215,37,27,23,15,14,12
0.734978239505826,0.768426851917474,0.669892473118279,1078,213,34,31,15,13,19,18
0.742231075697211,0.760995226528236,0.704708826205641,1078,213,36,35,15,13,21,22
0.801496318436976,0.815296414604606,0.725669697714426,1072,219,44,39,22,17,22,22
0.670964861121236,0.69859252497721,0.662126685428655,1067,224,44,38,18,14,26,24
0.759219977317596,0.78427665298945,0.725973882248783,1062,229,38,36,18,16,20,20
0.73080736238631,0.76155857561485,0.759085195912345,1057,234,37,29,18,13,19,16
0.721992397137746,0.741721852830172,0.733005733005733,1079,212,43,33,19,13,24,20
0.713778220451527,0.749767263556451,0.697363031233999,1053,238,36,31,17,15,19,16
0.733439744612929,0.757220042461695,0.733953076582559,1070,221,38,36,18,16,20,20
0.659769817664555,0.691230871865766,0.646462164818195,1058,233,37,34,14,11,23,23
0.730312686344663,0.754383034847285,0.692447679708826,1062,229,43,35,23,18,20,17
0.752575519469181,0.778197378505729,0.740794573643411,1099,192,46,43,20,18,26,25
0.762348590150913,0.798831151026742,0.718290806195393,1091,200,32,32,19,16,13,16
0.718615107913669,0.73176734244283,0.64957604663487,1070,221,40,33,17,11,23,22
0.672080521560105,0.701015333841601,0.647512907069102,1058,233,42,32,18,11,24,21
0.733247614788312,0.746123970456013,0.657219512195122,1046,245,43,41,17,14,26,27
0.740869853917663,0.760548828319523,0.737690584184928,1064,227,36,29,14,11,22,18
0.727871822875298,0.775149188221043,0.609357652656622,1068,223,32,30,18,11,14,19
0.751045303676883,0.780449404368639,0.756733230926779,1068,223,37,31,19,18,18,13
0.763500909918107,0.776543249116272,0.762199312714777,1069,222,35,30,13,10,22,20
0.737173001878884,0.770500263625596,0.65762928827445,1067,224,33,31,17,13,16,18
0.769682412596744,0.795702473172006,0.713414121896921,1084,207,42,38,21,17,21,21
0.691992652899126,0.711201750367438,0.685226670520788,1102,189,32,33,9,10,23,23
0.680438805181073,0.716386485792349,0.645874702144559,1051,240,30,32,11,9,19,23
0.722474348855564,0.751325781884733,0.703744342339871,1057,234,24,23,12,7,12,16
0.762909463148317,0.783459117966706,0.692712470214456,1072,219,35,32,15,14,20,18
0.686286208994338,0.706993690809631,0.636579130262113,1074,217,34,32,13,9,21,23
0.7844726062468,0.809843198341793,0.773061369473742,1067,224,31,29,15,14,16,15
0.744040691409113,0.766110494153923,0.723892405063291,1067,224,37,27,18,12,19,15
0.720006963217826,0.756019211029876,0.721385365853659,1096,195,39,41,15,13,24,28
0.775890308390659,0.792503897983599,0.740304475598593,1082,209,34,33,18,15,16,18
0.720559924633407,0.748199023713675,0.660267988406771,1083,208,39,38,18,14,21,24
0.725559524677408,0.75664747006939,0.663692836373249,1079,212,44,30,22,12,22,18
0.787133230380458,0.805627227082487,0.717922283901665,1060,231,34,30,17,15,17,15
0.67065327359445,0.702098061477617,0.644321212972062,1064,227,33,34,14,10,19,24
0.672843036333829,0.703653575351995,0.699380495603517,1079,212,42,40,14,16,28,24
0.764768566588338,0.777102361108579,0.617670364500792,1092,199,29,29,10,6,19,23
0.770029387676446,0.792058363213418,0.708221760751954,1071,220,33,29,18,12,15,17
0.771504097277293,0.813472344967273,0.746556082148499,1089,202,30,25,17,12,13,13
0.691897544918393,0.71657344960754,0.670329858729941,1077,214,23,23,8,9,15,14
0.72068612391193,0.744623571518979,0.70864773629865,1090,201,31,32,11,11,20,21
0.736711790904829,0.771058874655904,0.740695102685624,1059,232,27,25,11,12,16,13
0.793859213661636,0.832489478505465,0.76733150262562,1079,212,32,33,19,19,13,14
0.751721405541286,0.792325978703063,0.644133849038912,1067,224,29,27,16,11,13,16
0.798782647189022,0.814457162753487,0.70704556230872,1086,205,36,37,17,15,19,22
0.767001302138027,0.796025874161993,0.751651305683564,1071,220,38,31,20,17,18,14
0.739091044479746,0.7756154716799,0.731235107227959,1072,219,32,32,13,14,19,18
0.727917665867306,0.757094152270281,0.630876494023904,1070,221,40,36,17,12,23,24
0.741857363470448,0.757530094787235,0.703834850893674,1074,217,34,33,15,12,19,21
0.723173756376059,0.74634188827929,0.719187761120669,1103,188,34,39,12,15,22,24
0.760459076231925,0.78038558174278,0.698979845115171,1075,216,34,32,15,13,19,19
0.77153607791058,0.797318829573514,0.678537306642402,1081,210,36,35,21,17,15,18
0.804108298517244,0.830580702292047,0.772661834789515,1086,205,39,32,20,18,19,14
0.804408260524226,0.829796759280108,0.725935828877005,1080,211,32,33,19,15,13,18
0.706701030927835,0.732664107652854,0.725326520574895,1081,210,30,29,12,11,18,18
0.793395283772982,0.816461540530905,0.773307188244639,1084,207,40,32,20,16,20,16
0.746710189452125,0.766302912171662,0.689336775218427,1083,208,31,32,14,13,17,19
0.777854868061875,0.813058755146601,0.789102789498359,1055,236,35,27,19,16,16,11
0.773941463414634,0.807780791840358,0.752058278374068,1057,234,41,37,20,15,21,22
0.76610343061956,0.791993826587248,0.721940259053661,1064,227,31,30,18,15,13,15
0.70545013239188,0.729700300389838,0.697654717317639,1058,233,55,45,24,20,31,25
0.799295486196445,0.814652497078341,0.732725668920906,1043,248,39,38,26,21,13,17
0.828770649071084,0.86128081506717,0.728057553956835,1049,242,34,40,21,17,13,23
0.744624270845248,0.775918303036943,0.721090435586172,1053,238,42,38,20,15,22,23
0.760080936551525,0.792517749681518,0.701374238162213,1081,210,33,27,17,11,16,16
0.758984920749627,0.77244650464972,0.668843484632958,1087,204,33,37,16,15,17,22
0.743501875080822,0.775573961776482,0.69775141560204,1071,220,37,34,19,16,18,18
0.775591212668543,0.796425660035963,0.741789168807039,1029,262,38,29,20,15,18,14
0.780753046614569,0.801159482712082,0.786260548523207,1067,224,29,27,16,15,13,12
0.792157535552251,0.809320647592922,0.717539116900139,1062,229,42,39,23,18,19,21
0.69809043493254,0.722798322416412,0.629640582347589,1081,210,37,35,15,9,22,26
0.800025601638505,0.815269881443781,0.752530933633296,1074,217,31,21,16,11,15,10
0.68636866452132,0.706266575098002,0.6547057796403,1073,218,48,46,16,13,32,33
0.708643204957946,0.739677208197868,0.696219382321619,1068,223,36,39,15,15,21,24
0.708637092658745,0.727338499905465,0.622875670840787,1040,251,44,43,19,14,25,29
0.808161102278749,0.832025366190176,0.768087345435412,1068,223,33,24,21,13,12,11
0.755660099970597,0.799507211756701,0.741818219054641,1060,231,38,39,21,19,17,20
0.754221447473432,0.780094793289581,0.712301003906414,1037,254,38,38,21,20,17,18
0.70856774496015,0.733094759400141,0.667192843988424,1084,207,27,24,11,9,16,15
0.704139173569189,0.72949630340775,0.686048417946336,1057,234,34,29,18,15,16,14
0.754505611534366,0.772137144056985,0.684684684684685,1094,197,39,33,16,11,23,22
0.713580527752502,0.759439008672563,0.675680676711604,1085,206,35,30,14,11,21,19
0.731662239929172,0.759572997272475,0.724827768945416,1083,208,36,33,17,12,19,21
0.751024065540195,0.779572087790846,0.698863335976738,1094,197,31,30,13,10,18,20
0.77418222658992,0.800943174736467,0.671620583717358,1076,215,34,31,18,11,16,20
0.69446451799393,0.71625475598043,0.708741258741259,1068,223,33,26,13,9,20,17
0.661598052235502,0.694953206775627,0.62988441199869,1076,215,36,34,13,10,23,24
0.719539641149811,0.741125490433898,0.751496435243433,1051,240,52,42,23,18,29,24
0.758746587807097,0.794946605362562,0.702377452009913,1072,219,35,38,19,19,16,19
0.773461708720673,0.803839677054959,0.731403647898493,1064,227,36,30,17,12,19,18
0.735402833111997,0.75320918983766,0.693199884376355,1054,237,36,33,18,15,18,18
0.741842320789689,0.777557486089497,0.74535540325014,1074,217,37,37,17,15,20,22
0.747299690128375,0.7697763068353,0.716513056835637,1058,233,36,31,17,13,19,18
0.785540325014009,0.809690674715324,0.663591901728844,1063,228,37,35,21,15,16,20
0.701866254908689,0.721950772343861,0.707258536585366,1051,240,42,41,17,16,25,25
0.757348736131763,0.78148309755044,0.770388809862494,1070,221,42,37,19,19,23,18
0.778908683534619,0.812110750686381,0.775576857821513,1069,222,29,28,17,14,12,14
0.79460487804878,0.820338651292858,0.765869853917663,1085,206,41,36,16,14,25,22
0.674125719344843,0.70275776150685,0.640911418330773,1062,229,36,31,15,10,21,21
0.709019563239308,0.738861353237615,0.712340306050821,1064,227,35,34,14,14,21,20
0.750286720734005,0.783267710332171,0.718415227976981,1049,242,39,36,19,16,20,20
0.803445543472321,0.821602561837132,0.74845700178302,1056,235,29,23,17,11,12,12
0.729038666338986,0.760755882726619,0.716811544473674,1067,224,39,42,20,18,19,24
0.66278801843318,0.69768239751788,0.640377014290058,1074,217,31,26,13,10,18,16
0.788435148295706,0.813308934404152,0.744075896391811,1061,230,36,28,21,14,15,14
0.721762589928057,0.748889128853371,0.692835731414868,1060,231,40,40,18,17,22,23
0.800739408473221,0.821684802350581,0.774052760894866,1069,222,40,37,21,16,19,21
0.752146967684816,0.779104857449992,0.748373521383076,1046,245,36,35,21,20,15,15
0.783698539176627,0.808020192484537,0.690229754322111,1086,205,36,35,17,12,19,23
0.777670433065905,0.794597543817193,0.716981335402388,1084,207,38,37,18,15,20,22
0.729659000793021,0.761246663926435,0.662860721684251,1066,225,30,33,14,11,16,22
0.70658308818499,0.727421851930207,0.653386454183267,1081,210,47,36,20,13,27,23
0.650521565869667,0.691338281624272,0.606810580723624,1062,229,27,26,10,9,17,17
0.749890646642852,0.77715157954908,0.681507110450265,1051,240,44,42,19,16,25,26
0.639222597299444,0.663444262491398,0.66690802776108,1054,237,32,29,10,10,22,19
0.732425852146968,0.753026156511108,0.698593757311994,1067,224,36,34,17,18,19,16
0.688865170770453,0.740538762572613,0.601642913697545,1057,234,32,28,15,11,17,17
0.752941937152463,0.787410647122707,0.746443446113529,1075,216,37,34,19,19,18,15
0.766728273196959,0.779050729889083,0.714336917562724,1064,227,38,31,18,11,20,20
0.794635544635545,0.830365044590347,0.767803330689929,1052,239,37,30,22,15,15,15
0.71260487804878,0.733655983074508,0.667311191992721,1063,228,41,35,18,13,23,22
0.767689175909027,0.788199539392941,0.725020475020475,1049,242,34,33,17,14,17,19
0.754583712465878,0.791324304427371,0.699910643367752,1089,202,35,32,19,14,16,18
0.691483816521048,0.727446990628391,0.620622119815669,1077,214,32,31,14,12,18,19
0.808706537507604,0.823625189646965,0.782453554214048,1059,232,34,34,18,13,16,21
0.735071833029154,0.768480877482719,0.688284696301323,1082,209,34,28,16,8,18,20
0.737105341540906,0.763481089570979,0.73829676330421,1056,235,32,32,18,17,14,15
0.752636776982707,0.780345514579001,0.74658273381295,1068,223,43,40,23,20,20,20
0.756299079828491,0.790823381052829,0.719204172526957,1051,240,33,27,19,15,14,12
0.85876687847498,0.864741545539703,0.760663082437276,1069,222,32,31,22,17,10,14
0.766594227763163,0.782515886278637,0.729089866470058,1068,223,42,39,21,18,21,21
0.764194722474977,0.787809090795829,0.701103885458222,1050,241,35,29,14,10,21,19
0.758187502382859,0.779355924937771,0.73605550500455,1071,220,42,35,24,19,18,16
0.670495672698663,0.711578803997727,0.669267707082833,1075,216,20,17,6,4,14,13
0.682331707317073,0.702408977064983,0.673051558752998,1078,213,41,40,15,13,26,27
0.798773244859507,0.817072958867878,0.747452636968766,1072,219,39,31,21,14,18,17
0.722997620935765,0.750852270513316,0.672706846418187,1092,199,30,30,12,9,18,21
0.662151394422311,0.685402387091496,0.597634152788792,1079,212,36,30,14,7,22,23
0.724347524969016,0.750069442831772,0.699454049135578,1036,255,44,35,22,13,22,22
0.782242769084874,0.816231115569889,0.725645501961292,1045,246,37,37,24,19,13,18
0.707885304659498,0.741037424287621,0.621072189737144,1080,211,31,29,11,8,20,21
0.676569608735214,0.695106573099473,0.663888888888889,1083,208,35,36,13,14,22,22
0.754740865766481,0.781354895687816,0.706859635210151,1073,218,32,30,18,14,14,16
0.778939326177698,0.800973531434809,0.690371845949535,1077,214,43,36,24,16,19,20
0.72078712153119,0.748100010724546,0.615418424753868,1052,239,34,27,18,11,16,16
0.721706161137441,0.752107094388798,0.63785151856018,1066,225,25,21,11,6,14,15
0.742786491065085,0.781865913752533,0.694491502267884,1091,200,29,29,16,13,13,16
0.77868904103835,0.808153890863568,0.670143312101911,1080,211,38,35,19,13,19,22
0.716699434750553,0.752815088672257,0.613045950864422,1060,231,39,35,19,13,20,22
0.702091633466135,0.725826393684497,0.744012638230648,1090,201,36,25,12,8,24,17
0.796428571428571,0.817031687529099,0.692723824302772,1080,211,35,37,19,16,16,21
0.72320185139674,0.756467401215762,0.694994459700342,1075,216,39,33,21,15,18,18
0.786620185922975,0.805196694721446,0.700886798633535,1066,225,36,34,19,14,17,20
0.801189639006095,0.843745540600939,0.734575659872124,1082,209,27,29,13,10,14,19
0.762712195121951,0.782331204515437,0.744951520011664,1074,217,41,44,21,20,20,24
0.711025196319314,0.735881962803057,0.68173124214438,1084,207,33,29,12,9,21,20
0.781318732743694,0.803850280630728,0.711184834123223,1060,231,34,25,17,13,17,12
0.716106532962669,0.748477030133313,0.64455186533212,1089,202,32,35,14,13,18,22
0.761489309412632,0.794059771456174,0.6984005079053,1066,225,39,39,20,17,19,22
0.730843768634466,0.755176615052152,0.698428508189464,1060,231,43,36,21,14,22,22
0.746019512195122,0.770160377625352,0.699988562278394,1085,206,41,42,20,15,21,27
0.794835868694956,0.808568845211878,0.780113716130844,1061,230,42,34,24,17,18,17
0.717892814549791,0.742331334136806,0.714528054658617,1059,232,43,34,20,16,23,18
0.748665080623844,0.766080623905507,0.723828911039356,1060,231,30,34,15,17,15,17
0.800330425588158,0.829205631887827,0.759543603664744,1080,211,30,28,15,12,15,16
0.704792708027051,0.732286275361837,0.69340746624305,1055,236,38,32,17,14,21,18
0.719252432155658,0.757068871897963,0.677810262855894,1079,212,31,29,15,11,16,18
0.688803117553614,0.713830686117353,0.654129952002293,1095,196,32,22,13,7,19,15
0.755118755118755,0.785771440829156,0.719508448540707,1091,200,37,31,12,8,25,23
0.714086193136473,0.736882989849769,0.691435395814377,1066,225,38,35,17,14,21,21
0.739452975572436,0.755968827058013,0.703835560243788,1063,228,29,27,14,11,15,16
0.781085898732958,0.802821048373018,0.714750635803267,1080,211,33,37,17,16,16,21
0.739767200393464,0.770212070620726,0.69081416864922,1077,214,29,30,15,11,14,19
0.754751219512195,0.79288820162379,0.7174135577798,1072,219,41,35,21,16,20,19
0.79174413457282,0.813255791590157,0.736802355350742,1069,222,36,31,21,17,15,14
0.679103885804917,0.704911080589896,0.594630132337971,1041,250,30,28,13,7,17,21
0.701465934652484,0.731050225986205,0.626444850016379,1076,215,42,34,18,9,24,25
0.765195632393085,0.792347981424124,0.713000433588669,1083,208,35,33,16,12,19,21
0.726594034343573,0.750642051611517,0.682610387482592,1057,234,47,39,20,15,27,24
0.725946464504656,0.75605876844494,0.722307229903274,1093,198,34,29,18,16,16,13
0.748491207034373,0.778151016917819,0.712420063948841,1082,209,40,40,20,17,20,23
0.691756272401434,0.730282164462545,0.627035968781812,1051,240,31,28,11,8,20,20
0.757779961626656,0.786373359663305,0.72523129791171,1069,222,34,30,18,15,16,15
0.735623003194888,0.765347895986953,0.710796012915906,1064,227,39,34,18,13,21,21
0.754576338928857,0.774704386321578,0.704485233896999,1093,198,40,33,15,10,25,23
0.700152802623733,0.716829883538957,0.665657267672756,1084,207,43,32,17,10,26,22
0.790517585931255,0.804915482111867,0.76936763952893,1068,223,40,31,21,15,19,16
0.727477477477477,0.777852826029336,0.660138248847926,1082,209,33,31,16,13,17,18
0.755980658296573,0.777428013422586,0.646286016389109,1073,218,28,30,11,8,17,22
0.715366959943166,0.756552280400163,0.660363954314444,1077,214,29,29,12,11,17,18
0.805853658536585,0.844371242995287,0.723565670934092,1064,227,41,37,30,22,11,15
0.852277381830097,0.866679260008248,0.776252782794976,1039,252,39,38,26,25,13,13
0.732943143812709,0.766425676923194,0.679176381840626,1068,223,26,23,10,9,16,14
0.730121864582764,0.780181030265014,0.69299497753106,1065,226,29,30,15,14,14,16
0.626811953931692,0.670516637327271,0.739501312335958,1070,221,32,21,13,8,19,13
0.776280081925243,0.791763340652608,0.720625293014533,1057,234,31,27,16,13,15,14
0.808419512195122,0.820706534114781,0.753833030027298,1052,239,41,35,24,17,17,18
0.728200204813108,0.770478399322331,0.641372247823861,1062,229,31,31,16,12,15,19
0.723813542494043,0.771214011388662,0.71548991748183,1070,221,32,29,18,15,14,14
0.776713879655056,0.80854241050564,0.751397658510918,1061,230,33,24,15,11,18,13
0.710679021011746,0.7445331286542,0.694422416071901,1062,229,34,30,19,15,15,15
0.729339125675583,0.74644755416303,0.735629268292683,1071,220,47,41,18,16,29,25
0.696868292682927,0.722002517197352,0.649749637325097,1061,230,41,34,19,13,22,21
0.724597807367581,0.746193822162095,0.652599123187358,1073,218,38,33,18,13,20,20
0.749255361397935,0.784895200113147,0.75370433208913,1058,233,32,28,17,15,15,13
0.752356103731815,0.762705412943102,0.707112195121951,1054,237,51,41,23,17,28,24
0.770812256106374,0.799365552224304,0.70080420969023,1072,219,33,32,14,9,19,23
0.770711514290399,0.790002640042376,0.74799230856238,1080,211,29,28,13,9,16,19
0.736380303823992,0.764775904168787,0.736520783373301,1053,238,46,40,25,21,21,19
0.764442231075697,0.786636296362135,0.745673323092678,1062,229,36,31,16,13,20,18
0.77809756097561,0.792106273627879,0.707155458478599,1084,207,41,38,19,14,22,24
0.709408602150538,0.72984773540895,0.665146708961142,1078,213,31,30,10,6,21,24
0.748666358634015,0.785624337751865,0.727140241846124,1075,216,38,33,23,18,15,15
0.766188779549825,0.793324677892931,0.726397679324895,1062,229,28,27,15,12,13,15
0.734989938696242,0.772562026642516,0.773590728295159,1049,242,34,23,18,13,16,10
0.789420097388225,0.809192593348075,0.759423737774253,1044,247,36,30,21,18,15,12
0.76326688193177,0.805573065459048,0.705464779266602,1051,240,34,38,21,20,13,18
0.68536169244768,0.705688194177954,0.665458697378872,1058,233,35,32,15,13,20,19
0.783246132848044,0.812289165378704,0.729094631483166,1089,202,35,35,17,15,18,20
0.749871991807476,0.768370939565774,0.725006608511763,1067,224,31,30,14,13,17,17
0.753496870668291,0.784600582839641,0.668795919322383,1046,245,38,34,23,16,15,18
0.772773818300975,0.793504064941084,0.719125836492115,1084,207,39,34,19,15,20,19
0.749180487804878,0.766726586882407,0.719863602850823,1059,232,41,39,17,17,24,22
0.854874616709371,0.868730792581942,0.81616898540889,1060,231,38,28,29,19,9,9
0.784898009338904,0.801320265140411,0.746940791058438,1070,221,39,33,19,12,20,21
0.749925536139793,0.776884096994613,0.700317208564631,1052,239,32,30,18,15,14,15
0.752274795268426,0.783607322753303,0.705698362147407,1054,237,35,35,20,19,15,16
0.699910643367752,0.74567143667042,0.659995081698454,1076,215,32,29,18,12,14,17
0.757295796986519,0.776135480998627,0.71521327014218,1096,195,30,25,9,6,21,19
0.751024002621447,0.765867692687828,0.740449005154888,1051,240,39,33,16,13,23,20
0.793688466947961,0.801751694608316,0.731269468276955,1055,236,27,29,14,12,13,17
0.78930542652604,0.811041410779516,0.76104766633565,1081,210,29,19,15,10,14,9
0.703666398066076,0.717397707419206,0.667000266880171,1066,225,50,42,19,16,31,26
0.704361873990307,0.716619022193011,0.668048771597288,1085,206,53,44,19,16,34,28
0.784872102318146,0.815419423008701,0.689357807004866,1057,234,40,33,24,17,16,16
0.789368088467614,0.856161009127463,0.815988890412838,1077,214,25,23,18,16,7,7
0.749871308905424,0.770894744205828,0.723339973439575,1079,212,34,36,16,17,18,19
0.724360440733539,0.747673697557963,0.677866952024255,1057,234,42,45,21,21,21,24
0.839443510496142,0.858373668327794,0.803542162305049,1064,227,37,30,22,15,15,15
0.72865209707315,0.753806799477863,0.634699239713775,1062,229,37,43,18,19,19,24
0.773764208300291,0.79718816390745,0.66961082395865,1081,210,30,26,14,9,16,17
0.817937198745847,0.843411881064321,0.80150185159786,1086,205,34,23,21,11,13,12
0.749464443230982,0.782119272914735,0.736089030206677,1062,229,38,33,21,17,17,16
0.732563046068308,0.757845625217535,0.651037529785544,1062,229,32,32,15,11,17,21
0.62334583387215,0.645207487578605,0.59615975422427,1074,217,37,31,9,5,28,26
0.769195037980217,0.824124250388201,0.638299907098749,1041,250,29,29,19,12,10,17
0.793160690571049,0.817832518577924,0.749967671020303,1061,230,36,37,20,18,16,19
0.742009452945856,0.773102387325345,0.709242191500256,1081,210,34,31,18,15,16,16
0.797203791469194,0.818599079973824,0.715642573035249,1072,219,25,23,17,13,8,10
0.789260112647209,0.811985849389995,0.791826021747282,1069,222,31,21,17,12,14,9
0.722057619116443,0.758694489463443,0.664595076359782,1053,238,33,33,18,15,15,18
0.736737094131978,0.763867037214617,0.716410650281618,1058,233,38,31,17,11,21,20
0.761616362192216,0.806707703887021,0.673651083345032,1085,206,32,34,16,14,16,20
0.744477982123637,0.760887111188881,0.745271544876887,1078,213,34,32,11,10,23,22
0.791880963029219,0.811111838152148,0.687460031974421,1072,219,43,40,25,19,18,21
0.779326829268293,0.8059626853602,0.716043794991163,1053,238,41,37,24,19,17,18
0.780435132957293,0.789821029827461,0.733587883648028,1061,230,50,44,24,20,26,24
0.745655141037307,0.779723107365018,0.67884019477645,1076,215,35,36,16,14,19,22
0.806706010837149,0.835927144683464,0.740537848605578,1089,202,38,36,26,20,12,16
0.813191201769477,0.834242888604754,0.780385937086968,1040,251,39,30,26,19,13,11
0.704758128469469,0.740001912099284,0.667846991376403,1087,204,30,33,11,11,19,22
0.747521444889866,0.771225908974382,0.720636411812882,1066,225,37,33,19,12,18,21
0.768265873529031,0.788428881897842,0.755761629674673,1070,221,37,26,17,10,20,16
0.804534922211188,0.828130843093562,0.623800066203244,1083,208,19,19,9,3,10,16
0.764398192024495,0.786751545941466,0.761533212010919,1066,225,44,35,22,20,22,15
0.70994623655914,0.728035020045329,0.677388089528377,1082,209,51,40,22,15,29,25
0.755489154493139,0.789812913213943,0.750870455709165,1066,225,36,31,18,16,18,15
0.773971641162432,0.792523014653827,0.705273937532002,1063,228,34,31,16,14,18,17
0.788130498934368,0.812535381472083,0.778884159318942,1065,226,29,26,15,12,14,14
0.644175627240143,0.682256783924179,0.691258741258741,1071,220,31,26,11,8,20,18
0.745606008616417,0.771359713595647,0.626835494931425,1040,251,42,43,23,19,19,24
0.717761582727769,0.735870801988765,0.699933598937583,1080,211,38,36,15,10,23,26
0.705457585892368,0.755420678064241,0.723666163763544,1089,202,26,23,10,9,16,14
0.768388983004536,0.797763467888486,0.766270058976821,1064,227,29,23,16,10,13,13
0.713938848920863,0.729771977503762,0.701530254106416,1093,198,40,34,18,15,22,19
0.703555753668907,0.712778324286697,0.749751737835154,1070,221,23,19,8,9,15,10
0.704057279236277,0.725271776322743,0.684081097327723,1069,222,34,29,14,10,20,19
0.688455619539317,0.718601934981586,0.64347456633849,1065,226,32,27,11,7,21,20
0.73139512195122,0.763127271034097,0.718377310673822,1046,245,41,43,19,20,22,23
0.76050753370341,0.789159378835876,0.723362741771293,1085,206,30,28,14,11,16,17
0.764027108970929,0.796036979033439,0.746260614681667,1043,248,45,37,27,22,18,15
0.739120809614168,0.762652141591982,0.685497117189595,1042,249,51,48,25,20,26,28
0.720484531392175,0.737237954618414,0.703370659427667,1038,253,35,28,17,11,18,17
0.757360471070149,0.791012645474531,0.627472353870458,1076,215,31,25,15,9,16,16
0.729632602104512,0.746043802326784,0.698267387564512,1057,234,45,39,20,18,25,21
0.716267871326449,0.746687468833446,0.70683383918678,1048,243,32,33,12,11,20,22
0.683391525496789,0.710213602861697,0.691775615688659,1073,218,37,26,13,11,24,15
0.69385435301133,0.724719637001897,0.671226206285967,1060,231,43,36,18,13,25,23
0.756029268292683,0.786401319840713,0.676516229147808,1073,218,41,37,24,15,17,22
0.777750471041206,0.803279122199784,0.71335304822566,1084,207,39,35,21,15,18,20
0.697541633624108,0.722453498628378,0.712654028436019,1069,222,30,25,13,11,17,14
0.725372736954207,0.737005641827491,0.729597244303127,1070,221,39,33,16,16,23,17
0.736121103117506,0.774347570528491,0.713217023526302,1064,227,40,30,20,15,20,15
0.714879951722057,0.741380952682528,0.675099127676447,1067,224,37,30,16,13,21,17
0.689573157395932,0.724688983360256,0.61779179120799,1078,213,44,44,17,16,27,28
0.741200067207124,0.762555661726106,0.695015159621901,1062,229,38,45,17,16,21,29
0.718060162415647,0.744999793313665,0.671556685008611,1071,220,42,38,20,16,22,22
0.707059533386967,0.731908255319509,0.659251210492203,1077,214,48,42,22,16,26,26
0.736511706820495,0.759768650709902,0.725290588676416,1071,220,28,21,12,9,16,12
0.762554420449157,0.783073305336459,0.736571504097277,1061,230,37,30,19,13,18,17
0.72515923566879,0.743920435123686,0.69279934471803,1088,203,35,32,12,10,23,22
0.683859670680757,0.697837757456503,0.682215638097991,1057,234,39,33,11,10,28,23
0.702579375922181,0.735579624063441,0.71229216152019,1075,216,29,28,13,11,16,17
0.736747839232311,0.752849311948865,0.666210122242099,1051,240,49,43,21,14,28,29
0.810738546032664,0.843579989281959,0.792560360993905,1081,210,33,27,23,18,10,9
0.722,0.74489295869123,0.671146953405018,1051,240,41,31,18,11,23,20
0.733684641579378,0.7674728518588,0.657188353048226,1059,232,37,35,20,15,17,20
0.712352138307552,0.750442849550792,0.711443841194435,1082,209,35,28,16,13,19,15
0.752843601895735,0.783053566296343,0.70044994375703,1053,238,25,21,11,8,14,13
0.735995903737839,0.778115802022475,0.730600032788677,1071,220,31,29,14,13,17,16
0.639353696325808,0.660502471547454,0.699747235387046,1073,218,36,25,10,7,26,18
0.71742191500256,0.743404590621665,0.702564755118199,1067,224,31,28,12,11,19,17
0.768581230633023,0.794338154723502,0.753817441465898,1067,224,36,28,20,13,16,15
0.708289578695342,0.724364815297139,0.709690230341541,1070,221,38,32,15,14,23,18
0.678936341659952,0.69157075799577,0.663364422202002,1078,213,50,35,17,11,33,24
0.720244275643478,0.752937010869518,0.694265354597896,1055,236,29,28,15,12,14,16
0.823153489424273,0.858817665204955,0.74866678387248,1066,225,28,27,17,13,11,14
0.72513922036595,0.749143275733105,0.715349038878451,1059,232,34,33,16,16,18,17
0.800523729150119,0.833824390053702,0.714003164556962,1088,203,32,27,16,10,16,17
0.729036770583533,0.760163798692614,0.704414485857785,1084,207,40,30,18,12,22,18
0.750319744204636,0.778374100537245,0.755495926548558,1064,227,40,37,20,19,20,18
0.7088572529749,0.720731218775956,0.631218609569125,1083,208,33,30,12,7,21,23
0.710116772377872,0.735508262298279,0.677523515372736,1067,224,38,34,17,15,21,19
0.731234510858151,0.749455496529908,0.672044053623001,1056,235,38,37,16,12,22,25
0.748961691895732,0.786467873730805,0.69558997632202,1059,232,29,24,13,11,16,13
0.765212794078774,0.795894339147768,0.735818133756278,1060,231,30,30,13,14,17,16
0.701483457344752,0.730883212797408,0.652084869337266,1078,213,34,39,13,13,21,26
0.705547480620155,0.726353479891385,0.621919029784198,1062,229,43,45,19,14,24,31
0.734643734643735,0.752233518722296,0.695323854660348,1065,226,33,25,14,10,19,15
0.763773885350318,0.784418845562945,0.775114016418364,1085,206,35,26,13,10,22,16
0.713323039383888,0.740212845708593,0.663584637268848,1061,230,42,37,19,14,23,23
0.738991295442908,0.767526501568115,0.695147679324894,1089,202,31,27,14,10,17,17
0.698500163788666,0.741257666598585,0.68102082080988,1104,187,34,29,14,9,20,20
0.805977982590886,0.827829776342203,0.792092464069075,1091,200,31,29,18,15,13,14
0.755152411282985,0.783385800871086,0.646667424931756,1093,198,35,35,16,11,19,24
0.790704104202507,0.814921018886187,0.70155836518671,1059,232,39,38,24,18,15,20
0.735106930600402,0.752890697351494,0.688400729705077,1070,221,34,26,15,8,19,18
0.746962430055955,0.787796313616918,0.763224878264719,1095,196,40,36,21,18,19,18
0.760338988848601,0.78387962034078,0.718536585365854,1095,196,47,41,20,14,27,27
0.761300959232614,0.798005148621563,0.739348521183054,1044,247,40,40,23,21,17,19
0.705659765907964,0.725741169206166,0.730209281164695,1062,229,42,35,17,12,25,23
0.773746341463415,0.800366288771756,0.732302092811647,1083,208,41,35,20,16,21,19
0.727592054263566,0.747015234777433,0.663754357961944,1054,237,43,38,21,14,22,24
0.785840299071702,0.801520685881162,0.706034442416585,1067,224,38,34,21,15,17,19
0.791215011803247,0.824732833486336,0.754336615096109,1062,229,33,27,17,13,16,14
0.789287295263391,0.823689109465468,0.700659690627844,1074,217,36,35,24,17,12,18
0.669476474124269,0.694804612142143,0.637739767200393,1086,205,29,29,9,8,20,21
0.753948418532364,0.782586064392429,0.65060696433822,1053,238,38,38,19,15,19,23
0.746509805351024,0.777978088734673,0.713588252832439,1065,226,44,43,23,20,21,23
0.746974764366069,0.786736011660535,0.638904487809444,1063,228,26,34,14,13,12,21
0.786907923860115,0.814409685811435,0.730162850428985,1063,228,36,29,18,12,18,17
0.806468292682927,0.83454003740916,0.784588463065925,1080,211,41,32,27,19,14,13
0.741933081810961,0.776303051606615,0.704608294930876,1068,223,32,31,13,10,19,21
0.734808996136181,0.763107551077923,0.658770731707317,1061,230,44,41,22,15,22,26
0.732576537420413,0.751428341913262,0.651159072741807,1094,197,42,40,19,17,23,23
0.67115912704148,0.699683203894931,0.636558287073751,1043,248,33,30,14,13,19,17
0.714762286019291,0.746325264479549,0.700388882534599,1091,200,42,42,20,18,22,24
0.649468791500664,0.673505453964124,0.617332309267793,1063,228,36,31,10,7,26,24
0.750926764084659,0.773818046797468,0.708350882118957,1083,208,37,34,18,14,19,20
0.749031007751938,0.767418022550161,0.662535530182589,1081,210,43,33,17,11,26,22
0.750937382827147,0.778707679350058,0.662298462692163,1068,223,21,21,9,10,12,11
0.744123417157125,0.769403469057321,0.70561738208797,1054,237,45,33,22,16,23,17
0.751974214343271,0.779720714250012,0.724210631494804,1084,207,50,40,24,17,26,23
0.754368849677638,0.788074606106827,0.735924427376217,1083,208,28,23,15,10,13,13
0.66445793254085,0.688194405035268,0.65487241858618,1082,209,38,32,13,8,25,24
0.720428865459739,0.738466861716624,0.707974910394265,1054,237,38,31,18,17,20,14
0.70807560137457,0.728259886386453,0.632481186365649,1081,210,30,36,10,11,20,25
0.77191235059761,0.807323554046558,0.698740184034302,1046,245,36,33,23,19,13,14
0.742334126354745,0.778318393850214,0.701518493383101,1080,211,30,28,18,14,12,14
0.762065653920028,0.801082699325148,0.754321306952886,1040,251,46,37,29,22,17,15
0.801437237007487,0.813665659452515,0.763566572902016,1059,232,29,27,16,13,13,14
0.772133757961784,0.798214802671709,0.782808499743984,1057,234,35,31,21,15,14,16
0.682026294787248,0.704547041791899,0.658984097491666,1071,220,38,29,16,9,22,20
0.738343055396698,0.763309411531486,0.70098080396522,1062,229,42,38,22,17,20,21
0.719745146215734,0.734117979479371,0.675166410650282,1070,221,33,31,13,9,20,22
0.669449150226788,0.678652546430156,0.63626348329387,1071,220,29,24,10,8,19,16
0.733041401273885,0.754610620239855,0.59965746624305,1068,223,35,32,14,10,21,22
0.750753370340999,0.78108251010493,0.686320380650278,1063,228,30,30,16,13,14,17
0.75259382446386,0.785257881744044,0.666783216783217,1069,222,32,26,13,7,19,19
0.760364945382324,0.791638145659427,0.728973249409913,1074,217,19,20,8,7,11,13
0.699689167051707,0.73064898122066,0.663521015067407,1059,232,38,30,15,11,23,19
0.730078611016853,0.769838628973999,0.653432869584889,1089,202,28,28,13,9,15,19
0.697702487176172,0.723267773265294,0.632672482157018,1084,207,37,30,15,8,22,22
0.753469977154188,0.781638855013969,0.757433975377284,1064,227,37,32,22,17,15,15
0.767186973069326,0.804845566717049,0.763149773693595,1085,206,33,23,15,10,18,13
0.769568690095847,0.816001413313943,0.691949291390186,1064,227,39,39,22,18,17,21
0.69049756097561,0.716118227554931,0.62758346581876,1067,224,41,33,14,9,27,24
0.775594819503047,0.820041748797821,0.753759873617693,1071,220,27,25,17,13,10,12
0.73033526756931,0.784982601551378,0.711442189000137,1090,201,22,23,12,10,10,13
0.75208143767061,0.773039902272068,0.758191024622716,1079,212,35,32,19,17,16,15
0.854719453413824,0.880342419999097,0.742572081575246,1067,224,34,27,26,16,8,11
0.767709281164695,0.785765948535757,0.779761904761905,1079,212,35,28,16,13,19,15
0.793439404594468,0.815679694739905,0.724830051570558,1082,209,27,27,14,12,13,15
0.800741918388977,0.816455934296795,0.738197644649258,1084,207,33,31,16,11,17,20
0.741200724054706,0.758313202264901,0.692179412407961,1062,229,48,44,25,19,23,25
0.731151219512195,0.761290761142514,0.686876716288481,1069,222,41,33,22,17,19,16
0.70321300563236,0.723168055348503,0.649178812954173,1099,192,31,38,8,8,23,30
0.700752187594293,0.728968703579217,0.705971337579618,1076,215,37,35,16,14,21,21
0.756284972022382,0.779024931879466,0.730626985702939,1045,246,40,32,19,16,21,16
0.717293356270992,0.739761406353601,0.696137807783955,1087,204,39,32,15,11,24,21
0.686205737808208,0.705657866849166,0.687367989999569,1094,197,38,37,14,15,24,22
0.770402103834408,0.785586643488832,0.68601072279587,1073,218,28,32,13,12,15,20
0.780787959274015,0.808934864245705,0.74791856232939,1075,216,36,35,17,13,19,22
0.791754756871036,0.809393985541557,0.806002703366921,1090,201,44,39,21,18,23,21
0.748425387596899,0.773150162323079,0.683700687912396,1059,232,43,34,22,13,21,21
0.700939248601119,0.724792587035124,0.695646238501281,1051,240,40,38,18,14,22,24
0.864055907172996,0.874225389290864,0.811642969984202,1078,213,27,25,20,16,7,9
0.704518116206168,0.737705441055837,0.622991606714628,1045,246,44,40,21,15,23,25
0.750137155397065,0.774433270727904,0.672166610111978,1064,227,23,28,8,8,15,20
0.667611913679329,0.696522476836891,0.651073239544016,1071,220,45,42,19,17,26,25
0.843412322274881,0.856217856204855,0.705987311657415,1062,229,25,30,16,14,9,16
0.784212920837125,0.806895093832161,0.769062748212867,1069,222,35,32,18,16,17,16
0.788126118067978,0.816796362139853,0.731003850699607,1067,224,43,42,26,22,17,20
0.682226446034586,0.698312643981062,0.692012288786482,1070,221,43,31,13,8,30,23
0.775857654889913,0.813231928464928,0.700599479696867,1051,240,31,28,17,13,14,15
0.778161802355351,0.801083559297385,0.696473092125266,1043,248,31,26,17,12,14,14
0.748246216020435,0.777284000987426,0.66381094012673,1038,253,42,37,24,17,18,20
0.736350253428742,0.7553568679383,0.724770731707317,1073,218,43,41,18,16,25,25
0.718484383000512,0.74727351990039,0.728345811246516,1082,209,31,29,12,12,19,17
0.776091586794462,0.791434138857743,0.755498619495531,1054,237,39,34,19,14,20,20
0.770075068243858,0.800880394473507,0.696394449499545,1080,211,35,35,16,12,19,23
0.814716651183125,0.84312443217798,0.776407524335701,1052,239,29,24,15,10,14,14
0.720667715673531,0.75591625260253,0.658346377459749,1053,238,47,43,26,18,21,25
0.748411270983213,0.779651004524727,0.783543603364321,1054,237,40,36,19,16,21,20
0.682632930761244,0.717301344002889,0.678321678321678,1084,207,29,26,13,11,16,15
0.753843410023185,0.780142557090091,0.699404030474318,1068,223,45,39,20,14,25,25
0.711226114649682,0.744227458397473,0.719656811847642,1043,248,35,29,17,12,18,17
0.768366877137595,0.827260665809979,0.661401641836424,1065,226,24,26,17,12,7,14
0.77649741562785,0.818928019176596,0.765121382526402,1062,229,26,23,14,12,12,11
0.771631803079227,0.80451136472839,0.628338463065925,1048,243,34,32,19,13,15,19
0.746530571198713,0.773716260283453,0.672401997673941,1076,215,48,47,26,21,22,26
0.735462735462736,0.761226993274111,0.684606020362992,1071,220,37,36,19,14,18,22
0.75859512195122,0.771427854604032,0.765294378043382,1083,208,41,36,19,16,22,20
0.686335318869884,0.718376643809875,0.630231308675489,1063,228,29,28,12,9,17,19
0.74359610802224,0.779579683615361,0.75817215247144,1089,202,32,28,13,10,19,18
0.763661948740368,0.787119489268243,0.686619273301738,1075,216,29,25,15,7,14,18
0.773572540345703,0.788049719064182,0.704026126769437,1072,219,39,38,19,16,20,22
0.706572605175722,0.730383049471404,0.673184594502884,1053,238,34,28,11,9,23,19
0.739459604066346,0.76942071356784,0.579986978619734,1040,251,45,38,23,16,22,22
0.755480079009491,0.772155066195577,0.727628340365682,1082,209,33,27,15,12,18,15
0.782328839545334,0.809703316022618,0.704445198506956,1056,235,30,28,17,13,13,15
0.772367172675522,0.795048192333774,0.752757901013715,1080,211,51,43,28,21,23,22
0.7581777341008,0.809152275059829,0.689505683320116,1045,246,34,30,21,15,13,15
0.76092115764271,0.786658611166325,0.747465692784418,1069,222,38,36,20,18,18,18
0.75480181595949,0.775195187380828,0.779926059152678,1051,240,46,40,24,21,22,19
0.800797884786373,0.815736685210792,0.764557684670374,1056,235,34,32,21,18,13,14
0.76945126945127,0.789908388886387,0.666722408026756,1060,231,37,26,19,10,18,16
0.704888245259304,0.742582148022467,0.684597156398104,1074,217,29,25,11,11,18,14
0.769199272065514,0.804035803834215,0.77437605069184,1065,226,35,37,20,22,15,15
0.702107317073171,0.737203615468068,0.684040509865549,1057,234,41,46,20,20,21,26
0.741863873442821,0.765655885359399,0.661894092573365,1055,236,37,29,18,10,19,19
0.734383960022938,0.763251782081893,0.689071844023921,1074,217,39,39,18,14,21,25
0.749137893874736,0.779919739443035,0.685708435708436,1055,236,37,33,20,11,17,22
0.825363338021566,0.850864656446645,0.73711966972062,1061,230,27,28,15,12,12,16
0.736092136182305,0.767100732737971,0.66392972293568,1077,214,29,29,14,11,15,18
0.741257040450589,0.774913429549018,0.652013193812557,1052,239,31,35,15,12,16,23
0.740231706650637,0.77053804276373,0.713315574848724,1062,229,29,24,13,10,16,14
0.772627625910252,0.792697203805934,0.694284572342126,1063,228,42,40,24,20,18,20
0.750592697961119,0.772738665549783,0.694918074756784,1081,210,37,31,20,15,17,16
0.704089133448146,0.734206381523581,0.65824644549763,1069,222,38,25,17,10,21,15
0.728405480540111,0.755130990692414,0.683294538557696,1090,201,32,37,11,11,21,26
0.754166666666667,0.772671404160669,0.76509792166267,1062,229,40,40,22,22,18,18
0.752631686737118,0.798780161334038,0.666436850519584,1066,225,39,40,21,16,18,24
0.692111143974498,0.710629895281999,0.668264110756123,1089,202,49,39,17,12,32,27
0.789685701637893,0.813186564527833,0.737823046518699,1046,245,36,26,23,15,13,11
0.807021466905188,0.829016980085772,0.755560584507953,1061,230,43,37,22,16,21,21
0.76700868354223,0.787324070235236,0.718856416224837,1063,228,39,37,20,16,19,21
0.777030015797788,0.806204048196601,0.730266767247291,1051,240,25,23,14,12,11,11
0.731862400375058,0.749982063375205,0.683460018242627,1083,208,27,26,9,7,18,19
0.75952380952381,0.801390172613352,0.686953931691819,1076,215,31,32,17,13,14,19
0.791765853658537,0.824187131735389,0.773610931505668,1044,247,41,37,24,20,17,17
0.74971226206286,0.768187389189995,0.701523297491039,1071,220,36,31,18,15,18,16
0.74706123235535,0.783589664044112,0.702454825258141,1065,226,33,32,17,13,16,19
0.749818016378526,0.775011368424417,0.616071900607983,1040,251,35,30,14,10,21,20
0.731847133757962,0.741313682731143,0.730861877920702,1072,219,35,33,14,13,21,20
0.781747058062848,0.800090617478936,0.785223367697594,1067,224,37,30,19,15,18,15
0.738869579609401,0.7782801340756,0.723859166011015,1049,242,19,20,10,10,9,10
0.76151989309884,0.783163123787468,0.692720655141037,1054,237,37,35,18,14,19,21
0.772685928303906,0.798213607748715,0.734980620155039,1087,204,45,43,23,22,22,21
0.715293821145041,0.740589648813662,0.689730372720063,1060,231,38,30,14,8,24,22
0.701405384006334,0.721726111941232,0.649335164041046,1054,237,28,33,9,12,19,21
0.735291099404803,0.752901004757933,0.6911096092406,1055,236,47,39,21,16,26,23
0.742499627310674,0.763615856540969,0.738364766665267,1050,241,43,38,20,21,23,17
0.722592094762045,0.756454517938139,0.678751974723539,1087,204,38,25,16,6,22,19
0.72594290399523,0.754015566969091,0.653474768639776,1091,200,43,46,17,17,26,29
0.729941116231439,0.757293448369798,0.65746624305004,1051,240,31,32,16,14,15,18
0.654933422942832,0.67717232787508,0.657528296266878,1073,218,38,32,12,8,26,24
0.721629463241144,0.760579036404483,0.673749007148531,1070,221,34,32,17,15,17,17
0.739634517291403,0.762062998821,0.66650868878357,1053,238,34,25,14,6,20,19
0.740904780378465,0.773519890560247,0.723647444235679,1047,244,37,33,17,14,20,19
0.734587813620072,0.759559032945385,0.763028276071754,1067,224,31,26,13,13,18,13
0.725001863446631,0.74641734289147,0.699317561419472,1073,218,43,35,20,15,23,20
0.695248780487805,0.723178070313131,0.681695440460381,1065,226,41,36,17,15,24,21
0.727212506624271,0.759042003265055,0.681271914941749,1086,205,33,28,18,13,15,15
0.745458274730426,0.760886643795953,0.673304955913651,1067,224,27,26,9,9,18,17
0.69163273901446,0.710761682961879,0.646239822710411,1081,210,34,33,10,8,24,25
0.749726965845909,0.785727887946975,0.73171869697998,1072,219,32,28,16,13,16,15
0.711369386464263,0.729253708721051,0.71426230851151,1078,213,51,39,22,16,29,23
0.753092682926829,0.772023093689416,0.746408777287637,1089,202,41,28,17,13,24,15
0.719750851329799,0.750813582124928,0.659265786338364,1071,220,37,32,17,10,20,22
0.808962693357598,0.840002450491746,0.754915514592934,1073,218,35,31,20,15,15,16
0.70507279344859,0.726971494139424,0.735095231409987,1076,215,35,34,11,14,24,20
0.769865186360032,0.818571276334081,0.681255700820918,1056,235,30,26,18,12,12,14
0.721033173461231,0.756653303789655,0.686232856290996,1061,230,40,43,20,20,20,23
0.764592811646952,0.785521443653787,0.746212465878071,1079,212,35,35,14,12,21,23
0.781833497121999,0.805245978875227,0.624446691076015,1050,241,34,29,18,9,16,20
0.767018923568444,0.786603438110304,0.750700502246894,1087,204,39,30,19,12,20,18
0.763866877971474,0.807611564651624,0.681823323153489,1037,254,29,28,12,9,17,19
0.720526037536347,0.755793150450398,0.70328082092788,1058,233,30,33,15,15,15,18
0.70952080116056,0.738474223309081,0.690092498916028,1075,216,34,33,15,14,19,19
0.755516378525933,0.783661729714874,0.722252582108312,1071,220,35,29,16,11,19,18
0.714219356248975,0.739909540387534,0.713905131427947,1052,239,29,29,11,11,18,18
0.777730289621883,0.795113796945006,0.724780175859313,1077,214,48,40,25,19,23,21
0.810695399878329,0.827581186825482,0.789941845096484,1062,229,34,30,20,16,14,14
0.748359914036874,0.77510367302047,0.650618258353065,1077,214,28,24,12,7,16,17
0.679579698651864,0.696579222662931,0.656455538016312,1083,208,30,24,11,9,19,15
0.755062328975373,0.785586440516616,0.711556493202063,1072,219,26,27,14,11,12,16
0.709371193346495,0.733981440459486,0.698849663916061,1087,204,38,29,16,10,22,19
0.742508292348164,0.769146866116653,0.670740118108539,1072,219,42,37,23,14,19,23
0.827321936283444,0.85166000180456,0.777411282984531,1067,224,44,35,28,18,16,17
0.798905666779776,0.813576867966038,0.744699163888737,1093,198,28,29,12,10,16,19
0.72139220894201,0.742001331917891,0.644448850118953,1082,209,36,30,15,9,21,21
0.780780487804878,0.803487640068076,0.738136343514829,1078,213,41,36,21,16,20,20
0.802146967684816,0.819737208988258,0.74962372731297,1093,198,36,36,21,16,15,20
0.77261065882192,0.78968548510186,0.745052549194991,1055,236,47,43,26,24,21,19
0.775882926829268,0.79631452107404,0.758413269384492,1063,228,41,40,22,20,19,20
0.679460112812248,0.705191913650572,0.698932890109361,1091,200,50,33,21,14,29,19
0.766334661354582,0.801587775806657,0.710281248537601,1059,232,36,34,20,16,16,18
0.753763440860215,0.767727540276052,0.705337941628264,1093,198,31,31,12,12,19,19
0.779053658536585,0.806094121332477,0.715371845949535,1062,229,41,36,21,15,20,21
0.721120432883241,0.758366581044999,0.714704130262113,1070,221,32,32,16,15,16,17
0.774322169059011,0.797798059763648,0.686544380460683,1054,237,37,32,20,15,17,17
0.750894435104961,0.769065220182383,0.713440029949927,1065,226,37,34,18,14,19,20
0.690941739824422,0.716478435612209,0.624488171064604,1081,210,38,35,18,15,20,20
0.739391513210568,0.766389201212011,0.696956617972554,1060,231,42,36,20,15,22,21
0.697861710631495,0.72485979256626,0.67430264489088,1043,248,40,33,18,14,22,19
0.72810450208706,0.752255879292903,0.712060702875399,1056,235,43,39,19,16,24,23
0.799629923341263,0.837342798741703,0.772959690230341,1074,217,30,32,21,19,9,13
0.777037803353593,0.805564936545587,0.743062380083298,1063,228,37,34,20,17,17,17
0.725048473495678,0.748237177724969,0.728856914468425,1052,239,49,40,22,16,27,24
0.791290393979637,0.820473081384619,0.776285742652899,1055,236,36,32,24,20,12,12
0.71397474029053,0.741175614776489,0.678548770816812,1053,238,37,30,18,11,19,19
0.720903918272339,0.75133002955378,0.661916795357761,1062,229,37,34,18,12,19,22
0.65088467614534,0.673566106405748,0.634698044272512,1060,231,25,22,7,5,18,17
0.766138281314,0.792054531518224,0.734152585765489,1050,241,39,31,21,16,18,15
0.681468531468532,0.713686061110538,0.644602672292546,1045,246,26,27,9,8,17,19
0.773589626933576,0.791826106320368,0.673037272006344,1088,203,35,30,16,11,19,19
0.7628819529778,0.79079849913782,0.763079924844631,1077,214,39,33,21,19,18,14
0.749817744404753,0.77233069993131,0.734679253867152,1065,226,44,35,23,15,21,20
0.763568034734169,0.778533659118458,0.732158734615565,1079,212,39,34,18,15,21,19
0.725094361203248,0.745258929872968,0.696644676979072,1038,253,42,35,22,17,20,18
0.721684251096016,0.740180634454061,0.720124985861328,1062,229,33,28,14,11,19,17
0.729540047581285,0.759207475638552,0.596666501191422,1057,234,30,32,11,10,19,22
0.739028991262907,0.765436688878809,0.719349722442506,1056,235,32,30,14,9,18,21
0.71484762274236,0.745885875185484,0.715775902484763,1075,216,37,27,14,11,23,16
0.751915475828519,0.778870309991678,0.702101105845182,1060,231,26,25,10,9,16,16
0.742402183803458,0.768807899303226,0.673147420790783,1069,222,35,18,17,8,18,10
0.747439836149513,0.770340861770984,0.665549711571089,1057,234,31,28,13,10,18,18
0.708883050089445,0.746986140647039,0.751076325518274,1071,220,43,34,22,17,21,17
0.740814519698982,0.767061771710747,0.641444102462272,1097,194,36,32,18,11,18,21
0.742003965688176,0.775496267047885,0.732919181992606,1061,230,37,34,19,18,18,16
0.707498168024484,0.730945744467691,0.666385886096682,1065,226,37,34,14,9,23,25
0.687486529591793,0.724591063145969,0.628460116772378,1060,231,37,38,14,10,23,28
0.728703335980937,0.748248237111637,0.690270598966251,1049,242,32,26,14,11,18,15
0.775734873613176,0.797478770935758,0.766290393979637,1080,211,42,36,22,18,20,18
0.748256820628012,0.779031495750308,0.689955735286081,1065,226,34,29,15,10,19,19
0.719995450409463,0.74326427017483,0.710388580491673,1072,219,35,30,17,14,18,16
0.739944294257393,0.760604023751844,0.702744577246569,1057,234,39,36,16,16,23,20
0.728748997594226,0.747992698037021,0.685198184285647,1074,217,44,34,19,12,25,22
0.670433518371663,0.697369854527441,0.637235387045814,1062,229,30,25,13,8,17,17
0.780817346495313,0.795025065157107,0.768420169946333,1055,236,52,43,26,23,26,20
0.698661071143086,0.726610909263769,0.649768752709929,1086,205,40,33,19,12,21,21
0.724374431301183,0.744397088201015,0.716414072143739,1067,224,35,23,16,10,19,13
0.731270730870411,0.760595757041569,0.673436384256731,1073,218,42,38,18,14,24,24
0.681108897742364,0.713295857473588,0.682064138204925,1079,212,36,32,9,10,27,22
0.684648152699271,0.717923286006031,0.691936917965277,1041,250,39,34,18,14,21,20
0.759699239713775,0.776898515163475,0.739898081534772,1056,235,43,40,18,17,25,23
0.738844832143801,0.770799598923435,0.693523867436911,1057,234,30,26,16,10,14,16
0.714165379755721,0.746990108388535,0.671976610743757,1066,225,34,29,13,10,21,19
0.683588668882787,0.705759413696902,0.622798259088582,1061,230,33,31,10,9,23,22
0.700013044126416,0.737610816185118,0.677727817745803,1063,228,43,40,20,16,23,24
0.69872813990461,0.733808537252084,0.660502170885558,1074,217,33,39,15,16,18,23
0.726016760431317,0.75745431106329,0.678883846356222,1070,221,27,24,13,8,14,16
0.748362147406733,0.778166823688097,0.716902731608614,1063,228,35,33,15,13,20,20
0.700088534749889,0.729956282059231,0.665006640106242,1063,228,36,36,15,14,21,22
0.747284391630823,0.76171493980683,0.742885691446842,1053,238,44,40,21,16,23,24
0.78648771610555,0.81729989661187,0.661000442673749,1065,226,35,36,21,14,14,22
0.786443932411674,0.796613337879853,0.663836296189237,1084,207,31,33,16,13,15,20
0.741895849880858,0.764776384701061,0.611036214644462,1078,213,32,30,12,8,20,22
0.801669316375199,0.820517179650031,0.710948987671078,1068,223,33,28,21,15,12,13
0.737353567625133,0.755196575704179,0.66208035950304,1061,230,39,30,18,11,21,19
0.802488009592326,0.821277754823698,0.76815556647825,1077,214,40,39,21,18,19,21
0.663108038914491,0.70549903802589,0.67984403912239,1082,209,31,30,11,12,20,18
0.747799895233106,0.7633634776821,0.674899647743098,1066,225,46,39,20,13,26,26
0.713676459867318,0.724789514509962,0.672814755412991,1053,238,44,44,14,12,30,32
0.732078335019511,0.765970307550934,0.620494936457506,1068,223,33,32,15,10,18,22
0.777042791898332,0.804950053142464,0.764440911499735,1067,224,32,33,19,16,13,17
0.746747538677918,0.774301294939431,0.749711158406811,1065,226,27,26,15,15,12,11
0.697749196141479,0.718131088038302,0.670011553369111,1078,213,47,43,20,16,27,27
0.816138605219516,0.838590186663041,0.682224428997021,1068,223,18,19,11,7,7,12
0.72292813038182,0.75294399320552,0.605047030745472,1055,236,38,34,19,13,19,21
0.739120846809762,0.761055151010423,0.70511070293884,1082,209,38,32,17,14,21,18
0.707207207207207,0.75504377902487,0.7004978866681,1056,235,33,22,17,10,16,12
0.730803690571505,0.750323139920973,0.725753265226949,1077,214,42,37,16,13,26,24
0.634656505914468,0.64643094433049,0.583023662495218,1084,207,35,29,8,5,27,24
0.803678929765886,0.834447762284958,0.793952180028129,1062,229,26,27,15,14,11,13
0.840961205484581,0.859478623050608,0.774399324861001,1068,223,34,32,26,20,8,12
0.755872993588844,0.784160120922196,0.721227935952784,1057,234,34,29,20,15,14,14
0.737241147561641,0.762846263064007,0.725297490003372,1064,227,38,33,19,15,19,18
0.749473536431279,0.77026482348084,0.708078837235607,1061,230,34,28,16,11,18,17
0.727758782515419,0.7495198304858,0.713298545224542,1069,222,48,51,20,20,28,31
0.746897339158062,0.770911442939772,0.682346029837696,1085,206,32,29,15,13,17,16
0.721684928443649,0.745599475432424,0.715849821112979,1054,237,43,37,19,17,24,20
0.785717073170732,0.810072603624261,0.782338488220841,1052,239,41,33,24,18,17,15
0.717774637503072,0.742011554502388,0.699444990579176,1058,233,39,39,19,18,20,21
0.779915082546661,0.798231722199122,0.761107525814138,1057,234,37,32,19,13,18,19
0.754539285881417,0.78604476758104,0.731596906278435,1087,204,34,35,16,15,18,20
0.717132867132867,0.749398752011728,0.670742496050553,1074,217,26,25,9,8,17,17
0.741389548693587,0.767718789636927,0.637485107227959,1077,214,28,32,14,12,14,20
0.730615880556498,0.763419272022643,0.671387965505613,1071,220,28,33,13,13,15,20
0.799537404176579,0.830304848395687,0.799598461712476,1072,219,30,28,21,18,9,10
0.730604444071072,0.751990342432005,0.733806963645673,1083,208,38,31,13,10,25,21
0.755695443645084,0.776765753034001,0.738933121019108,1072,219,40,35,20,15,20,20
0.684163346613546,0.701579915778924,0.686908553230209,1082,209,36,35,11,11,25,24
0.703694131955002,0.781253141907052,0.660643258812234,1064,227,26,23,15,11,11,12
0.759677141256089,0.787167271649025,0.727695632393085,1105,186,37,35,18,15,19,20
0.721768247726714,0.743230243226155,0.715167807787626,1064,227,39,38,17,15,22,23
0.776633240667196,0.822296291185213,0.691324510801946,1074,217,32,28,18,12,14,16
0.644906511927789,0.667851607593375,0.667432141674942,1052,239,22,19,6,4,16,15
0.676548558127505,0.699047361156912,0.610950684033751,1084,207,37,39,15,10,22,29
0.728766986410871,0.757663741422053,0.744790718835305,1051,240,40,35,16,16,24,19
0.785466418929996,0.805264719423746,0.686028826805185,1090,201,29,34,14,11,15,23
0.777316086139616,0.804739371570229,0.662415088885677,1073,218,33,33,17,14,16,19
0.713492063492064,0.735794956774978,0.639003436426117,1074,217,31,30,13,10,18,20
0.77031622319301,0.801579264068805,0.656103964927494,1075,216,32,33,20,15,12,18
0.704225647918679,0.737232485421431,0.682632930761244,1073,218,38,29,18,13,20,16
0.753717073170732,0.782048688124072,0.741073517712574,1049,242,41,34,21,17,20,17
0.70406813122191,0.730434119120689,0.656580025001078,1068,223,38,37,13,10,25,27
0.67419579030977,0.700817132690976,0.695789372259961,1047,244,32,33,13,12,19,21
0.685225763612218,0.704920294101405,0.691851265822785,1073,218,36,27,16,12,20,15
0.717487340667016,0.751041339514749,0.668806848582129,1064,227,46,45,25,23,21,22
0.778078151880069,0.807239444748785,0.709912767644726,1068,223,39,30,19,11,20,19
0.68168878512329,0.710825501706588,0.633822324998795,1055,236,39,33,16,12,23,21
0.71313634351483,0.745031948846578,0.665602040338808,1065,226,36,34,18,14,18,20
0.745495811689831,0.793088115312143,0.720071684587814,1061,230,34,31,18,16,16,15
0.777532880474057,0.806329247686547,0.601097012952683,1074,217,33,30,19,11,14,19
0.729437804338203,0.760253301462206,0.747668334849863,1077,214,36,35,19,19,17,16
0.73886882009493,0.771142510415654,0.656394777481398,1059,232,38,34,22,18,16,16
0.729818872987478,0.751952698868042,0.699793151470468,1071,220,43,39,18,14,25,25
0.792479513613534,0.803388398382359,0.783928099392017,1058,233,30,30,19,17,11,13
0.721027524613649,0.747230571494472,0.697716950650776,1050,241,53,53,27,25,26,28
0.762996249838355,0.790807412408661,0.75744798583444,1070,221,37,36,17,15,20,21
0.696949718706048,0.737264293014297,0.715631492227237,1069,222,27,22,14,12,13,10
0.730875299760192,0.755659252229115,0.733781628518471,1068,223,40,37,20,18,20,19
0.715731950304735,0.772867812721678,0.714825560570241,1088,203,27,22,14,9,13,13
0.760938743038982,0.799859292994953,0.745917040034687,1064,227,34,33,18,12,16,21
0.723782984531392,0.759857656441168,0.677236397934869,1086,205,35,32,17,13,18,19
0.656238435104414,0.672717686210228,0.609514181102792,1066,225,30,29,10,9,20,20
0.720865250277015,0.743204916244163,0.74075330844927,1071,220,33,28,11,12,22,16
0.695133939542885,0.745075408868803,0.696776990894638,1090,201,39,33,20,17,19,16
0.775466922077034,0.799578900941901,0.717016875563201,1070,221,47,39,29,22,18,17
0.714600229376587,0.744122145324599,0.69266226777107,1053,238,39,34,21,17,18,17
0.757923707117255,0.790887740726984,0.663780473511486,1078,213,31,27,16,10,15,17
0.751461828515219,0.789687697411876,0.667436779138907,1071,220,29,22,15,10,14,12
0.787145997672314,0.796930286475601,0.754006656426011,1074,217,37,31,16,13,21,18
0.691489617960206,0.721112046518773,0.672202001819836,1070,221,33,35,15,15,18,20
0.702087804878049,0.729114833007848,0.681869881710646,1077,214,41,35,17,12,24,23
0.700486431131592,0.737338164902456,0.633764141015522,1072,219,31,24,16,9,15,15
0.768636810332725,0.794197083235095,0.69501582278481,1056,235,34,27,16,12,18,15
0.728318798449612,0.753424572738373,0.6541563405721,1046,245,43,38,24,15,19,23
0.756115353572981,0.773494774768146,0.722448941562314,1046,245,52,43,29,22,23,21
0.727777777777778,0.754054056621432,0.724240607513989,1047,244,40,40,20,21,20,19
0.699237619187634,0.72933483076861,0.677843902439024,1059,232,38,41,18,19,20,22
0.751947910846216,0.769310775447584,0.761351938693812,1071,220,52,42,24,19,28,23
0.686047107014849,0.714213616081025,0.651117695235342,1073,218,31,33,12,10,19,23
0.742585249801745,0.775824533125107,0.702648851383029,1074,217,30,27,12,10,18,17
0.741569455618128,0.768651349951229,0.647725204731574,1056,235,48,35,26,16,22,19
0.745652539169152,0.770536261580389,0.701838529176659,1050,241,38,40,19,16,19,24
0.65919930625813,0.690155391695942,0.639181088112204,1050,241,33,28,13,10,20,18
0.768458781362007,0.805488852094246,0.698506956226671,1062,229,31,28,17,12,14,16
0.766749549155691,0.793934406843946,0.662126345701951,1087,204,29,29,12,7,17,22
0.70180265654649,0.723536682403945,0.661132230172928,1047,244,51,43,26,22,25,21
0.614888535031847,0.629266335602191,0.634034611469291,1051,240,35,28,11,6,24,22
0.756818578662476,0.778986744671621,0.745173673225999,1043,248,46,43,25,22,21,21
0.766985016584696,0.787924602550806,0.733067729083665,1047,244,42,36,23,18,19,18
0.702335447557441,0.719542328337553,0.62731694828469,1059,232,38,31,14,11,24,20
0.718102318341935,0.746525043398155,0.698631786867081,1066,225,39,33,17,10,22,23
0.734204878048781,0.766538854148851,0.775916716760479,1067,224,41,29,19,14,22,15
0.778139043087497,0.806468475765922,0.73303317535545,1081,210,30,25,15,9,15,16
0.717374944665781,0.751526341637007,0.656246799795187,1074,217,36,31,16,14,20,17
0.741217293848873,0.777241140009507,0.737045040946315,1045,246,37,35,20,18,17,17
0.792571541680805,0.816895127053041,0.696185583911689,1064,227,28,29,14,11,14,18
0.796111901375059,0.80968985110044,0.694858577848269,1084,207,37,30,17,7,20,23
0.722961630695444,0.743290062343959,0.710653587627739,1090,201,40,29,13,10,27,19
0.649659948371723,0.675572164077198,0.609645131938126,1085,206,32,35,10,10,22,25
0.715194572452637,0.738906096567703,0.703187403993856,1081,210,31,31,14,12,17,19
0.716068713894801,0.748231518974371,0.70557920340529,1064,227,26,26,10,9,16,17
0.767706949977866,0.793781603129981,0.739794524290945,1053,238,36,29,18,13,18,16
0.748749946118367,0.763461782677335,0.729185623293903,1060,231,37,35,16,13,21,22
0.71372368943606,0.728467828970691,0.706362007168459,1063,228,32,31,12,10,20,21
0.713917525773196,0.747331861953227,0.711483239568683,1067,224,30,27,13,11,17,16
0.706291853350677,0.723828166940201,0.693094289508632,1087,204,33,36,13,13,20,23
0.763204417875629,0.798856788814576,0.708371050476314,1066,225,44,37,25,18,19,19
0.752538724320277,0.780454281902598,0.714406274821287,1074,217,34,32,19,18,15,14
0.73302447470635,0.762778223455175,0.67271180745159,1056,235,34,38,16,14,18,24
0.744732182381585,0.784135531789172,0.675178147268409,1057,234,36,28,22,15,14,13
0.766025641025641,0.786247185317456,0.735035913806864,1059,232,43,38,22,17,21,21
0.783077316948285,0.809507887024099,0.71387289999532,1043,248,31,34,16,13,15,21
0.77259478730067,0.8129990864938,0.706107825295723,1094,197,33,35,17,14,16,21
0.793277979981802,0.817685003413084,0.739586100044267,1054,237,35,36,19,17,16,19
0.799869041382923,0.814895548978729,0.775141957994116,1027,264,46,47,28,28,18,19
0.687604796967267,0.703220712056489,0.623131494804157,1094,197,44,40,11,7,33,33
0.734089101034209,0.776146298657877,0.774539967182372,1068,223,34,27,19,11,15,16
0.762985033681836,0.801485898952216,0.757115418194517,1080,211,53,46,32,28,21,18
0.676521321117521,0.724811491118168,0.623331636692682,1079,212,28,28,13,10,15,18
0.726560579995085,0.740965652222751,0.671499959039895,1080,211,39,39,16,11,23,28
0.699431301182894,0.726190657787985,0.663820492454329,1065,226,35,32,14,9,21,23
0.778534325424681,0.794473189639704,0.710328045299265,1077,214,34,34,18,16,16,18
0.743581230633023,0.766038340179732,0.753423566878981,1076,215,36,35,16,14,20,21
0.776851346242702,0.79732720404492,0.758886020651311,1066,225,38,32,20,14,18,18
0.776976586359009,0.800831535606801,0.766623914759274,1082,209,28,24,12,10,16,14
0.735184215121355,0.776481084522572,0.723089961361814,1045,246,46,44,22,21,24,23
0.749512553875624,0.772516484296996,0.699433185098782,1058,233,47,44,25,21,22,23
0.740447641886491,0.769583810130654,0.647394105760799,1064,227,40,42,19,16,21,26
0.737075374585383,0.762789091043512,0.636041920443567,1083,208,42,38,20,16,22,22
0.714082503556188,0.73774815504337,0.721045912222383,1087,204,37,33,14,12,23,21
0.721399606782993,0.745353446014495,0.674880763116057,1049,242,39,33,19,13,20,20
0.81182005292561,0.834816681647757,0.793623411437649,1082,209,38,32,24,19,14,13
0.670127795527156,0.690106224855994,0.641442155309033,1055,236,39,29,14,11,25,18
0.764931244441404,0.785577388614309,0.642212327571154,1021,270,47,46,29,20,18,26
0.751638001638002,0.776255756962957,0.76234076433121,1092,199,37,35,17,15,20,20
0.70519807782466,0.754730742535104,0.66861541626663,1070,221,27,23,13,7,14,16
0.68172119487909,0.71745424089222,0.63135805277525,1067,224,37,35,15,15,22,20
0.791884280593958,0.814614661552272,0.74866678387248,1094,197,31,27,15,12,16,15
0.727519747235387,0.745506161374327,0.667501028665478,1068,223,25,23,7,7,18,16
0.712710547318016,0.747580719818623,0.663523657870792,1063,228,38,35,20,15,18,20
0.747870747344284,0.77177751158404,0.719345710881652,1074,217,34,32,17,16,17,16
0.731834532374101,0.74759955355613,0.659759041337989,1064,227,40,37,14,11,26,26
0.805993792835898,0.824596792597778,0.783227848101266,1093,198,37,27,21,14,16,13
0.762243624041377,0.782031806042329,0.706829923971941,1027,264,45,38,25,20,20,18
0.710161870503597,0.732122213714921,0.642322944954524,1043,248,40,37,18,12,22,25
0.763434716361931,0.797037352457677,0.721419884463363,1080,211,27,26,12,10,15,16
0.724993855984271,0.74122789022609,0.694946283181577,1069,222,39,33,18,14,21,19
0.702707006369427,0.717453491967146,0.639907038512616,1063,228,35,36,13,14,22,22
0.814789849325932,0.842749193341187,0.709450606018063,1045,246,30,34,20,17,10,17
0.77372374089748,0.790082410457446,0.743528207461329,1083,208,42,35,23,19,19,16
0.792925842942237,0.827462393259405,0.733459329582747,1074,217,29,27,19,15,10,12
0.74380487804878,0.772717267191324,0.699127549766528,1048,243,41,39,23,18,18,21
0.768217006635537,0.792416097151136,0.784831623066917,1077,214,39,33,21,20,18,13
0.765068557255838,0.799097175303056,0.740483743061063,1046,245,34,30,18,18,16,12
0.737850212122485,0.762479464893734,0.687283894449499,1084,207,38,35,17,13,21,22
0.745835088211896,0.786094473446555,0.71221198156682,1049,242,34,31,18,15,16,16
0.680622009569378,0.726854133686348,0.679526842584167,1071,220,37,35,13,11,24,24
0.685134212920837,0.707243064372936,0.718235969178644,1066,225,35,29,13,12,22,17
0.779228160405486,0.790383036407139,0.719935313143193,1074,217,43,38,22,16,21,22
0.761591455857695,0.778794917893505,0.736923486524126,1071,220,44,39,19,14,25,25
0.729365853658537,0.758386028067086,0.642262155458842,1040,251,41,34,19,12,22,22
0.740329051768017,0.755510760506805,0.725869702719797,1060,231,54,51,23,22,31,29
0.7564448441247,0.780141978514694,0.715138502779984,1055,236,40,32,20,12,20,20
0.651720082328727,0.684361911842917,0.62353509472004,1068,223,38,38,15,12,23,26
0.720303756994405,0.74951927331493,0.739001364877161,1069,222,40,35,18,15,22,20
0.760002978554408,0.808984249844091,0.695250896057348,1047,244,32,31,18,14,14,17
0.715186360031721,0.740479522293972,0.614832395686826,1080,211,30,27,12,7,18,20
0.777312970340859,0.792581331360274,0.718778434940855,1059,232,36,35,20,15,16,20
0.729945256261046,0.751866814478199,0.713153422409752,1080,211,37,27,15,9,22,18
0.748687360860251,0.778226368051576,0.692465192465192,1064,227,38,37,18,16,20,21
0.705323151837096,0.737058817513113,0.662151394422311,1058,233,36,36,18,13,18,23
0.781460674157303,0.81286915484031,0.713949678665939,1061,230,45,38,24,16,21,22
0.748760513501549,0.769626462164844,0.695580251102816,1056,235,36,28,19,11,17,17
0.72576201350278,0.763619384119673,0.619535278949836,1058,233,32,27,15,10,17,17
0.798963133640553,0.827170448485239,0.68115719406042,1066,225,31,31,18,14,13,17
0.738660337552743,0.757359938519662,0.667302906910983,1089,202,27,28,10,7,17,21
0.745258416311048,0.768171480287968,0.695161290322581,1076,215,37,31,18,13,19,18
0.755405025972203,0.801924869238771,0.731339791286443,1078,213,34,34,21,19,13,15
0.751448778070075,0.781591471436444,0.723291366906475,1064,227,42,40,23,20,19,20
0.657645203571721,0.676937676698968,0.630223688520754,1043,248,39,34,16,11,23,23
0.735313405104104,0.76082215374668,0.754587608524073,1068,223,29,24,15,13,14,11
0.737337816285185,0.762863802971132,0.699270583533173,1049,242,37,40,22,20,15,20
0.714621319884478,0.744223417976675,0.640627843494085,1056,235,37,35,16,13,21,22
0.626378950506858,0.643485411918795,0.577191235059761,1064,227,43,36,11,9,32,27
0.757744495647721,0.784699975740702,0.6993149324861,1060,231,31,32,18,17,13,15
0.761140819964349,0.777048938668351,0.742859970591562,1091,200,33,28,15,13,18,15
0.728687102371313,0.755826314737355,0.699028886917086,1056,235,56,49,29,21,27,28
0.700582619682718,0.721719223636116,0.669205390986944,1033,258,34,34,14,10,20,24
0.80063636745495,0.823689666737807,0.739599880857824,1056,235,38,32,22,16,16,16
0.692465192465192,0.718458212935389,0.665818346340912,1057,234,33,28,15,11,18,17
0.733742959549411,0.760003306390674,0.633307731694828,1080,211,31,31,15,14,16,17
0.719757380386834,0.756161955623202,0.667930489731438,1066,225,28,25,12,8,16,17
0.753912238963785,0.789344056543167,0.68879446964315,1072,219,30,29,13,10,17,19
0.787601772895891,0.808653310133593,0.76884906296671,1086,205,33,33,18,17,15,16
0.663390663390663,0.683457797860601,0.676381178958498,1078,213,33,30,10,7,23,23
0.768380476780637,0.799141037173382,0.709254935692635,1057,234,44,39,22,17,22,22
0.816941272823626,0.842936120733449,0.782011837787154,1054,237,33,27,20,15,13,12
0.796601063228142,0.811107786651645,0.774502318742224,1077,214,28,28,12,11,16,17
0.738570120923062,0.75596823762748,0.730750314224821,1072,219,33,29,13,11,20,18
0.732096812001875,0.77179292153919,0.691904196357878,1065,226,27,28,14,12,13,16
0.782061522077496,0.809153133333772,0.739364763169544,1060,231,39,36,20,16,19,20
0.756336707911511,0.791751035963016,0.660540392264436,1045,246,21,23,11,9,10,14
0.692793138760881,0.724953391485199,0.654067041725269,1070,221,31,27,12,7,19,20
0.80651728844404,0.825532748336131,0.773284690220174,1077,214,35,31,21,17,14,14
0.69869104716227,0.732135554175607,0.620146341463415,1064,227,40,41,20,17,20,24
0.753822478157268,0.781455768207079,0.724173451151708,1082,209,32,32,14,14,18,18
0.739529224577659,0.767861794227343,0.707834101382488,1056,235,34,31,17,14,17,17
0.736869215994413,0.761738458735465,0.690867172122184,1051,240,46,44,22,19,24,25
0.764160600545951,0.788970164813988,0.697616276563645,1071,220,35,37,18,15,17,22
0.742641209228321,0.756727457161734,0.729315831344471,1070,221,34,34,14,11,20,23
0.740838140481846,0.774403201525666,0.715845128149079,1069,222,28,29,13,12,15,17
0.712655828533936,0.7350779273593,0.715535346746755,1075,216,44,38,15,14,29,24
0.758247929243296,0.784760202549989,0.655670103092784,1056,235,34,30,17,10,17,20
0.69056304520222,0.723916464959531,0.659136193155181,1075,216,30,27,10,5,20,22
0.673110909953015,0.707481546984944,0.673140770252324,1096,195,37,36,13,12,24,24
0.738247120730739,0.764469524376437,0.636589631051982,1074,217,32,23,14,7,18,16
0.793626281061351,0.819957933089285,0.710784947627053,1049,242,34,37,20,15,14,22
0.730206868260666,0.781614926590426,0.680116033755274,1050,241,27,27,11,9,16,18
0.73573883161512,0.765675642556686,0.677892772310825,1070,221,30,28,15,11,15,17
0.696803912647862,0.718779153909799,0.69584403519318,1051,240,35,29,14,13,21,16
0.71166067146283,0.73677051829956,0.727003098716246,1063,228,40,36,17,17,23,19
0.773463901689708,0.811515000640551,0.770206022187005,1073,218,31,29,15,13,16,16
0.735202252944189,0.771518063023163,0.720801101734646,1067,224,31,27,13,11,18,16
0.727609381429159,0.760145876114056,0.635772619815173,1080,211,23,22,8,7,15,15
0.751520894754083,0.781152414009518,0.633377184273233,1063,228,34,32,15,12,19,20
0.678699436763953,0.709057821144627,0.661467348544453,1068,223,31,20,10,6,21,14
0.795570916538658,0.821575376238097,0.73205325140809,1058,233,31,31,18,12,13,19
0.718574995541288,0.737253596051668,0.741685623293904,1067,224,45,35,18,15,27,20
0.774168902802624,0.791865594054852,0.755896391969676,1072,219,43,34,22,16,21,18
0.722935044105854,0.755703157088678,0.709771972929868,1072,219,44,37,24,18,20,19
0.75811199645861,0.774163543801582,0.717577941865917,1102,189,36,27,14,9,22,18
0.75714857600366,0.782974505235214,0.685148295706065,1084,207,42,36,17,11,25,25
0.760441310282075,0.78155205632233,0.750359908657665,1081,210,35,32,17,15,18,17
0.75031105078611,0.784604851066381,0.715560821484992,1066,225,28,25,18,15,10,10
0.702077876724288,0.719462545531893,0.615659259881548,1072,219,46,38,15,10,31,28
0.650610305562382,0.691611546946246,0.643098668458857,1098,193,39,38,14,14,25,24
0.798221111437812,0.827163387698663,0.681197061163367,1068,223,38,34,22,13,16,21
0.791826538768985,0.817275129462249,0.758190008190008,1058,233,40,33,25,19,15,14
0.832809104426398,0.847211634237171,0.750905486293797,1059,232,42,42,27,19,15,23
0.733432715551974,0.761408866324541,0.679317073170732,1071,220,50,41,27,18,23,23
0.776818545163869,0.802247784403954,0.694175627240143,1076,215,40,31,21,12,19,19
0.730556097560976,0.756036171735235,0.684947078115683,1060,231,41,43,20,18,21,25
0.692709281164695,0.71403352076834,0.649878264718902,1067,224,35,36,12,11,23,25
0.669272080454266,0.6936955629143,0.696301302531334,1057,234,47,39,18,15,29,24
0.751605672658304,0.782824999641887,0.652292682926829,1062,229,37,41,18,17,19,24
0.721724294813467,0.74712288685032,0.731169036334913,1078,213,35,25,13,8,22,17
0.682791173794358,0.693055757690955,0.636523853762501,1069,222,35,29,11,8,24,21
0.759743700920171,0.789402600668381,0.703918246898738,1071,220,33,29,17,12,16,17
0.728685258964143,0.763577587335882,0.708192524321556,1077,214,36,31,17,13,19,18
0.76540444187503,0.786936922875421,0.708736452550885,1067,224,33,30,16,14,17,16
0.709251881363435,0.747411241453156,0.655351437699681,1064,227,36,39,19,17,17,22
0.770372159448902,0.787073456605446,0.717914012738854,1105,186,38,35,17,14,21,21
0.720720720720721,0.749226303147982,0.689362519201229,1054,237,37,31,19,14,18,17
0.752444560852104,0.775089231853988,0.66060487804878,1052,239,46,41,23,15,23,26
0.782374100719424,0.805317562865249,0.659937473788555,1064,227,40,42,22,18,18,24
0.777448041566747,0.793303446464524,0.756255686988171,1089,202,40,35,20,15,20,20
0.671714172604909,0.700775363734219,0.708544781237142,1083,208,28,23,11,10,17,13
0.716355471079308,0.731688877491689,0.636277113767154,1051,240,43,36,17,11,26,25
0.76737143842407,0.789868629523849,0.689783240814169,1050,241,37,30,21,13,16,17
0.819027887398053,0.84739350957426,0.690525519600105,1086,205,24,24,10,8,14,16
0.729329471555823,0.755548892855201,0.748372138910813,1049,242,29,24,14,13,15,11
0.712265397832408,0.741780054481436,0.656401990725031,1078,213,30,28,12,8,18,20
0.780400619743249,0.816483446218887,0.716271234030605,1072,219,36,34,20,16,16,18
0.742418167237734,0.775685076926203,0.681548773654037,1071,220,44,37,23,18,21,19
0.729136690647482,0.762369705677467,0.688133109185741,1067,224,40,37,22,20,18,17
0.818709126162542,0.833023859388184,0.796746347941567,1063,228,49,36,28,20,21,16
0.740387016229713,0.756477254600802,0.692995603517186,1087,204,45,40,21,18,24,22
0.751707317073171,0.767348475604835,0.705994085532302,1079,212,41,35,17,13,24,22
0.72671862509992,0.742948838616288,0.693996719828074,1063,228,40,28,18,8,22,20
0.796616441977267,0.830794418675983,0.79192439862543,1064,227,30,30,17,16,13,14
0.756019512195122,0.789730101715634,0.695075254537406,1082,209,41,36,23,17,18,19
0.744127006411156,0.774395880126416,0.733640552995392,1090,201,34,31,13,12,21,19
0.701705380770361,0.741179166570403,0.663907927065822,1090,201,38,37,14,13,24,24
0.695823341326938,0.724292688098297,0.655540736581029,1073,218,40,34,18,13,22,21
0.77511914217633,0.802388603990592,0.744876862268167,1055,236,32,26,16,13,16,13
0.735191082802548,0.771134249664095,0.700429268292683,1066,225,35,41,17,15,18,26
0.703715677399888,0.732440399604317,0.658820154106782,1064,227,37,29,13,9,24,20
0.781665150136488,0.805144743817816,0.788395453343907,1052,239,35,30,19,17,16,13
0.721403275785746,0.747377388673242,0.694422416071901,1086,205,36,30,14,11,22,19
0.704093962480544,0.73267078576805,0.717065073041169,1055,236,39,36,18,15,21,21
0.803207918012073,0.824545424213926,0.742777005559968,1079,212,34,32,19,13,15,19
0.776971326164875,0.803050731180254,0.707893873982185,1067,224,31,29,15,11,16,18
0.732054356514788,0.745594249453052,0.617740652346858,1081,210,40,34,13,8,27,26
0.778187403993856,0.815662529044052,0.712480696335814,1062,229,31,34,17,16,14,18
0.75800051203277,0.774621741012016,0.731559744603223,1064,227,31,26,15,10,16,16
0.70867306155076,0.72965128644533,0.643279985025036,1085,206,40,34,17,13,23,21
0.711896862455968,0.733094583876177,0.704341243050039,1056,235,39,32,17,12,22,20
0.694293631942088,0.729014035906152,0.664693501710076,1072,219,28,24,12,8,16,16
0.771269335759781,0.810565645278746,0.674146147736299,1093,198,35,32,18,12,17,20
0.754326676907322,0.774267117941245,0.685556587791683,1076,215,31,29,13,9,18,20
0.643318109610802,0.665004672475979,0.654636616362192,1063,228,32,32,13,11,19,21
0.694096664883182,0.716523194549835,0.703931203931204,1074,217,45,33,17,15,28,18
0.728706128863279,0.759648588235951,0.678304548400625,1059,232,46,42,23,17,23,25
0.676618705035971,0.696614027013091,0.697375832053251,1104,187,40,31,12,11,28,20
0.756731213508632,0.794840117362238,0.690593182824259,1073,218,38,36,21,17,17,19
0.742741935483871,0.77308198902636,0.789946509395145,1064,227,31,23,15,13,16,10
0.756961506961507,0.777883204362765,0.720307658255865,1064,227,37,36,16,14,21,22
0.682040870791872,0.706219450050881,0.688517665130568,1050,241,42,31,19,14,23,17
0.756385568835768,0.778199605900964,0.716212738078525,1076,215,36,34,18,14,18,20
0.745011971268954,0.77251183284651,0.679968460719259,1077,214,38,39,18,14,20,25
0.721733695417906,0.754659998975712,0.680967486122125,1073,218,37,30,15,9,22,21
0.839729969012837,0.855816096022364,0.79830595722776,1079,212,36,34,22,18,14,16
0.816020498172806,0.840332461054031,0.758909370199693,1070,221,38,31,24,17,14,14
0.735859883053719,0.768256626112855,0.668906810035842,1060,231,29,31,15,13,14,18
0.744116439761921,0.760867619714746,0.685227867993714,1053,238,47,46,21,17,26,29
0.712589118914179,0.736533107848214,0.615198270721527,1055,236,42,43,18,15,24,28
0.718049510973841,0.755363894902073,0.671628848099436,1058,233,34,33,18,14,16,19
0.716047598400539,0.738234106505529,0.626566217287867,1079,212,33,30,13,8,20,22
0.718209736123749,0.755201531780926,0.666892885420201,1057,234,35,28,15,8,20,20
0.696502797761791,0.724750262043025,0.667186808322267,1059,232,40,36,14,10,26,26
0.745519429024584,0.779955881269215,0.731544542414108,1037,254,30,26,13,9,17,17
0.742513252090278,0.762788381081536,0.723129791171028,1059,232,29,30,11,10,18,20
0.712738078524966,0.744009637671202,0.699983605661511,1075,216,34,29,15,14,19,15
0.777822151224707,0.786672316284467,0.785389530597198,1052,239,39,39,20,19,19,20
0.722482014388489,0.736827205540352,0.671038685744568,1061,230,40,33,15,10,25,23
0.774995541287676,0.796254393254595,0.759242605915268,1070,221,45,40,22,18,23,22
0.709874448591788,0.738304414615211,0.689791502753737,1075,216,28,20,11,10,17,10
0.631127399504347,0.649945643143018,0.598493259318002,1068,223,38,30,15,11,23,19
0.762726870296591,0.80407342648358,0.64521035144368,1057,234,36,34,20,14,16,20
0.78880895283773,0.817245561190189,0.732910388580492,1048,243,40,30,24,14,16,16
0.73167194092827,0.764390843320769,0.66332994005203,1064,227,27,28,13,9,14,19
0.726540513294409,0.753796721081375,0.692091938046068,1078,213,38,32,16,9,22,23
0.701342129208371,0.724878794662578,0.686941124391324,1074,217,35,36,16,14,19,22
0.764365971107544,0.780754683182147,0.748277817448649,1085,206,45,38,20,14,25,24
0.708056852625543,0.728392092974244,0.67369104716227,1072,219,39,40,16,13,23,27
0.763621910680734,0.798436817330832,0.755860976009618,1051,240,33,29,17,15,16,14
0.71652875993293,0.739630573487382,0.715373783922171,1051,240,44,31,20,17,24,14
0.730172865374542,0.74880183021919,0.715195632393085,1044,247,46,35,19,14,27,21
0.735259326660601,0.754973663698287,0.686098310291859,1082,209,35,31,15,10,20,21
0.756524750309835,0.77664275611162,0.776737967914438,1069,222,44,33,21,17,23,16
0.731346678798908,0.755152244269619,0.646946867565424,1045,246,35,30,16,9,19,21
0.798665309354145,0.829435943600013,0.755655214350867,1044,247,28,26,19,16,9,10
0.718683490422621,0.759029895878939,0.693745970341715,1095,196,26,22,11,8,15,14
0.746180280200899,0.771597548071902,0.716180296346567,1068,223,30,28,15,12,15,16
0.741935483870968,0.785512754785069,0.710483870967742,1052,239,31,31,17,15,14,16
0.740419845683004,0.784263217382654,0.673057028320186,1066,225,37,37,19,15,18,22
0.718419512195122,0.74488144654193,0.683357909396248,1070,221,41,39,22,19,19,20
0.782507106036518,0.808011473344383,0.641530976965846,1086,205,33,32,17,12,16,20
0.713190031771247,0.74070225162581,0.627688693478167,1056,235,32,37,16,14,16,23
0.682784467928238,0.713258766770181,0.67320618613039,1076,215,39,29,18,11,21,18
0.740798284915932,0.770679527914076,0.705749405233941,1090,201,33,30,15,10,18,20
0.725088534749889,0.763721135578255,0.686008370093881,1044,247,36,28,23,16,13,12
0.769323288395453,0.805523178799089,0.685727262072199,1083,208,30,27,18,12,12,15
0.744256141947225,0.765763198127321,0.716107445364781,1054,237,35,34,17,16,18,18
0.776364877161056,0.804581547169293,0.667846991376403,1081,210,35,33,20,14,15,19
0.753401825236352,0.789838624191804,0.661552543854856,1075,216,29,29,13,8,16,21
0.745189003436426,0.764347884640002,0.693365054189796,1066,225,30,30,15,13,15,17
0.743532302355832,0.767735883476336,0.648219786517659,1077,214,33,22,17,8,16,14
0.714845990005734,0.738202720803664,0.729276615104641,1073,218,39,35,17,17,22,18
0.737883605530664,0.766895348527101,0.715108156284627,1084,207,33,33,15,13,18,20
0.736650679456435,0.769015144919406,0.673990304002333,1061,230,40,44,21,16,19,28
0.818531097942863,0.840296875461519,0.782037384978561,1029,262,33,33,22,19,11,14
0.822589969648793,0.844499634188447,0.770615880649216,1070,221,33,29,22,16,11,13
0.659463148316652,0.679213920452733,0.619836885030255,1068,223,35,24,12,8,23,16
0.750324068778833,0.765895810702257,0.739811173916605,1076,215,42,39,18,18,24,21
0.733888724571954,0.758280570671587,0.690841804886749,1044,247,49,45,24,19,25,26
0.70734005079053,0.741667759760483,0.672820922421561,1077,214,39,39,17,15,22,24
0.727694271811919,0.742576993102776,0.726409271704842,1066,225,33,23,14,10,19,13
0.782851571043231,0.7998971161813,0.722349086576648,1074,217,44,32,23,14,21,18
0.735183716627016,0.770239559408769,0.747290070819482,1079,212,30,33,12,13,18,20
0.754365916549461,0.784221015863053,0.729826224328594,1079,212,27,25,17,13,10,12
0.776286147292537,0.812772256820899,0.759628433712387,1086,205,39,34,23,20,16,14
0.762028869286287,0.811107654467814,0.70678319060321,1063,228,44,34,25,16,19,18
0.72496373250971,0.756864754562916,0.664995354937428,1071,220,34,29,16,10,18,19
0.762170263788969,0.780311768751413,0.674376433150826,1077,214,40,34,20,13,20,21
0.675517475398711,0.698211656842417,0.614452550616446,1059,232,28,28,7,6,21,22
0.756325703694125,0.783438608306074,0.663432666060054,1075,216,37,35,17,10,20,25
0.728039281454979,0.748073385723477,0.731033665244192,1090,201,43,37,16,16,27,21
0.777094514013119,0.808648858936333,0.696927374301676,1067,224,43,38,23,18,20,20
0.779060017652251,0.8032545223387,0.690895309434635,1077,214,55,45,30,19,25,26
0.713147550189527,0.731531742286668,0.695260663507109,1068,223,34,25,12,7,22,18
0.743687443130118,0.769600148185748,0.728014103730664,1087,204,35,35,15,15,20,20
0.714751767879274,0.748283207150342,0.726156097560976,1067,224,44,41,16,14,28,27
0.69094292076887,0.713173163829674,0.699367088607595,1058,233,27,27,10,8,17,19
0.737522747952684,0.762537939769391,0.68835304822566,1064,227,35,35,14,9,21,26
0.748361826353593,0.778854626409391,0.700655200655201,1086,205,38,33,19,14,19,19
0.749061591329632,0.782899953848588,0.696609444882926,1061,230,30,24,15,12,15,12
0.711496185180396,0.738117945337918,0.662934624923955,1061,230,37,34,15,12,22,22
0.797974767596282,0.823774153272817,0.709519645882289,1047,244,36,29,20,13,16,16
0.75622402684052,0.771221295316215,0.692954363490793,1069,222,42,42,17,15,25,27
0.703663125276671,0.734536151052103,0.676375798114929,1067,224,36,26,18,12,18,14
0.695294739624636,0.726480564628343,0.636333231985406,1085,206,30,26,15,11,15,15
0.70355216155136,0.735817757693037,0.648223211660436,1069,222,44,38,22,15,22,23
0.726615371352213,0.744470214792099,0.71365318530267,1063,228,37,30,16,14,21,16
0.67769338222455,0.702112820650651,0.655038759689923,1090,201,46,43,14,11,32,32
0.763131707317073,0.781839211146493,0.683905994035368,1042,249,41,38,22,16,19,22
0.66280643562469,0.68142087363933,0.616791925615455,1070,221,42,33,13,7,29,26
0.737154984114376,0.766382541249896,0.686922782665719,1075,216,32,29,14,9,18,20
0.748411437648928,0.772682945778918,0.724953740417658,1083,208,32,30,14,14,18,16
0.754446442845723,0.775314821893233,0.747465437788018,1050,241,40,31,23,17,17,14
0.788877822045153,0.80225747807345,0.734679867032808,1063,228,36,33,21,17,15,16
0.772711830535571,0.80922038865798,0.643092682926829,1063,228,40,41,23,15,17,26
0.669609416800428,0.686874437659237,0.622483727746886,1051,240,45,37,21,16,24,21
0.702228449426208,0.730848244647015,0.640388989990901,1057,234,42,35,20,12,22,23
0.737671882408725,0.763241836879867,0.666026625704045,1056,235,37,31,20,12,17,19
0.736023104444157,0.757016515230224,0.69722474977252,1052,239,37,35,18,15,19,20
0.822818808112926,0.825901663437164,0.716224437268941,1069,222,33,34,19,16,14,18
0.746273209043425,0.770929775317986,0.75906374501992,1061,230,42,36,21,17,21,19
0.704246602717826,0.721587642963511,0.699867197875166,1061,230,40,36,13,13,27,23
0.739385365853658,0.778736600844038,0.716028899063301,1046,245,41,38,27,24,14,14
0.749392830266128,0.781479630070663,0.731649873023675,1064,227,47,39,25,21,22,18
0.729479752991967,0.752450075687852,0.708128223159869,1068,223,29,27,11,8,18,19
0.806046465448769,0.829292008239765,0.75336661546339,1071,220,32,31,20,17,12,14
0.736385524225576,0.77808663203242,0.735253456221198,1093,198,32,31,16,13,16,18
0.753400790101372,0.789262198262314,0.704021758516141,1069,222,43,45,26,24,17,21
0.705904984114377,0.726082738333262,0.707194060419867,1083,208,32,31,14,13,18,18
0.779865019946445,0.807354657258588,0.732496050552923,1061,230,29,25,15,11,14,14
0.764061258935663,0.810194064100052,0.699147853032315,1074,217,32,36,17,15,15,21
0.802911093627065,0.865683631076851,0.815768785170473,1083,208,20,19,12,10,8,9
0.796471054718477,0.825281494530061,0.70400363967243,1081,210,30,35,17,15,13,20
0.699123350586863,0.723018203649051,0.649158919876051,1043,248,44,36,16,13,28,23
0.806564062088924,0.83951792511414,0.743928648183967,1075,216,24,22,12,10,12,12
0.796429195041034,0.823501458332093,0.757760322594195,1055,236,46,38,30,24,16,14
0.789054891544931,0.811181889387005,0.708763414434341,1069,222,36,39,20,18,16,21
0.672238372093023,0.699152346488257,0.659222616188189,1065,226,43,42,16,13,27,29
0.769969167027991,0.79372888894513,0.671419884463363,1069,222,33,26,15,8,18,18
0.769824637471696,0.792216521677996,0.733132564189571,1076,215,33,28,14,8,19,20
0.722287562481623,0.744315142295631,0.674391785150079,1038,253,38,25,17,10,21,15
0.685428251217725,0.707712144793041,0.624268800598998,1085,206,37,34,12,11,25,23
0.725185900707152,0.741618885194214,0.723151478816946,1041,250,44,40,23,22,21,18
0.755941463414634,0.799100774327241,0.688944494995451,1068,223,41,35,23,16,18,19
0.792308984752384,0.819585420464829,0.758224530862464,1054,237,38,34,24,20,14,14
0.802345282682361,0.818159161753671,0.810024138971507,1047,244,45,37,30,26,15,11
0.724965878070974,0.737748142892143,0.659000793021412,1073,218,35,30,16,11,19,19
0.768318794607454,0.803109059398634,0.707034333070245,1081,210,30,24,16,11,14,13
0.803036851683348,0.824399349157344,0.783717689491229,1059,232,35,29,20,15,15,14
0.711321381142098,0.758694268008385,0.685691537761602,1051,240,36,35,16,14,20,21
0.691336930455635,0.712381428743619,0.714241828459081,1046,245,40,39,16,16,24,23
0.746093585920108,0.774158245040386,0.739593871946813,1068,223,38,33,17,15,21,18
0.744245390011341,0.775643263590293,0.711538461538461,1075,216,38,30,19,13,19,17
0.700258141382049,0.747115704600697,0.641510465052735,1082,209,32,29,14,9,18,20
0.742103046469184,0.768492137628691,0.723698123182659,1069,222,34,30,14,13,20,17
0.769024780175859,0.799459087386139,0.77789298515105,1059,232,40,31,26,18,14,13
0.754337539432177,0.79564231956033,0.726923076923077,1101,190,23,30,11,11,12,19
0.663456933707327,0.691088543293785,0.633591381993938,1074,217,47,39,19,14,28,25
0.785289299995182,0.802175064608045,0.78061022508766,1076,215,33,28,18,17,15,11
0.753436426116839,0.769930297603466,0.746762118148533,1067,224,30,29,15,12,15,17
0.725774679061532,0.74064873695483,0.705219925808161,1066,225,36,33,15,14,21,19
0.698303200408253,0.715315348834765,0.689021691013723,1036,255,44,36,21,16,23,20
0.686904761904762,0.716615598603774,0.643010752688172,1050,241,31,31,14,12,17,19
0.822222940643993,0.840954764891218,0.779339499927735,1033,258,37,33,24,19,13,14
0.757643312101911,0.780281318208227,0.699005154887508,1063,228,35,33,18,12,17,21
0.738663484486874,0.760932352022801,0.689373669808452,1066,225,34,26,17,12,17,14
0.723278048780488,0.746656508015985,0.653545119705341,1079,212,41,24,19,7,22,17
0.783960573476702,0.82005213156896,0.748604710701485,1068,223,31,31,16,14,15,17
0.706291219449114,0.729350189506011,0.660191154846737,1082,209,37,28,14,11,23,17
0.719311557546852,0.742240572764502,0.711848940053348,1053,238,33,34,13,13,20,21
0.748831719419955,0.779539783879225,0.735777402700556,1068,223,33,32,17,16,16,16
0.689219512195122,0.707231497676146,0.680388121140841,1059,232,41,38,15,14,26,24
0.694869931425164,0.71719670266997,0.663209973166369,1074,217,43,43,19,18,24,25
0.752839159882329,0.775703542514687,0.706037096486535,1070,221,47,45,23,19,24,26
0.705180401516215,0.734509593008415,0.659880104060627,1068,223,34,28,14,14,20,14
0.766027890869952,0.799599006117044,0.68733264112793,1071,220,34,29,17,11,17,18
0.715548225659691,0.74254109090417,0.753912647861692,1062,229,35,35,13,13,22,22
0.654219658878044,0.68597716406418,0.623860911270983,1052,239,49,40,20,14,29,26
0.659600355655389,0.676633700592208,0.641733067729084,1083,208,34,36,11,11,23,25
0.76931008623922,0.787519790361206,0.725607135181603,1066,225,21,22,8,9,13,13
0.746402877697842,0.763790401129964,0.681955025804866,1085,206,40,39,21,16,19,23
0.731506616898541,0.752662619917131,0.65060176230389,1087,204,28,22,12,7,16,15
0.646592725819345,0.66860707541576,0.674533385059701,1053,238,40,37,15,16,25,21
0.696654790182106,0.716424801516135,0.657150409727729,1086,205,28,30,10,9,18,21
0.785051958433253,0.812883800287776,0.797147737376573,1076,215,40,34,22,18,18,16
0.717194022063208,0.735647196237895,0.615285776773347,1055,236,43,44,20,15,23,29
0.749656927844179,0.78604750437508,0.714989759344598,1059,232,36,31,18,12,18,19
0.747053658536585,0.762718633795607,0.723059183585499,1075,216,41,37,19,14,22,23
0.746234146341463,0.764495352510385,0.742071659595917,1056,235,41,38,19,18,22,20
0.807211087669948,0.828313690580372,0.759794628751975,1092,199,27,25,15,14,12,11
0.740218380345769,0.768894451676562,0.593541454586585,1053,238,35,28,18,12,17,16
0.687473396169048,0.730228067144117,0.647326747418586,1080,211,26,32,11,12,15,20
0.739620853080569,0.773392859193025,0.678867403314917,1073,218,25,24,12,11,13,13
0.737517408044565,0.760002029388306,0.751137397634213,1069,222,39,35,19,16,20,19
0.675648316651501,0.70806263790854,0.675844854070661,1075,216,35,31,14,14,21,17
0.796230440967283,0.830997242372754,0.707778991262907,1091,200,37,32,22,17,15,15
0.713089084828215,0.746287818566696,0.673124399945138,1077,214,26,23,12,11,14,12
0.763921747042766,0.794517358973377,0.677080270508674,1070,221,35,38,17,15,18,23
0.748391286970424,0.765289707924909,0.718193891102258,1047,244,40,36,21,18,19,18
0.803881211408409,0.825128261190452,0.811781696564305,1066,225,38,26,24,15,14,11
0.645313921747043,0.663714785690653,0.640463661636219,1076,215,35,32,11,9,24,23
0.726478616924477,0.747439812550102,0.666482346194806,1060,231,35,39,15,13,20,26
0.753596451997615,0.781561646286542,0.771606455312526,1056,235,43,39,23,23,20,16
0.736328480436761,0.761215607248457,0.665335381464414,1069,222,35,31,17,14,18,17
0.735013337077074,0.757061749949115,0.698260027799841,1072,219,34,32,14,13,20,19
0.667216259321523,0.703389229176577,0.640113666402326,1057,234,37,30,16,12,21,18
0.694290834613415,0.747437494915985,0.648792283731351,1040,251,31,29,17,10,14,19
0.706724086576648,0.735471685076261,0.660666137985725,1064,227,32,30,14,10,18,20
0.746336048967628,0.766059374373406,0.705197907188353,1078,213,37,35,18,17,19,18
0.761068173226362,0.781359252508591,0.733340352847583,1057,234,38,34,18,14,20,20
0.736432561851556,0.755201641330972,0.620670135376018,1072,219,38,33,17,11,21,22
0.763025313344802,0.797749141134698,0.721336983480743,1079,212,39,34,20,15,19,19
0.713036565977743,0.747866026899301,0.694031073049745,1061,230,33,34,15,14,18,20
0.742187171840215,0.767295903982178,0.725029785544083,1063,228,38,32,19,15,19,17
0.762511373976342,0.780986181776602,0.713430676137858,1076,215,35,24,16,7,19,17
0.713424623010039,0.738108686486727,0.716259534840189,1083,208,38,34,16,13,22,21
0.779948005746733,0.789055239539608,0.740268405200351,1082,209,47,42,21,18,26,24
0.727844178840195,0.75464576139631,0.654803687584819,1068,223,36,34,15,11,21,23
0.707632772884975,0.739261238484514,0.632139316349843,1051,240,42,37,19,12,23,25
0.76705011202798,0.80233251837336,0.703043382027446,1066,225,29,36,14,13,15,23
0.6946227929374,0.710575464282271,0.670809847280435,1075,216,45,33,13,9,32,24
0.765028697078116,0.783068736516196,0.719984076433121,1064,227,43,35,24,18,19,17
0.757140756920234,0.778591248526505,0.747766084193805,1081,210,38,32,18,16,20,16
0.742467347730506,0.769677650871973,0.652183803457689,1063,228,37,35,20,17,17,18
0.72598400539577,0.751126618379835,0.676907874733962,1058,233,33,26,14,11,19,15
0.74310551558753,0.778219195624639,0.728556727013063,1069,222,40,38,19,17,21,21
0.721936758893281,0.751017444965163,0.701017710811525,1063,228,26,30,12,12,14,18
0.714780487804878,0.738736474809853,0.603543382955148,1067,224,41,33,16,10,25,23
0.760525260625501,0.786015846546308,0.703524823212073,1074,217,44,44,24,22,20,22
0.74265587529976,0.769906244261593,0.704374834787206,1064,227,40,30,20,15,20,15
0.801621139856434,0.812036678459648,0.753456221198157,1074,217,33,31,18,15,15,16
0.700582619682718,0.71708794508305,0.754013377926421,1064,227,34,26,11,11,23,15
0.752281342131125,0.777162869220205,0.758466135458167,1069,222,34,36,18,18,16,18
0.762773922072244,0.790835245283919,0.724595639943741,1078,213,29,27,18,13,11,14
0.685471356523988,0.719871696494786,0.59101970143666,1086,205,37,34,15,11,22,23
0.828905630452022,0.84022045222472,0.76329632566746,1060,231,30,30,18,16,12,14
0.782381584772023,0.796954960465292,0.78670367433254,1069,222,36,30,15,14,21,16
0.765117308543603,0.790897731757761,0.716114320462147,1078,213,36,26,17,9,19,17
0.802892772310825,0.814100638790834,0.683191212602977,1071,220,28,33,14,13,14,20
0.74582338902148,0.799594453833203,0.678514694201747,1074,217,34,32,20,16,14,16
0.716939863234111,0.74722293305682,0.676087804878049,1075,216,48,41,25,17,23,24
0.791886490807354,0.799431274304398,0.765019379844961,1070,221,40,43,18,21,22,22
0.744372144993263,0.758007623595353,0.732553956834532,1082,209,49,40,17,11,32,29
0.789126478616924,0.816323805511369,0.71875,1029,262,35,27,21,14,14,13
0.714795008912656,0.740382932730474,0.674211790904829,1058,233,33,27,15,10,18,17
0.773441765241128,0.797171595658374,0.73146073555932,1058,233,35,29,20,14,15,15
0.728839545334391,0.764808552856526,0.715662172878668,1080,211,30,30,14,13,16,17
0.749508634002527,0.776471903832981,0.7428955453149,1070,221,34,31,15,12,19,19
0.771314741035857,0.797035273182633,0.714342629482072,1046,245,36,36,22,20,14,16
0.790525477707006,0.82416313140192,0.763019837149571,1063,228,35,29,22,17,13,12
0.712329390354868,0.756377273301308,0.693510441448586,1072,219,35,30,20,14,15,16
0.687238398544131,0.698826061671891,0.673867436910915,1065,226,35,26,7,3,28,23
0.727072581305808,0.747919266649373,0.629591932238289,1044,247,39,34,18,12,21,22
0.727029858564693,0.75433694499367,0.682975609756098,1073,218,46,41,23,16,23,25
0.649560351718625,0.680983220533799,0.602411234764176,1087,204,40,33,16,11,24,22
0.776490850769119,0.791491830214387,0.71829687884001,1092,199,44,39,21,17,23,22
0.702249180083482,0.722833718605546,0.673215860881253,1050,241,43,38,21,16,22,22
0.799502247238207,0.819873886620227,0.706003584229391,1076,215,38,31,21,13,17,18
0.697753106000529,0.733457105402127,0.71069457347396,1072,219,30,29,14,15,16,14
0.746907317073171,0.771788209173227,0.745109190172884,1054,237,41,35,21,16,20,19
0.606289808917197,0.6217355264035,0.577775250227479,1080,211,35,35,11,7,24,28
0.801137440758294,0.841966877973746,0.796006749156355,1058,233,25,21,16,14,9,7
0.768048780487805,0.784401368561133,0.783169533169533,1051,240,41,33,22,19,19,14
0.804332759272483,0.834454259129495,0.791833077316948,1057,234,38,31,24,19,14,12
0.781255686988171,0.798203744994208,0.719916388873709,1068,223,35,29,19,14,16,15
0.758731994026112,0.816457052376706,0.751188589540412,1061,230,33,29,19,16,14,13
0.74869104716227,0.772472441055029,0.728742007759987,1045,246,40,29,22,16,18,13
0.739056304520222,0.761322043946962,0.698806748045535,1078,213,30,23,12,8,18,15
0.71376999008578,0.737360262532899,0.743725008430891,1064,227,37,33,18,15,19,18
0.768470562195662,0.789474384700697,0.73120839733743,1063,228,36,31,20,17,16,14
0.707394084732214,0.734705839227721,0.661150455268102,1084,207,40,33,16,12,24,21
0.852929121809935,0.868743217700558,0.711203483768804,1037,254,29,28,19,11,10,17
0.74807031456516,0.785566927876423,0.697272034692921,1076,215,30,27,14,12,16,15
0.787229268292683,0.807647380560614,0.727953223560252,1062,229,41,39,23,18,18,21
0.716173110909953,0.743740450513725,0.626509645335811,1068,223,37,29,19,12,18,17
0.71121103117506,0.743660777610058,0.7338355101513,1077,214,40,37,16,15,24,22
0.765570528291767,0.783877338985402,0.718654311039484,1089,202,48,50,23,21,25,29
0.760302024035421,0.788217195918528,0.744975609756097,1051,240,51,41,27,20,24,21
0.730167791898332,0.751460814050438,0.73167194092827,1078,213,32,27,14,10,18,17
0.746824644549763,0.794888711503049,0.640390185256025,1078,213,25,29,16,12,9,17
0.737793888752355,0.759507450790552,0.686544380460683,1056,235,39,32,19,14,20,18
0.769823654606263,0.792823109112038,0.729199552749276,1051,240,26,24,11,10,15,14
0.780211702440459,0.798051721175429,0.718214958630294,1066,225,38,39,20,16,18,23
0.702877697841727,0.732105107825893,0.673262419459377,1095,196,40,42,15,14,25,28
0.753648729150119,0.814810572905867,0.652489575059571,1080,211,32,32,20,15,12,17
0.641928024280966,0.669353788433899,0.63223632038065,1069,222,33,30,13,9,20,21
0.793556085918854,0.812735931622716,0.771872139519198,1053,238,34,33,18,18,16,15
0.764098721023182,0.792219003468563,0.756832327202958,1050,241,40,34,25,20,15,14
0.738922089420097,0.756801232849169,0.718817748229513,1071,220,36,33,14,11,22,22
0.747009912345376,0.774353319242594,0.666994243998315,1044,247,39,34,22,14,17,20
0.790885382990646,0.819286088576302,0.725826063970394,1068,223,37,30,21,16,16,14
0.780597198328828,0.802459924804965,0.709181393963463,1082,209,39,32,20,12,19,20
0.707087369554027,0.734682884813258,0.688158079460901,1049,242,34,34,15,12,19,22
0.713389656938044,0.739972317582618,0.643087557603687,1062,229,31,31,10,7,21,24
0.769404849676415,0.804924159510056,0.676865332120109,1086,205,39,35,22,15,17,20
0.759473218238158,0.786354742383875,0.686767463666198,1059,232,36,27,19,10,17,17
0.758018653321201,0.785260616116112,0.736826711591558,1076,215,35,34,15,14,20,20
0.73907884235729,0.757090195881415,0.736534451945989,1079,212,38,32,18,16,20,16
0.744241461477363,0.780028697849633,0.689514760773668,1063,228,32,28,19,14,13,14
0.733385365853658,0.763385719476904,0.689200279378383,1034,257,41,46,16,15,25,31
0.683239775461107,0.702376411974455,0.621702711558941,1065,226,44,39,18,11,26,28
0.809866845885664,0.828965158411009,0.761194818926778,1068,223,38,30,21,16,17,14
0.688603202360785,0.709302870769276,0.733471892319873,1075,216,29,28,11,10,18,18
0.763598941487798,0.785590225266627,0.698494983277592,1055,236,38,26,21,12,17,14
0.702629978005522,0.733937511220228,0.675374572433396,1053,238,34,33,13,13,21,20
0.758886675520142,0.800287568702339,0.70762928827445,1077,214,36,31,22,17,14,14
0.674113108323635,0.690310477247273,0.604559873116574,1061,230,37,30,14,8,23,22
0.738997370576318,0.776986167096552,0.721298495645289,1067,224,37,28,16,12,21,16
0.718119188707424,0.738382554118234,0.704864700516875,1072,219,33,26,15,10,18,16
0.789242659721931,0.824179723762278,0.777259113669334,1062,229,38,34,22,17,16,17
0.802764612954186,0.84193631177989,0.821176649437519,1067,224,25,26,14,16,11,10
0.789590060367823,0.814572087970994,0.75552273629865,1060,231,34,32,21,15,13,17
0.668315626383355,0.689145032166101,0.663478878627247,1051,240,36,29,15,11,21,18
0.694797458300238,0.736244269707516,0.692401224110607,1073,218,32,29,18,17,14,12
0.755196001052355,0.78864838030402,0.657386576677915,1057,234,24,21,14,8,10,13
0.663461538461538,0.68543097788848,0.609072741806555,1070,221,43,40,15,10,28,30
0.709275415745064,0.729886786839658,0.653584206215785,1055,236,39,37,13,11,26,26
0.737953851374279,0.763944771102457,0.703996840442338,1072,219,28,25,14,8,14,17
0.753100285460246,0.78028455176272,0.737429595494112,1048,243,34,31,17,14,17,17
0.715947242206235,0.751356182956908,0.685919017288444,1056,235,40,35,21,16,19,19
0.788721207307387,0.804257245917748,0.733415377402719,1061,230,32,27,14,11,18,16
0.739654092595269,0.78111194469812,0.768107322231034,1069,222,33,30,14,15,19,15
0.715423111919927,0.756851700015004,0.693419876886418,1057,234,35,32,20,15,15,17
0.753965076823363,0.771241459001877,0.678965853658537,1061,230,42,41,20,15,22,26
0.743366559034115,0.774360728601793,0.691040411975212,1066,225,34,18,18,8,16,10
0.741266554931151,0.759503968187473,0.691924218613585,1066,225,49,46,25,20,24,26
0.760752688172043,0.790482236550689,0.740785256410256,1039,252,51,43,29,25,22,18
0.736341956930192,0.760408106796954,0.727690037706979,1088,203,33,29,12,11,21,18
0.800354569369782,0.830803434550273,0.731005195843325,1051,240,42,40,27,22,15,18
0.745218480512598,0.777964288365122,0.690751588562351,1081,210,33,32,16,13,17,19
0.753241583257507,0.779371492860228,0.665860428231562,1068,223,35,30,15,9,20,21
0.755834849863512,0.797246120886349,0.730825026908138,1099,192,35,34,20,17,15,17
0.794854070660522,0.82344177722591,0.706495305960864,1046,245,31,28,17,10,14,18
0.801847095469698,0.824542313610468,0.716131907308378,1060,231,29,33,18,17,11,16
0.733387070331712,0.787040740509016,0.664691943127962,1078,213,29,25,14,10,15,15
0.738739095955591,0.762999189835,0.707381036099391,1087,204,30,27,11,9,19,18
0.696825167413403,0.726743812486672,0.690117767537122,1070,221,33,31,13,11,20,20
0.719198001146883,0.747660481000443,0.660877052967615,1063,228,39,38,15,15,24,23
0.767829566194019,0.795108113433878,0.706562748212867,1060,231,34,32,17,14,17,18
0.774521503111985,0.812425974612439,0.764058145253839,1079,212,34,29,20,14,14,15
0.676460823373174,0.700675185625572,0.690201650363408,1056,235,36,29,13,10,23,19
0.70851713607058,0.734967417806317,0.70650653694132,1060,231,28,26,10,8,18,18
0.756829021534904,0.798466393382642,0.687045740204383,1016,275,33,29,21,16,12,13
0.758610284926074,0.767416613552142,0.740696087352138,1075,216,37,35,16,13,21,22
0.720991617620831,0.746740858012671,0.660501193317423,1060,231,45,34,20,13,25,21
0.776906274821287,0.822401382305769,0.767857142857143,1062,229,32,28,18,14,14,14
0.726792828685259,0.749763972444582,0.714324116743472,1045,246,36,31,18,15,18,16
0.762215370018975,0.792962112407681,0.709541644373105,1076,215,51,45,26,21,25,24
0.761023123760005,0.782628443792643,0.685044525929806,1075,216,47,46,22,18,25,28
0.743355315747402,0.753172953296917,0.680336753866166,1034,257,40,33,18,10,22,23
0.797409463388845,0.823694321213909,0.776681785889939,1077,214,30,29,15,16,15,13
0.709109730848861,0.727094666093448,0.679638949254642,1071,220,49,42,21,18,28,24
0.742872952633909,0.771781714826076,0.663956737486149,1062,229,36,33,19,13,17,20
0.710620525059666,0.739846620158423,0.610733728380787,1076,215,34,33,12,6,22,27
0.737824390243902,0.760312657961462,0.739654092595269,1065,226,41,33,23,19,18,14
0.715346341463415,0.741007799841628,0.638751207628009,1072,219,41,38,17,13,24,25
0.735182682067666,0.763318359646672,0.68766851704996,1062,229,39,30,23,15,16,15
0.728087416350789,0.753008604275016,0.644348193010326,1057,234,34,32,16,11,18,21
0.764383935663225,0.794458002420611,0.684283452098179,1068,223,32,28,15,9,17,19
0.774478330658106,0.793576085444446,0.74452158597526,1059,232,45,39,23,17,22,22
0.777570711075866,0.809765295113232,0.658530805687204,1084,207,30,25,14,9,16,16
0.686810551558753,0.70990059111386,0.658556097560976,1087,204,40,41,14,13,26,28
0.744676494676495,0.760827914911138,0.658975229046488,1055,236,37,28,20,11,17,17
0.790514103730664,0.807458138128123,0.740140100449379,1067,224,35,30,21,16,14,14
0.774847632442569,0.817697196763736,0.748510185466707,1066,225,27,26,14,10,13,16
0.723940847322142,0.745810670565853,0.745885646420088,1044,247,40,28,19,14,21,14
0.755064456721915,0.778131228417234,0.634356090502499,1066,225,24,24,10,6,14,18
0.785035842293907,0.80554833532677,0.789149983033593,1071,220,31,28,18,13,13,15
0.734989938696242,0.77416958435275,0.678707034372502,1052,239,34,40,15,12,19,28
0.733450245726047,0.761040348402518,0.711613505259586,1052,239,38,28,20,15,18,13
0.75586753502089,0.776841885565243,0.751438652497165,1074,217,39,38,18,19,21,19
0.785491606714628,0.810201462828217,0.717447679708826,1083,208,40,35,22,15,18,20
0.67072709707229,0.693754242796825,0.686431131592422,1055,236,38,31,14,10,24,21
0.745551128818061,0.764555592412871,0.742348729467921,1070,221,36,34,17,14,19,20
0.755907125819916,0.776388369641269,0.743607825295723,1070,221,43,35,19,15,24,20
0.74180199057098,0.759593668488086,0.690763220901416,1063,228,46,38,22,16,24,22
0.773550470307455,0.790952463000423,0.721938357287283,1053,238,34,29,18,12,16,17
0.719038834227788,0.743779748887493,0.661643600594762,1064,227,43,42,21,18,22,24
0.758675366333746,0.781448005508952,0.704246602717826,1075,216,44,40,18,15,26,25
0.723481220496682,0.749422225638975,0.666371192191849,1051,240,47,42,22,18,25,24
0.804071883530482,0.821224036763657,0.751005262112788,1050,241,35,32,20,17,15,15
0.764143559928444,0.785633561540388,0.740515714918105,1068,223,43,36,23,19,20,17
0.698406374501992,0.736680484766498,0.688297923592041,1071,220,36,33,17,14,19,19
0.736760211687537,0.764287912828785,0.759230478430714,1050,241,43,38,17,16,26,22
0.763315411433612,0.794221661513407,0.686167982004651,1074,217,38,42,17,14,21,28
0.737747035573122,0.769198223450074,0.632890995260664,1057,234,26,25,14,9,12,16
0.837029613345403,0.848640229203453,0.794346485522956,1056,235,37,33,25,21,12,12
0.678530323151837,0.698486827867528,0.65647339158062,1042,249,36,32,15,12,21,20
0.669431473744573,0.692624603270567,0.658472298063595,1066,225,39,38,13,14,26,24
0.749752144488987,0.780690866580247,0.698185563939635,1077,214,37,32,21,15,16,17
0.723757718318142,0.749069550037917,0.70066451401563,1065,226,38,34,16,12,22,22
0.690474519163274,0.719753235031905,0.672857349327938,1081,210,34,33,11,10,23,23
0.710893854748603,0.730263452433129,0.670002520267148,1068,223,38,38,17,12,21,26
0.752727817745804,0.769180691854954,0.6648,1098,193,40,41,19,15,21,26
0.792094185740595,0.813282565722061,0.65414029535865,1086,205,24,27,12,9,12,18
0.738226691642841,0.755523665422438,0.677381484794275,1077,214,49,43,26,18,23,25
0.738512616201859,0.7622730764669,0.703198519693365,1079,212,36,30,15,14,21,16
0.774374431301183,0.801547443978459,0.753343906952154,1065,226,35,30,20,17,15,13
0.762454320157937,0.797300084583073,0.796193741209564,1061,230,38,27,22,17,16,10
0.736367281475541,0.755350143344097,0.717574147853032,1082,209,44,36,18,11,26,25
0.732381019233469,0.767309145061695,0.69345281109987,1041,250,34,33,19,16,15,17
0.648679507545671,0.666878664677848,0.655253750586029,1085,206,32,27,8,8,24,19
0.716020435395936,0.746844027496965,0.678930126298547,1049,242,42,37,20,15,22,22
0.775129024330302,0.793607199113008,0.782059571533256,1080,211,39,37,21,21,18,16
0.754868292682927,0.773242528199265,0.719095600884738,1079,212,41,39,19,17,22,22
0.763341092288461,0.801750037794485,0.697752565399624,1073,218,37,33,22,15,15,18
0.701907790143084,0.74219853846136,0.684245307956648,1072,219,33,30,14,11,19,19
0.743654648696723,0.77082139768574,0.695364024311393,1068,223,47,37,21,14,26,23
0.744010014506996,0.760207566181432,0.698029946991639,1063,228,34,29,15,12,19,17
0.719347358896052,0.749086938757516,0.672189990623535,1083,208,28,27,12,11,16,16
0.713307317073171,0.744409076087221,0.615307753796963,1055,236,41,40,22,15,19,25
0.773306772908367,0.797627632469913,0.75822825655282,1049,242,36,32,21,16,15,16
0.783397339185297,0.810764837229849,0.659852941176471,1053,238,23,16,14,6,9,10
0.793291776278165,0.810456878997857,0.736273170731707,1048,243,42,41,24,22,18,19
0.729447974583002,0.759100086444506,0.661986766202918,1072,219,32,28,17,13,15,15
0.671693523867437,0.714397045672045,0.658195429472025,1064,227,26,22,9,5,17,17
0.763457281983178,0.794196267609522,0.722811081473162,1063,228,36,34,18,15,18,19
0.741551219512195,0.764316573289355,0.724545040946315,1054,237,41,35,21,17,20,18
0.730839691366007,0.775898887077791,0.693049155145929,1064,227,37,31,21,15,16,16
0.736743325403119,0.767968402300833,0.709566123907863,1047,244,30,32,16,12,14,20
0.795382165605096,0.829459751223032,0.781444406741319,1086,205,35,28,20,16,15,12
0.700343072155821,0.744099206363699,0.650568332011631,1084,207,36,30,19,11,17,19
0.714952249034045,0.728876763883549,0.704731574158326,1053,238,44,35,17,15,27,20
0.665455538287058,0.684813074434366,0.582373271889401,1073,218,38,31,12,7,26,24
0.799066404604801,0.833315594863713,0.734331797235023,1061,230,34,31,22,17,12,14
0.726827094474153,0.74238013575517,0.665770609318996,1048,243,33,31,15,13,18,18
0.743863414634146,0.761896259511012,0.69384280593958,1050,241,41,31,18,14,23,17
0.719809299785777,0.749862329930172,0.694452473864238,1067,224,38,33,15,12,23,21
0.749445970034205,0.790904147103859,0.694366976538291,1069,222,33,36,17,16,16,20
0.70857909396248,0.736158247347553,0.710844420174742,1068,223,39,32,17,11,22,21
0.75037172595219,0.789373600383998,0.71848051259816,1062,229,42,33,24,14,18,19
0.790676959619952,0.823520650672252,0.738250117205813,1083,208,28,27,15,12,13,15
0.705215499087463,0.740391166897413,0.668135372376903,1077,214,34,23,15,9,19,14
0.778657074340528,0.798119596880472,0.722089314194577,1047,244,40,37,26,19,14,18
0.732979194333776,0.758786104863671,0.578264331210191,1058,233,36,35,19,12,17,23
0.739477884655773,0.772592683025955,0.671377368151562,1063,228,38,31,18,10,20,21
0.75566424021838,0.790896386777251,0.731602049817281,1070,221,35,38,20,19,15,19
0.727531707317073,0.749593068365112,0.71134351482957,1077,214,41,36,17,14,24,22
0.724667994687915,0.749511865135969,0.717049960348929,1066,225,36,30,19,15,17,15
0.723953594176524,0.748266906467702,0.746880570409982,1069,222,35,33,14,13,21,20
0.708522323624242,0.724402861270896,0.678402699662542,1056,235,29,21,12,8,17,13
0.719274778404512,0.738311036272603,0.642126829268293,1055,236,50,41,21,13,29,28
0.775723816096487,0.810700491598558,0.753887997146424,1058,233,49,45,30,26,19,19
0.7349485687995,0.763569726938707,0.691112195121951,1074,217,49,41,25,19,24,22
0.811698717948718,0.826090367860113,0.750907481186366,1045,246,43,36,27,21,16,15
0.681509543682014,0.705535213898101,0.71246003197442,1060,231,47,40,17,14,30,26
0.671671756588621,0.710706454688246,0.646310181531176,1062,229,28,24,9,6,19,18
0.752644975652944,0.779627979860571,0.739997021445592,1088,203,36,32,17,15,19,17
0.758269329237071,0.795148969839612,0.74274861878453,1084,207,31,24,12,10,19,14
0.680439589767052,0.699414329032115,0.740354868061874,1060,231,42,35,14,9,28,26
0.723590150913423,0.754157011122672,0.647980516401569,1078,213,32,37,15,15,17,22
0.742895086321381,0.772083153770766,0.671845642433878,1072,219,36,33,18,12,18,21
0.731257896953531,0.756947954640423,0.66622399291722,1072,219,34,36,12,12,22,24
0.712355594842564,0.734229846727972,0.6619945953342,1078,213,53,47,24,19,29,28
0.759201715084068,0.794382814887397,0.644354838709677,1059,232,33,31,15,14,18,17
0.74359229747676,0.777890230347377,0.764107424960506,1059,232,36,25,21,16,15,9
0.763045793397231,0.787844562606969,0.678784860557769,1067,224,39,36,21,16,18,20
0.764785303231518,0.792715620177349,0.732972597299444,1058,233,36,32,17,14,19,18
0.787625418060201,0.801895349542415,0.791358609794629,1079,212,26,25,11,12,15,13
0.655883919062833,0.677184566592039,0.640972498014297,1045,246,39,32,12,11,27,21
0.797528037972025,0.811239001670415,0.806541218637993,1039,252,38,31,22,18,16,13
0.739075974370092,0.765057937442544,0.684165386584741,1072,219,33,31,15,12,18,19
0.729655107866536,0.759264390464663,0.679429083461342,1074,217,34,31,18,12,16,19
0.764900153609831,0.785592532406946,0.666090629800307,1066,225,31,31,16,14,15,17
0.72755522344536,0.740993801689649,0.655695443645084,1044,247,44,40,19,14,25,26
0.734139692706546,0.745130093455322,0.691944031415609,1055,236,42,42,16,16,26,26
0.712410785091197,0.734473264663406,0.710407066052227,1095,196,30,31,9,10,21,21
0.670547061159651,0.682162763564362,0.655497630331754,1051,240,32,25,12,9,20,16
0.65006551546633,0.686263684643838,0.650463748444746,1075,216,34,28,8,5,26,23
0.7459654296715,0.756791918179149,0.710751046261735,1052,239,39,28,19,10,20,18
0.730067958357432,0.757167404970639,0.70814562598219,1063,228,56,46,29,22,27,24
0.781783657664813,0.815471653222922,0.774627871542429,1077,214,32,27,17,14,15,13
0.777607913669065,0.811502666573716,0.792805755395684,1057,234,40,40,24,25,16,15
0.757190243902439,0.776581441341204,0.765124518718768,1043,248,41,39,23,22,18,17
0.689164004259851,0.71760432862601,0.681905894792493,1067,224,39,30,17,13,22,17
0.69873041290175,0.745398270351671,0.656200357426529,1062,229,42,32,19,12,23,20
0.751302434204617,0.768399010121077,0.696062510913218,1072,219,54,46,25,19,29,27
0.710665239878723,0.737816826104716,0.709455202251439,1059,232,45,38,22,17,23,21
0.668573703366697,0.699258302834482,0.556778889899909,1079,212,35,35,13,10,22,25
0.720742273373852,0.746468465787775,0.68146256304151,1043,248,37,37,18,16,19,21
0.707546920433518,0.725591016076745,0.657722712070538,1080,211,30,26,13,9,17,17
0.711158687818803,0.730630624933976,0.680187441936718,1066,225,34,29,12,9,22,20
0.748427313279195,0.770652907756971,0.669045373312153,1076,215,42,32,19,10,23,22
0.745541287676119,0.775638233959042,0.70384019477645,1065,226,45,36,24,16,21,20
0.74811643034302,0.76707313656635,0.695898682988142,1058,233,34,29,17,13,17,16
0.726214547243019,0.753093105258707,0.704224386229598,1090,201,29,23,13,10,16,13
0.660777074542897,0.693156606377299,0.691726100672061,1079,212,27,23,10,8,17,15
0.775580711555425,0.797136956607131,0.740427180168216,1045,246,38,36,20,18,18,18
0.800338995407159,0.812856293855184,0.736058536585366,1071,220,44,41,22,20,22,21
0.743284130754439,0.770935412326532,0.72500586029067,1068,223,28,27,14,13,14,14
0.755956609650801,0.78577406573157,0.678543151227237,1066,225,29,28,15,12,14,16
0.817844582550465,0.847269112846924,0.749444885011895,1073,218,33,30,18,14,15,16
0.723122529644269,0.766375580119708,0.632306477093207,1088,203,26,25,14,11,12,14
0.760903854066658,0.804541753420159,0.716640543364681,1067,224,23,15,14,8,9,7
0.781470822219102,0.801849870268209,0.770342641674408,1055,236,34,29,19,15,15,14
0.664163901373546,0.697965623984827,0.679621539883228,1079,212,38,38,18,15,20,23
0.755735411670663,0.774161208314355,0.707518367752184,1056,235,40,32,19,15,21,17
0.743879446964315,0.757868827281708,0.701944177753395,1041,250,29,23,13,9,16,14
0.697833649588868,0.722651724530036,0.651257202723939,1083,208,51,46,23,18,28,28
0.79004317175802,0.810010323349491,0.660208497246263,1075,216,29,20,16,8,13,12
0.760369995664113,0.784989624558532,0.706608280254777,1068,223,33,35,14,10,19,25
0.752035301361428,0.77923688968111,0.659278048780488,1056,235,47,41,27,17,20,24
0.760917073170732,0.779870531084948,0.681274980015987,1051,240,41,40,20,15,21,25
0.689808917197452,0.714503767076934,0.618802742616034,1066,225,35,27,14,8,21,19
0.722349863512284,0.743059694173189,0.700066401062417,1054,237,35,36,18,18,17,18
0.72899512195122,0.752882243250445,0.677689243027888,1057,234,41,36,19,13,22,23
0.78349855084639,0.809105068494301,0.743346223839854,1060,231,38,35,22,19,16,16
0.744462067142479,0.779606780070608,0.696414432756476,1062,229,30,28,15,11,15,17
0.786940198444623,0.80719725524865,0.724468292682927,1080,211,48,41,26,20,22,21
0.737254025044723,0.761295189349016,0.72546962430056,1068,223,43,40,21,19,22,21
0.792527821939587,0.818634691142412,0.778751200109724,1061,230,33,23,16,11,17,12
0.726345313741064,0.75961015260472,0.702306136947374,1070,221,32,29,17,13,15,16
0.735784063570752,0.752100493735116,0.652606961836613,1060,231,44,43,20,15,24,28
0.685487834848857,0.704672594117371,0.641565112847697,1067,224,39,29,13,8,26,21
0.76057272568535,0.774939669590412,0.726340992145167,1062,229,46,38,25,21,21,17
0.72565560821485,0.754669710603448,0.635633931286105,1086,205,25,26,14,8,11,18
0.735451638689049,0.75918965630796,0.734019563239309,1046,245,40,35,19,14,21,21
0.76145396733632,0.781740098907863,0.710504763136342,1050,241,33,37,14,12,19,25
0.741489597166888,0.773490064509462,0.727477477477477,1090,201,36,33,17,15,19,18
0.733670769101525,0.768090344553531,0.727999114652501,1075,216,38,36,19,18,19,18
0.74468085106383,0.773713007761804,0.670772447088236,1049,242,47,37,26,18,21,19
0.751975237269355,0.783270009584658,0.692764612954186,1076,215,33,25,15,11,18,14
0.703341041576336,0.729508436504399,0.659885821650528,1057,234,33,33,14,10,19,23
0.733135077980439,0.767343061473534,0.684507366482505,1077,214,30,24,15,10,15,14
0.759878872120731,0.771158388779556,0.674351683348499,1051,240,32,35,13,11,19,24
0.747347833210453,0.769222974424765,0.714459674985991,1057,234,39,37,19,15,20,22
0.764504935557567,0.786890268885881,0.720822219102438,1085,206,37,34,18,16,19,18
0.762699840127898,0.781151439740169,0.705199885311706,1023,268,40,39,21,19,19,20
0.747812251392204,0.778418049535908,0.707754169976172,1057,234,34,32,17,15,17,17
0.680909948371723,0.709061507787405,0.674244494234658,1066,225,32,29,12,10,20,19
0.675831490128615,0.705187719186859,0.614268452527238,1043,248,39,39,19,14,20,25
0.777447303763093,0.806176073812725,0.684071066376911,1070,221,37,42,20,19,17,23
0.723882248782647,0.746084703807837,0.699202115213627,1057,234,36,34,16,13,20,21
0.74177174344718,0.761479089283186,0.661088977423639,1063,228,32,36,11,9,21,27
0.763125568698817,0.788511753689756,0.749326066572902,1045,246,35,27,19,15,16,12
0.830861749933915,0.854453345931252,0.70488349734193,1093,198,30,28,18,11,12,17
0.752644975652944,0.779586052836709,0.671462829736211,1067,224,36,40,17,14,19,26
0.778692553452937,0.811614069527436,0.72278768309233,1068,223,39,34,21,16,18,18
0.732608276725924,0.758795025936391,0.677567140600316,1063,228,33,25,16,9,17,16
0.805593102318342,0.81866540135727,0.753184713375796,1066,225,39,35,19,13,20,22
0.775105798924854,0.784013279238094,0.73249924565714,1061,230,42,37,25,18,17,19
0.742273373852321,0.761486102423332,0.711219526488514,1047,244,37,27,20,14,17,13
0.740134965114949,0.753931816496252,0.692204878048781,1067,224,42,41,19,15,23,26
0.728328807276176,0.762766893308623,0.708397678880621,1076,215,37,34,18,14,19,20
0.762214634146342,0.787257766513427,0.76045813586098,1056,235,41,25,23,13,18,12
0.79904226208574,0.827575702235932,0.682821300563236,1085,206,26,31,13,11,13,20
0.730736970528804,0.759543242638187,0.662305204351661,1067,224,42,38,16,14,26,24
0.730093328038125,0.760777018863818,0.654706845883316,1068,223,32,33,14,11,18,22
0.78333128532809,0.810851883769113,0.775486941124391,1079,212,39,36,21,19,18,17
0.774778663125277,0.801634679697976,0.738216560509554,1068,223,36,35,18,19,18,16
0.759668659327841,0.77835937123043,0.715774386827018,1067,224,44,37,22,17,22,20
0.769874119176302,0.799483301731566,0.722606577869736,1051,240,47,37,28,19,19,18
0.700704513803555,0.73379383397249,0.524936419673262,1059,232,39,37,24,13,15,24
0.656796068308181,0.683508636911512,0.624987199180748,1085,206,32,31,9,5,23,26
0.738912492546213,0.758646753240632,0.72826269584576,1045,246,43,38,23,20,20,18
0.705334218680832,0.734155337472063,0.681282267672756,1083,208,36,32,13,14,23,18
0.727275268336315,0.747154527256185,0.679786171063149,1071,220,43,40,17,14,26,26
0.729646544876886,0.754174429091446,0.732603262299395,1084,207,32,24,17,12,15,12
0.74939512195122,0.766737674848361,0.719587716321683,1044,247,41,28,18,10,23,18
0.700011720581341,0.720732598976117,0.649873617693523,1058,233,27,25,8,10,19,15
0.728839545334391,0.761373777585261,0.660678179135472,1055,236,30,29,16,12,14,17
0.744483788601436,0.769356870197351,0.710281248537601,1078,213,33,34,15,12,18,22
0.717242703533026,0.740599454842816,0.63701401936696,1071,220,31,33,13,13,18,20
0.759158372620919,0.797381191017329,0.72956483387239,1047,244,46,38,30,23,16,15
0.779738302934179,0.816925433144867,0.723833802156587,1066,225,30,27,19,13,11,14
0.706571403939825,0.733135354264548,0.670063441712926,1076,215,37,30,13,12,24,18
0.697881723539618,0.719844524180754,0.622570931892966,1073,218,56,52,21,13,35,39
0.779327135900841,0.801424105278537,0.688081009296149,1047,244,36,36,23,19,13,17
0.688733953076582,0.711210081018451,0.630646842732327,1079,212,36,32,12,8,24,24
0.674319896743447,0.697835293430648,0.706281717185571,1070,221,32,23,13,7,19,16
0.766791600476569,0.790904540513991,0.681861239119304,1055,236,32,31,18,15,14,16
0.729382470119522,0.751074660215887,0.739052132701422,1057,234,36,25,16,13,20,12
0.801416555998229,0.818302932689839,0.704162571950021,1063,228,36,34,17,13,19,21
0.720580628475365,0.73613769834367,0.705837173579109,1045,246,37,31,15,12,22,19
0.806146341463415,0.834959162178843,0.74781175059952,1065,226,41,40,27,24,14,16
0.759768985008602,0.79003688230512,0.766980845241715,1080,211,39,26,22,13,17,13
0.750808962070943,0.7819755504232,0.72283310166799,1044,247,39,32,20,14,19,18
0.735261790567546,0.758941554345411,0.708357161920012,1059,232,40,42,19,18,21,24
0.6844907108065,0.720820221520966,0.72480252764613,1057,234,37,25,19,14,18,11
0.745529757139045,0.767167073329084,0.722272511746196,1083,208,42,37,20,17,22,20
0.724257552483359,0.764338740741763,0.725299739848433,1058,233,31,28,15,13,16,15
0.74566346922462,0.787817044208451,0.677531707317073,1071,220,40,41,23,18,17,23
0.782324863119472,0.800639462082864,0.710732745515354,1056,235,34,26,19,12,15,14
0.77538724320277,0.791181771115267,0.708333333333333,1062,229,34,28,19,12,15,16
0.753916866506795,0.777270383793976,0.66527446300716,1073,218,40,34,19,9,21,25
0.734337768069897,0.762265383380546,0.747924927306371,1089,202,32,30,16,16,16,14
0.779616514910633,0.797899976815199,0.788276244158597,1042,249,33,33,19,20,14,13
0.812083973374296,0.829920482879354,0.755779400065515,1058,233,31,34,22,20,9,14
0.709770245677889,0.734883695428819,0.687812417784794,1052,239,35,24,16,11,19,13
0.701205641492265,0.759797269729436,0.733077316948285,1059,232,35,31,20,18,15,13
0.708189262966333,0.736799880261107,0.668001586042823,1066,225,35,30,14,11,21,19
0.791882335787709,0.807188322655042,0.797369562075445,1069,222,44,33,25,18,19,15
0.769871546187336,0.786396898007578,0.663299245432883,1060,231,37,32,21,14,16,18
0.7396,0.756410339906989,0.651609316906029,1051,240,41,44,21,17,20,27
0.716420691711389,0.74233059811515,0.669726829268293,1083,208,43,41,19,16,24,25
0.69097721822542,0.722689776508883,0.645324468853881,1060,231,40,33,17,11,23,22
0.776114649681529,0.801253790323179,0.73536169244768,1077,214,35,35,19,16,16,19
0.747302158273381,0.761124803623912,0.632175609756098,1061,230,40,41,17,11,23,30
0.69975197716318,0.728204133594959,0.640932798827536,1074,217,34,37,13,12,21,25
0.707590243902439,0.74470361812394,0.627483513252405,1054,237,41,38,19,17,22,21
0.772006344171293,0.796487760933378,0.629529884829229,1072,219,30,32,16,12,14,20
0.729758616153644,0.768130508267848,0.622440900350639,1083,208,24,28,11,11,13,17
0.797240857669035,0.822731463748097,0.807042051722903,1049,242,24,22,8,7,16,15
0.707628751746399,0.742864815726545,0.680974776545463,1064,227,33,34,15,12,18,22
0.724803562074385,0.753715388154609,0.700232403718459,1077,214,46,36,23,17,23,19
0.723038010977308,0.736856186318446,0.695873170731707,1067,224,39,41,15,14,24,27
0.788312376547671,0.806951170212834,0.704546362909672,1068,223,33,40,17,16,16,24
0.775937749401436,0.798942973265627,0.724705915620405,1058,233,38,28,18,14,20,14
0.725311883059604,0.752532671656381,0.637688490629667,1060,231,38,33,16,11,22,22
0.726453726453726,0.760160955390064,0.646646306978849,1084,207,33,28,16,11,17,17
0.680331321072582,0.713387467982023,0.630805687203791,1065,226,34,25,12,7,22,18
0.713456393793472,0.740786037848803,0.698082496744655,1019,272,45,38,24,16,21,22
0.744779344858963,0.779742403160163,0.68547107014849,1076,215,35,31,19,13,16,18
0.726323549581676,0.755271924613343,0.722342804525125,1067,224,23,24,9,8,14,16
0.734829308339605,0.76142327505827,0.706346872768513,1067,224,47,38,26,18,21,20
0.693482926829268,0.715369435007618,0.684451774340309,1068,223,41,35,13,11,28,24
0.855005120327701,0.864567623832504,0.775165876777251,1060,231,31,25,21,13,10,12
0.770168515764993,0.79848756918521,0.726764472640761,1039,252,42,30,22,13,20,17
0.768231235107228,0.792791062157213,0.768258900611842,1067,224,32,33,14,14,18,19
0.740216910137229,0.773238957238128,0.676571491810536,1090,201,36,36,17,11,19,25
0.706021960425483,0.733705391844419,0.714294579030977,1061,230,42,32,20,14,22,18
0.743626933895921,0.773745720977666,0.724443623603288,1102,189,27,17,12,6,15,11
0.813671519563239,0.825390636957018,0.720596883269627,1069,222,35,38,21,19,14,19
0.804592870382344,0.841408292107527,0.755710491367862,1080,211,37,36,18,17,19,19
0.794113338021566,0.817613996806733,0.767957629923866,1069,222,27,19,13,9,14,10
0.790413283007358,0.823391764232389,0.733114130172954,1086,205,42,33,26,18,16,15
0.788072417465389,0.80873145367216,0.755604017975152,1093,198,39,30,19,15,20,15
0.713522225992535,0.733817917592996,0.703858939153057,1095,196,28,33,11,12,17,21
0.722686604780107,0.738357391057048,0.661726829268293,1064,227,38,41,16,14,22,27
0.7685551558753,0.799231060168192,0.703167466027178,1064,227,40,40,21,20,19,20
0.756309809752564,0.773749993724824,0.732693219535325,1067,224,42,37,17,14,25,23
0.740668889010328,0.789230813161637,0.66879160266257,1073,218,29,31,15,14,14,17
0.732591604660957,0.754763748539365,0.653834146341464,1065,226,34,41,17,14,17,27
0.721945810971974,0.745318806926206,0.693665067945643,1055,236,43,40,19,17,24,23
0.746897272057016,0.773792143053066,0.681169994879672,1058,233,39,31,18,13,21,18
0.733427071616048,0.758746394538819,0.615470535007352,1082,209,21,28,7,7,14,21
0.711188811188811,0.739660128199045,0.648971989397521,1074,217,26,22,7,5,19,17
0.732857459052678,0.752255284677016,0.680926779313876,1064,227,36,31,16,11,20,20
0.75808224492435,0.784299653236831,0.702920962199313,1066,225,37,30,19,16,18,14
0.774570446735395,0.80821639491173,0.656905938820832,1080,211,30,22,16,10,14,12
0.760754773912669,0.7882896457557,0.704924543288324,1077,214,37,32,21,15,16,17
0.759488043427395,0.791981550794567,0.713132919015272,1073,218,34,33,19,14,15,19
0.777099291805174,0.796982001098721,0.747726671953476,1062,229,33,30,17,15,16,15
0.716954404603807,0.743267794168747,0.653614951636701,1047,244,36,29,19,12,17,17
0.709900057344147,0.731240465584829,0.706819512195122,1071,220,39,41,16,17,23,24
0.755357142857143,0.768373481990632,0.716722069663246,1047,244,35,33,20,14,15,19
0.747563741756626,0.783370997562884,0.659429026387625,1062,229,38,35,21,14,17,21
0.775843902439024,0.795339343811814,0.715337511264029,1081,210,41,39,20,15,21,24
0.834682275858746,0.851590194844448,0.756223426141819,1074,217,33,23,18,11,15,12
0.719714964370546,0.751559848041309,0.625256016385049,1072,219,28,31,14,9,14,22
0.770179706115965,0.801335469378404,0.732990873818241,1037,254,32,29,17,16,15,13
0.762378392217102,0.791484908822105,0.663386494740414,1063,228,31,28,16,12,15,16
0.74740927336774,0.780427516360092,0.768454626687847,1066,225,39,32,21,19,18,13
0.826398999090082,0.843490165358703,0.791766268260292,1072,219,35,36,21,20,14,16
0.718666621057673,0.741207159533933,0.69821618743344,1074,217,47,39,21,16,26,23
0.678009073925807,0.68754937989101,0.616400193798449,1060,231,42,43,13,10,29,33
0.69084772023019,0.71522660235015,0.730999305003971,1036,255,36,32,15,13,21,19
0.755533717066779,0.784203682276188,0.697764609529316,1056,235,34,33,17,15,17,18
0.748240371845949,0.764604184230178,0.695707317073171,1068,223,36,41,15,12,21,29
0.804594420174742,0.822067579650156,0.739848433435132,1057,234,32,28,20,13,12,15
0.688478048780488,0.71878090682927,0.687001875293014,1055,236,41,27,18,13,23,14
0.743958384533464,0.76765064444103,0.685004426737495,1042,249,39,36,21,17,18,19
0.738718940459447,0.768034991522045,0.72847605893186,1053,238,27,24,14,12,13,12
0.71292965627498,0.737066124304814,0.662819758894443,1086,205,40,38,16,13,24,25
0.785011895321174,0.808250039630718,0.728588421887391,1083,208,30,30,14,13,16,17
0.774003984063745,0.807116631896911,0.725682902153491,1063,228,36,33,21,17,15,16
0.77105248275082,0.798972635498689,0.709690220174091,1084,207,28,31,12,11,16,20
0.734468853698492,0.76415954813364,0.684495532179618,1062,229,38,28,18,13,20,15
0.765714918105356,0.784803264557332,0.680280200898758,1048,243,36,30,16,9,20,21
0.78379456011035,0.80314334562884,0.746519246519246,1063,228,37,37,21,19,16,18
0.803192017474186,0.821079246568159,0.748964968152866,1066,225,32,35,17,15,15,20
0.714390725416894,0.744851865725031,0.652861621975759,1065,226,38,34,14,12,24,22
0.729877112135177,0.747192646187044,0.744314381270903,1069,222,31,26,10,9,21,17
0.717952883834281,0.737691549263453,0.67711397687624,1060,231,60,47,30,20,30,27
0.777234272510435,0.796878363981567,0.771175481701798,1055,236,43,37,26,23,17,14
0.730472270009011,0.762002540124384,0.694949954504095,1081,210,39,35,17,15,22,20
0.732498011137629,0.753351944493419,0.708269329237071,1029,262,34,31,18,15,16,16
0.774131633870006,0.801987305410933,0.691909882232463,1050,241,43,31,24,13,19,18
0.77628896882494,0.80078115011375,0.768522785458269,1067,224,40,31,23,18,17,13
0.701334919376157,0.72890868034083,0.690338355802273,1083,208,30,30,8,9,22,21
0.732328720118952,0.753410762391066,0.683433443945058,1063,228,42,38,19,14,23,24
0.758355955208687,0.794491310221865,0.742478226444972,1085,206,28,28,9,9,19,19
0.725295723384895,0.739195505679524,0.716760478714684,1059,232,35,29,15,13,20,16
0.764720462088883,0.783049863319188,0.737305487305487,1084,207,37,33,17,14,20,19
0.77960637936885,0.804633549677242,0.726360595925813,1093,198,28,26,13,9,15,17
0.695243362831858,0.725116446281115,0.718503656144106,1086,205,48,45,22,18,26,27
0.738196748855379,0.775830159396175,0.707437275985663,1052,239,38,31,21,17,17,14
0.713099076452265,0.742421316071821,0.658066690107829,1076,215,29,27,11,9,18,18
0.746125089259462,0.773524061813795,0.708640458640459,1038,253,38,37,22,19,16,18
0.722510424940429,0.75949204478942,0.627479526842584,1073,218,32,35,15,11,17,24
0.768421807159826,0.791267839121897,0.646156589976815,1036,255,39,45,22,20,17,25
0.736996458610004,0.776398285716108,0.703547162270184,1055,236,36,40,20,18,16,22
0.722082427847039,0.751056656019265,0.708755760368664,1066,225,42,31,18,13,24,18
0.746087804878049,0.796051087965447,0.656558566147223,1068,223,41,34,22,15,19,19
0.729903273402918,0.757214626459435,0.691228336880511,1075,216,29,26,11,8,18,18
0.687519201228879,0.713754203989274,0.716830675262979,1078,213,31,28,15,10,16,18
0.78025927746375,0.80123710637197,0.706643729007946,1051,240,39,39,20,18,19,21
0.782792830736113,0.792335281953568,0.709183255509134,1064,227,34,39,19,17,15,22
0.69264416417584,0.710800785328431,0.662084680976183,1050,241,44,38,20,14,24,24
0.706185365853659,0.738816978240059,0.659054805401112,1071,220,41,32,22,14,19,18
0.804259251480657,0.830745746397723,0.728262904207029,1080,211,38,34,24,18,14,16
0.744805559455286,0.772616869126595,0.640181771633385,1076,215,34,31,18,12,16,19
0.762669826224329,0.796895592870737,0.725586097600962,1061,230,25,29,13,12,12,17
0.700271560836918,0.725980967002803,0.635912195121951,1078,213,44,41,20,17,24,24
0.677582534611289,0.702396979806782,0.601308007279345,1086,205,39,35,14,11,25,24
0.715172642762284,0.745883366115538,0.705698362147407,1057,234,36,35,17,13,19,22
0.686908553230209,0.71276860144996,0.693478260869565,1067,224,35,26,16,12,19,14
0.772855172927847,0.789859966139373,0.782080900575461,1067,224,43,38,23,21,20,17
0.743142500445871,0.765717619341913,0.730845969672785,1063,228,45,38,23,18,22,20
0.76499494146553,0.782430834246489,0.744616274028039,1068,223,33,33,17,17,16,16
0.758549696900377,0.792042817159391,0.749374973059184,1073,218,42,37,27,23,15,14
0.75346392208942,0.775420203871197,0.764512291831879,1067,224,36,30,19,17,17,13
0.773819551687023,0.798080562100862,0.734588950568332,1092,199,34,30,16,13,18,17
0.684633421022532,0.713255012273224,0.657487059852738,1063,228,42,44,14,14,28,30
0.686750599520384,0.709673565011642,0.682281563860511,1043,248,40,37,18,13,22,24
0.771326350273719,0.806833701657253,0.698710749216154,1038,253,37,34,23,17,14,17
0.733460304731355,0.765397992840556,0.696808704527229,1047,244,44,44,22,24,22,20
0.723043676069154,0.756304400922177,0.724620234312947,1063,228,35,32,17,15,18,17
0.731409986428939,0.752067635304298,0.742806493202063,1045,246,34,27,12,9,22,18
0.753834146341463,0.782598699720499,0.762414328203802,1085,206,41,37,20,19,21,18
0.699229268292683,0.720775555076957,0.717830129594836,1090,201,41,33,10,9,31,24
0.761700639488409,0.789923780125203,0.705838613733351,1051,240,40,37,22,18,18,19
0.736294358507734,0.755323950898109,0.690893470790378,1061,230,35,30,14,11,21,19
0.746436470877366,0.765086101501145,0.708521469676848,1090,201,39,36,15,13,24,23
0.797561950439648,0.830093115369511,0.79224577659226,1064,227,40,34,27,21,13,13
0.751592356687898,0.781791301793986,0.711708549768356,1064,227,35,34,18,17,17,17
0.778758402098475,0.789132735606544,0.766081294396212,1067,224,29,24,12,8,17,16
0.84023382559775,0.863096076164449,0.713825309129176,1043,248,27,24,17,10,10,14
0.811840527577938,0.828697450292204,0.747698096502877,1082,209,40,36,23,19,17,17
0.720452552518205,0.737326540980733,0.655515587529976,1081,210,42,40,18,15,24,25
0.761840527577938,0.794200133432029,0.700859950859951,1072,219,40,33,24,15,16,18
0.779056754596323,0.796398055842104,0.760970300443985,1055,236,40,37,23,20,17,17
0.736653187998125,0.768278616432255,0.72695102685624,1063,228,27,25,9,7,18,18
0.691018810839253,0.712931328549056,0.632395950506187,1074,217,24,21,6,5,18,16
0.766537761601456,0.814287517650518,0.742908346134153,1077,214,35,31,21,18,14,13
0.771561474946273,0.792491755521642,0.692613185067514,1065,226,28,32,14,10,14,22
0.754536480866972,0.778125469424893,0.727525653996242,1053,238,38,33,16,14,22,19
0.784484730641656,0.80978753676147,0.706205035971223,1050,241,42,40,23,16,19,24
0.71297254191991,0.734738241693542,0.677597145122918,1060,231,37,30,14,11,23,19
0.692212374511698,0.714412048369959,0.626858916332601,1068,223,38,37,15,13,23,24
0.735151426051161,0.761682000764175,0.688179681949833,1080,211,38,29,18,13,20,16
0.750164030035722,0.774522587707695,0.740574282147316,1040,251,44,45,24,21,20,24
0.782693043335701,0.802223577527906,0.760138302859822,1067,224,29,27,13,11,16,16
0.730039892890322,0.758464305268072,0.72267639474918,1051,240,29,27,13,10,16,17
0.777787769784173,0.821315906572898,0.682979194333776,1048,243,40,36,27,20,13,16
0.735562689495274,0.754706168099267,0.739551392447599,1065,226,45,38,21,19,24,19
0.744736715324951,0.783244481143106,0.722279906005793,1066,225,33,29,18,15,15,14
0.769654639898919,0.796014750813519,0.743356374807988,1102,189,34,31,13,12,21,19
0.699962562590669,0.728408759408178,0.715312251787133,1099,192,34,32,12,12,22,20
0.732521409518461,0.747560145079342,0.716910760150828,1079,212,34,29,14,12,20,17
0.724256484794276,0.766633176834443,0.660383095165704,1089,202,43,26,20,11,23,15
0.785712746239062,0.802075881615511,0.731210285941223,1066,225,37,32,22,16,15,16
0.718526386404293,0.737382830131842,0.698564348324732,1053,238,43,39,20,16,23,23
0.741947224749773,0.779292753492388,0.675354138999557,1064,227,35,36,16,13,19,23
0.748696882446386,0.783457059652612,0.695558115719406,1072,219,32,31,17,14,15,17
0.749756529437804,0.784362095402604,0.699295954941116,1059,232,36,31,20,14,16,17
0.767220569852149,0.793055395762222,0.665462253697548,1054,237,37,33,21,15,16,18
0.711912462721048,0.747474443410767,0.721929026387625,1080,211,38,35,19,19,19,16
0.691882070058473,0.714812784428272,0.602543443917851,1062,229,29,25,13,7,16,18
0.770166581614056,0.788785880937204,0.757985257985258,1055,236,44,33,22,15,22,18
0.738071371291099,0.766243519515438,0.726591300073728,1041,250,44,39,21,17,23,22
0.746839532041208,0.765615962464505,0.7269305307096,1076,215,46,43,21,19,25,24
0.672946609104323,0.705830748863846,0.686824644549763,1080,211,29,25,11,9,18,16
0.785590969455511,0.801262369141027,0.706794889793626,1050,241,36,34,22,19,14,15
0.7727474858042,0.801582066004151,0.7164,1041,250,47,41,26,21,21,20
0.752388535031847,0.779031232827351,0.75127698388568,1059,232,35,26,17,11,18,15
0.794682926829268,0.815088579375428,0.774498104731153,1077,214,41,34,21,15,20,19
0.749420367397895,0.770103937780439,0.718907317073171,1066,225,45,41,22,19,23,22
0.744090035063907,0.770182911262047,0.750887924230466,1051,240,28,24,12,11,16,13
0.75484939052977,0.790574941186447,0.674790972184272,1052,239,27,29,16,14,11,15
0.748886328725038,0.768863739414566,0.666370691923178,1089,202,31,24,15,10,16,14
0.75621273166801,0.768700026570725,0.708863920099875,1076,215,50,45,22,18,28,27
0.749397793515441,0.776281751253057,0.738580491673275,1068,223,33,30,13,11,20,19
0.765732206861239,0.791326272403618,0.700871994989642,1046,245,31,33,15,15,16,18
0.771636267512556,0.792922845132733,0.733775671406003,1073,218,30,25,12,7,18,18
0.742984611405664,0.783148196680874,0.705904984114376,1067,224,37,32,19,16,18,16
0.736175609756098,0.75543046613813,0.741237306378399,1075,216,41,34,16,13,25,21
0.724536001788909,0.753928439073172,0.682048299924745,1049,242,43,47,23,22,20,25
0.71032570085797,0.739312729935014,0.689795969023034,1093,198,29,32,9,10,20,22
0.766876936697654,0.778407486440875,0.782172995780591,1065,226,36,27,19,15,17,12
0.718143278446793,0.741637283230488,0.649692902638763,1060,231,39,35,14,9,25,26
0.695348980093389,0.725301471020308,0.637815013915895,1091,200,39,42,14,10,25,32
0.79327455798044,0.820056405997668,0.768240154711674,1072,219,33,27,14,12,19,15
0.716453295400664,0.748028104009535,0.727534562211982,1059,232,37,31,16,13,21,18
0.754924931756142,0.786509282735828,0.724881838176798,1070,221,35,34,17,14,18,20
0.703786970423661,0.719319311122987,0.662523486052898,1068,223,40,33,16,11,24,22
0.774464710547185,0.804040050008057,0.71404814154437,1082,209,30,23,17,11,13,12
0.759178187403994,0.783381765014342,0.696761829236056,1084,207,31,30,16,13,15,17
0.747434600375777,0.770027445623019,0.741263547449114,1044,247,33,30,20,18,13,12
0.786022576361222,0.802023902044094,0.748169482846902,1056,235,36,31,21,17,15,14
0.77833415253543,0.809264162180971,0.717792128784688,1044,247,39,34,27,18,12,16
0.795230195789301,0.811166101559324,0.797633186291143,1075,216,39,28,24,15,15,13
0.694162826420891,0.72689170579974,0.658548923254806,1076,215,31,33,14,13,17,20
0.76368213132919,0.789588494809586,0.691585970997736,1040,251,33,33,19,18,14,15
0.826780487804878,0.841521159814686,0.792800272975432,1067,224,41,35,25,21,16,14
0.708695652173913,0.738271956806632,0.657277690081557,1033,258,26,24,13,12,13,12
0.748666292292573,0.772768188019591,0.735763838705015,1070,221,34,33,14,12,20,21
0.766640042598509,0.795120876531672,0.731652002841685,1052,239,39,29,21,14,18,15
0.770576846703733,0.789404195231237,0.771235213830755,1070,221,32,35,17,17,15,18
0.786853558627752,0.816988203296196,0.747530281969817,1054,237,31,32,19,17,12,15
0.778702793479151,0.808967440320327,0.763080072793448,1075,216,39,35,23,22,16,13
0.758787073926516,0.779933500427485,0.747214681597104,1060,231,36,28,18,12,18,16
0.803924021838035,0.818207503981868,0.799352290679305,1049,242,35,25,21,13,14,12
0.72367197875166,0.758095514798096,0.675164008596313,1088,203,36,28,18,10,18,18
0.728697843413033,0.753012859067327,0.643503867791843,1056,235,27,27,15,12,12,15
0.781374957845546,0.803965611185338,0.718531468531469,1071,220,33,26,18,11,15,15
0.743566377487789,0.771144183171518,0.698205500894454,1069,222,44,43,24,19,20,24
0.740738523636861,0.761164939759501,0.741882926829268,1058,233,47,41,22,16,25,25
0.697184773988898,0.717121946455324,0.637716631194892,1076,215,30,26,13,10,17,16
0.7520798310272,0.776415426040697,0.658310805275662,1037,254,37,39,22,17,15,22
0.746599483717236,0.791684702193385,0.694726407613005,1071,220,32,30,18,13,14,17
0.751915818368981,0.774663014042121,0.709565514103731,1061,230,42,35,20,17,22,18
0.696045301875973,0.724473799823927,0.653937947494033,1053,238,39,34,17,15,22,19
0.70957929711264,0.73165442836086,0.710722768917543,1075,216,34,28,13,11,21,17
0.752854447974583,0.768688661227379,0.688439258975901,1074,217,32,29,15,10,17,19
0.684750028277344,0.713128411575904,0.705751775848461,1047,244,28,24,11,8,17,16
0.6856,0.712744853166116,0.62588734405847,1053,238,41,38,17,13,24,25
0.708963748437433,0.733925724821897,0.712429595494111,1087,204,37,31,15,13,22,18
0.70796178343949,0.723366088279988,0.669162249303241,1054,237,35,29,14,10,21,19
0.731125099920064,0.753592156080952,0.723242811501597,1070,221,40,39,18,16,22,23
0.740517073170732,0.778082299501915,0.737424026897711,1068,223,41,37,21,18,20,19
0.688985736925515,0.716265652959503,0.685768656356892,1063,228,29,33,15,14,14,19
0.757868525896414,0.792837246185486,0.72958491272404,1062,229,36,34,22,16,14,18
0.725154366362834,0.74818724846617,0.689624805439502,1084,207,38,39,16,14,22,25
0.802767785771383,0.819983475324755,0.771002293765872,1063,228,40,39,25,23,15,16
0.72720046249458,0.737105834556596,0.7091392376428,1063,228,33,28,17,13,16,15
0.748060895119719,0.779138878801961,0.715424266455194,1065,226,33,30,17,15,16,15
0.697267176330421,0.736673328696167,0.759462875197472,1072,219,32,25,12,9,20,16
0.754656277785577,0.796871190988989,0.690300157977883,1068,223,34,25,19,11,15,14
0.68036924983597,0.704285887312989,0.606521128737891,1058,233,44,34,17,9,27,25
0.775803076575048,0.818441693927063,0.74344508918977,1072,219,28,22,14,9,14,13
0.739014634146341,0.758682510349306,0.683359196517091,1078,213,41,37,16,13,25,24
0.706641503679134,0.743614374838826,0.784599636032757,1059,232,42,35,22,22,20,13
0.781254516548634,0.823057945659685,0.649213165210485,1082,209,33,32,18,14,15,18
0.740484503642398,0.769085943096616,0.734354675531146,1055,236,37,33,19,16,18,17
0.747078353253652,0.797931386478246,0.697606638321218,1084,207,36,23,19,10,17,13
0.728618823118561,0.74990379115975,0.723264166001596,1070,221,46,38,20,16,26,22
0.774217087260565,0.793146997207446,0.739889415481833,1063,228,26,25,13,10,13,15
0.814593693644461,0.828295055408563,0.802815387921771,1072,219,29,22,16,11,13,11
0.734891590154748,0.776789754102985,0.728031507443272,1057,234,37,33,20,17,17,16
0.740169574834112,0.756653316419316,0.74193585077343,1078,213,39,35,17,16,22,19
0.764562835420393,0.769012422942861,0.673683045595396,1070,221,43,36,19,13,24,23
0.756224028577677,0.777109723514108,0.729556354916067,1067,224,44,40,24,20,20,20
0.720436145818709,0.765380493742388,0.607459052678176,1081,210,34,36,16,11,18,25
0.710956097560976,0.726104833252244,0.646324131618249,1093,198,41,33,13,7,28,26
0.772214634146342,0.793785695709283,0.7100747679254,1080,211,41,38,19,17,22,21
0.795912195121951,0.813815990210512,0.761752988047809,1078,213,41,36,21,16,20,20
0.808281543575661,0.831718696194263,0.756772423933944,1068,223,33,28,20,15,13,13
0.731865568272946,0.755639801159295,0.694575124963246,1053,238,44,38,20,15,24,23
0.796215139442231,0.816354599531007,0.706145083932854,1077,214,36,40,22,18,14,22
0.72774468550194,0.77352587927171,0.650876812641519,1074,217,29,33,16,8,13,25
0.729177298243056,0.756924874379623,0.714653253244844,1077,214,44,38,17,16,27,22
0.815727418065547,0.835400839947511,0.717784417884019,1053,238,40,36,29,21,11,15
0.745805781736707,0.774745052549343,0.694932108078453,1064,227,29,23,15,10,14,13
0.720892414244934,0.748825932512311,0.63088926246821,1044,247,34,37,17,10,17,27
0.73458436594279,0.770069676241763,0.724319323288395,1064,227,38,30,22,16,16,14
0.754736211031175,0.7830969556754,0.731199113552055,1066,225,40,33,20,15,20,18
0.716556754596323,0.743350707766527,0.676904176904177,1071,220,40,33,22,14,18,19
0.728953156441574,0.752312850224817,0.706736393841546,1066,225,34,34,14,13,20,21
0.759497057249866,0.7900187025633,0.769259041458395,1067,224,45,38,24,22,21,16
0.758409756097561,0.784589073044209,0.737250996015936,1094,197,41,36,14,10,27,26
0.795770552471583,0.813755266219595,0.773666714843185,1078,213,30,33,15,14,15,19
0.786250637894583,0.809613823039437,0.727058432934927,1061,230,44,36,23,16,21,20
0.743459495351926,0.778833699403841,0.709731386588048,1048,243,36,34,22,16,14,18
0.671543778801843,0.707914213938955,0.664149983033593,1050,241,31,28,13,12,18,16
0.669977537554401,0.688120251510214,0.618253968253968,1074,217,34,31,9,7,25,24
0.777265002344116,0.807760109957389,0.748114113290358,1066,225,27,23,14,10,13,13
0.705048649722002,0.744207972412506,0.709450171821306,1074,217,32,30,15,12,17,18
0.759769822418279,0.800854372173459,0.761546338965694,1086,205,28,31,15,16,13,15
0.751541463414634,0.775715709581278,0.718085687742499,1067,224,41,29,18,11,23,18
0.742809364548495,0.761461707190223,0.675133689839572,1053,238,26,33,8,8,18,25
0.788307938068321,0.808105702761925,0.72084739872915,1042,249,39,32,22,15,17,17
0.755849353492509,0.788331052783383,0.738900323434284,1072,219,47,38,23,19,24,19
0.731403548680619,0.774860668296868,0.723019034971226,1071,220,35,36,17,17,18,19
0.706800918082955,0.748689362986208,0.690094786729858,1064,227,29,25,13,4,16,21
0.759190136862346,0.799830407431688,0.728015653775322,1067,224,28,24,15,11,13,13
0.737618666361661,0.759725027282544,0.68752766710934,1054,237,42,36,23,16,19,20
0.76634363541121,0.785431689581428,0.781282815978494,1059,232,46,38,23,21,23,17
0.775246852917778,0.807151668080546,0.774213165210485,1067,224,34,32,21,19,13,13
0.791341477208461,0.803386358081673,0.722307229903273,1057,234,28,29,14,12,14,17
0.747704642441485,0.787139062406693,0.711859957155458,1074,217,37,38,19,16,18,22
0.837655300026434,0.865068048228714,0.795007032348805,1056,235,30,27,21,17,9,10
0.748620630199578,0.777598613563538,0.745494111623144,1082,209,37,31,19,14,18,17
0.735531893916987,0.764452362101028,0.732771535580524,1048,243,49,45,27,25,22,20
0.756467697644168,0.789923439538993,0.680448312976742,1060,231,33,34,20,18,13,16
0.741725682902153,0.77036436847134,0.684918107370337,1078,213,33,35,9,7,24,28
0.756530411497896,0.790652438901467,0.762206830338774,1051,240,29,23,18,14,11,9
0.691710849605586,0.717328675844666,0.647528416600582,1069,222,37,30,13,10,24,20
0.722177848775293,0.745897556833363,0.677852493641967,1057,234,39,37,19,15,20,22
0.703830951657039,0.732925098339388,0.738478946646551,1079,212,26,23,10,11,16,12
0.691301349196086,0.711062146564052,0.674190647482015,1083,208,37,40,8,11,29,29
0.726715309779826,0.758960506757445,0.657052369641443,1080,211,31,28,14,11,17,17
0.746515490159558,0.764875405217838,0.70174011633639,1071,220,52,49,28,26,24,23
0.744597361237489,0.7726428834943,0.708406026962728,1052,239,35,30,18,15,17,15
0.729605055292259,0.783937163628108,0.676303317535545,1054,237,25,25,12,10,13,15
0.773733272332152,0.790304563921324,0.716655599822931,1047,244,42,36,22,16,20,20
0.779386490807354,0.817057267136045,0.713770787253215,1066,225,40,39,24,19,16,20
0.757392651615759,0.775912510190667,0.709402696685849,1097,194,36,38,14,14,22,24
0.717938526762056,0.751859677987925,0.672834622597281,1069,222,33,27,16,11,17,16
0.760338065925338,0.781564463801472,0.703838862559242,1069,222,32,25,15,9,17,16
0.74660671869698,0.786253666891188,0.71329632566746,1062,229,28,30,15,13,13,17
0.751980982567353,0.773976809421685,0.732243285939968,1078,213,29,25,14,11,15,14
0.783858166922683,0.813840446884182,0.726782425677453,1075,216,31,24,16,12,15,12
0.670193844924061,0.697512430866649,0.634645131938126,1062,229,40,35,13,10,27,25
0.703263071684124,0.728001452253125,0.688689685701638,1071,220,37,36,16,15,21,21
0.694078773460217,0.72236190724762,0.762527646129542,1063,228,30,25,12,10,18,15
0.750307219662058,0.792357724921953,0.699814961670632,1071,220,31,30,17,14,14,16
0.726191939051364,0.752424740931965,0.745320099536252,1075,216,39,28,17,14,22,14
0.807735395376797,0.827145263088837,0.747882397945243,1071,220,29,29,17,14,12,15
0.69350376272687,0.714913805276786,0.674193548387097,1065,226,36,31,12,10,24,21
0.660887266601151,0.709993784420776,0.592640548915449,1069,222,34,36,14,12,20,24
0.648338723904734,0.672952306250002,0.605966732473642,1060,231,38,38,13,11,25,27
0.785450970754485,0.81020681333975,0.77489350372737,1051,240,39,39,24,23,15,16
0.733810590742664,0.750714245699799,0.659168838293787,1076,215,29,23,12,7,17,16
0.729919579030977,0.753689643801934,0.642654125644632,1088,203,32,27,11,6,21,21
0.81593096158052,0.827466703210423,0.73700487804878,1089,202,44,41,23,17,21,24
0.816221284575715,0.841210248938159,0.786123302701961,1060,231,27,23,17,15,10,8
0.766918296541996,0.791134067846119,0.738606253312136,1079,212,42,33,24,18,18,15
0.765067206243677,0.785233082215821,0.720175965899776,1040,251,33,29,16,14,17,15
0.735847738781212,0.7621849213181,0.715577351199227,1045,246,46,38,22,16,24,22
0.784815741583258,0.826039569116053,0.772593445980543,1061,230,35,31,23,19,12,12
0.707379849314428,0.73836310191061,0.694050433412135,1062,229,34,22,14,7,20,15
0.732428115015974,0.753283133221597,0.702293443104969,1079,212,39,38,14,14,25,24
0.716924715327271,0.747147634720688,0.71483177216785,1092,199,39,38,16,14,23,24
0.738815573962282,0.757928251934145,0.711282984531392,1085,206,34,35,13,12,21,23
0.719126727433108,0.756992300574045,0.698328025477707,1059,232,38,35,20,16,18,19
0.753287472506903,0.77499084960808,0.730756013745705,1057,234,34,30,18,16,16,14
0.807165605095541,0.82006424941756,0.751139272913466,1057,234,35,31,19,14,16,17
0.75834440017707,0.800163264919424,0.717852281682069,1073,218,36,22,18,9,18,13
0.762638682374471,0.776317450480372,0.709653433337644,1074,217,42,37,20,15,22,22
0.759099181073703,0.777577928018691,0.769808452417148,1064,227,35,26,17,14,18,12
0.739748201438849,0.768215506752558,0.687560867640549,1075,216,40,36,20,15,20,21
0.713523659856819,0.740957098294637,0.695750332005312,1076,215,46,36,22,15,24,21
0.744117453744783,0.763544037733153,0.679354059146391,1066,225,49,39,22,16,27,23
0.679576338928857,0.715573513888655,0.619787516600266,1088,203,40,36,18,11,22,25
0.720166337631789,0.746893203624892,0.705894052131593,1070,221,38,34,18,14,20,20
0.720772465692784,0.758706994217503,0.726540513294409,1060,231,36,38,18,19,18,19
0.733280949886502,0.750252033199259,0.730271259492372,1072,219,46,47,19,20,27,27
0.748525902007581,0.77806529726094,0.651955917394757,1092,199,34,32,14,9,20,23
0.739941845096484,0.764891510442549,0.730939404594468,1085,206,30,27,12,12,18,15
0.742821698704052,0.75838853197453,0.732356616679821,1062,229,33,24,13,8,20,16
0.663648275539333,0.695911003509018,0.552338072669826,1071,220,34,25,13,5,21,20
0.782290201593999,0.804525898230079,0.697501982553529,1038,253,27,30,14,13,13,17
0.733205612108735,0.757062704884111,0.732380706064917,1092,199,42,37,18,15,24,22
0.692322894496808,0.710727048796047,0.662937062937063,1081,210,26,26,10,9,16,17
0.808176166673667,0.846871733940952,0.785151878497202,1056,235,38,40,25,25,13,15
0.740297998180164,0.772555909450594,0.68946319737459,1069,222,35,27,17,11,18,16
0.707428458319194,0.726804377257139,0.691365156582548,1046,245,28,26,11,11,17,15
0.698997720568517,0.724645223013305,0.66890487609912,1044,247,48,40,22,14,26,26
0.76327340698114,0.785367236525086,0.717922283901665,1049,242,38,30,19,14,19,16
0.745211492418196,0.774214244039674,0.750341219290264,1063,228,38,35,21,16,17,19
0.717877094972067,0.729155271858521,0.687982591604661,1066,225,38,34,15,13,23,21
0.730146021579168,0.756171359978074,0.740797017112807,1069,222,42,37,21,20,21,17
0.678306851702869,0.718532624113332,0.677250803858521,1056,235,48,47,27,27,21,20
0.753709591944886,0.775424306242746,0.734510271889185,1061,230,33,34,17,16,16,18
0.76075202752519,0.798557934301466,0.764683803457689,1056,235,39,35,21,19,18,16
0.782967032967033,0.800373181269572,0.761204411370341,1061,230,52,48,32,27,20,21
0.738845957570898,0.754254211252448,0.676527811911199,1060,231,44,39,17,13,27,26
0.732913669064748,0.764392312230242,0.645075254537406,1060,231,40,36,17,13,23,23
0.777712437518377,0.79041799613656,0.732665988010406,1050,241,38,28,19,13,19,15
0.789240218380346,0.795661203534977,0.757869282474452,1073,218,35,29,14,9,21,20
0.787948207171315,0.811056517837376,0.721872501998401,1070,221,36,40,19,19,17,21
0.806268944048497,0.82577703022285,0.754375188585715,1081,210,39,37,22,18,17,19
0.739575653313672,0.762984597868264,0.739667813549603,1066,225,39,39,15,13,24,26
0.742281475541299,0.766087947987875,0.692112030411449,1087,204,44,43,22,18,22,25
0.79687696895871,0.82687764368979,0.726008093655153,1061,230,38,33,27,18,11,15
0.727076070063427,0.745329726814832,0.68427951175555,1044,247,38,39,18,17,20,22
0.749906827668456,0.768011320612355,0.691939051363971,1059,232,43,39,22,16,21,23
0.743949114237807,0.764396359094848,0.677809388335704,1056,235,44,37,23,16,21,21
0.752866858617951,0.774327849958472,0.621337579617834,1066,225,32,35,16,13,16,22
0.794059784687688,0.830116295222791,0.781058451816746,1044,247,29,25,18,14,11,11
0.777566150569346,0.799313749114821,0.726556294678316,1061,230,39,32,25,19,14,13
0.760635236830456,0.796463369063198,0.752742752184273,1064,227,36,32,21,19,15,13
0.798399630360818,0.826015311097536,0.757398873527906,1063,228,38,31,21,15,17,16
0.804424476797088,0.825934333062887,0.736211775218427,1102,189,35,32,14,9,21,23
0.768275379696243,0.794916712513215,0.669963955107725,1083,208,40,39,21,14,19,25
0.772696429407085,0.807601298758348,0.726177918424754,1076,215,34,27,21,15,13,12
0.666465863453815,0.687363075091716,0.64650749127728,1050,241,46,47,17,16,29,31
0.774523431294678,0.795486313232588,0.701660544082605,1079,212,32,32,14,12,18,20
0.729566481628337,0.763405763271091,0.672250034288849,1068,223,30,23,16,9,14,14
0.733660267988407,0.761903534706311,0.6921279851358,1073,218,38,29,19,13,19,16
0.669797257006559,0.700777426286753,0.581814548361311,1071,220,43,40,18,13,25,27
0.791936866428145,0.813871061863979,0.780336000748748,1059,232,43,34,26,19,17,15
0.715733071271468,0.740666825037268,0.739859476701582,1059,232,34,37,13,12,21,25
0.758419243986254,0.790749847462834,0.758399598825131,1049,242,30,22,17,11,13,11
0.750714075692023,0.776005507818631,0.66562980030722,1043,248,38,31,20,10,18,21
0.814884240989213,0.846583669571749,0.736271721958926,1097,194,24,25,16,12,8,13
0.790036396724295,0.804245497984751,0.779434311393074,1090,201,35,30,19,16,16,14
0.758863920099875,0.785702708012081,0.684485896269336,1064,227,45,35,22,16,23,19
0.807289899332655,0.836168712317173,0.815373078365204,1070,221,28,21,17,13,11,8
0.697601785860572,0.728299110275959,0.662701421800948,1084,207,39,25,16,9,23,16
0.772775449246038,0.800836815152929,0.740309779825909,1068,223,33,31,17,13,16,18
0.734378763790529,0.76599185669346,0.64132149225072,1099,192,33,23,12,6,21,17
0.729002249418582,0.746090665068895,0.717663785259327,1068,223,42,35,20,13,22,22
0.730021453472781,0.745015730274747,0.697443559096946,1069,222,48,36,19,12,29,24
0.672964058234759,0.695446445693622,0.68540260127085,1067,224,35,32,14,11,21,21
0.695107398568019,0.726610298450778,0.691953820909517,1061,230,34,27,12,7,22,20
0.716397849462366,0.747949709358448,0.757457824715402,1075,216,31,23,16,11,15,12
0.684552086868001,0.707605139767491,0.525019825535289,1078,213,28,30,8,7,20,23
0.775580711555425,0.799657710528495,0.71948376527912,1043,248,38,38,23,18,15,20
0.752059488226289,0.778706745809166,0.69867829764737,1073,218,44,30,24,13,20,17
0.855807236242019,0.88018946852642,0.740726124704025,1069,222,26,24,15,9,11,15
0.721075978161965,0.75026426144742,0.663175138999206,1070,221,35,32,16,13,19,19
0.679953877322298,0.701706961641633,0.657759303246239,1078,213,37,28,12,7,25,21
0.798152430505372,0.819530424345874,0.699325931800159,1056,235,33,30,17,11,16,19
0.706159132963257,0.751323487751706,0.737302099004227,1087,204,30,22,15,10,15,12
0.760834440017707,0.78637179616069,0.717552207242929,1047,244,36,30,16,12,20,18
0.784629603631429,0.794708831824216,0.741190509616734,1087,204,34,34,15,14,19,20
0.764012638230648,0.797571047831812,0.702579375922182,1082,209,25,29,11,11,14,18
0.847298578199052,0.857712185314528,0.705092733353603,1065,226,25,26,16,12,9,14
0.782483017777136,0.796545854272227,0.682995905368517,1083,208,33,35,17,15,16,20
0.764979646544877,0.798055336746938,0.70460567519391,1063,228,32,33,18,15,14,18
0.756724427777059,0.774312261959209,0.709152585765489,1063,228,37,31,19,12,18,19
0.725075298333905,0.748088900973343,0.701387990861675,1052,239,42,37,18,15,24,22
0.755720904113435,0.776741016193053,0.751353503184713,1051,240,34,35,15,14,19,21
0.711692447679709,0.737602585565619,0.646292840176451,1078,213,35,28,15,10,20,18
0.770224738318396,0.797082218933719,0.710302077876724,1049,242,47,46,29,26,18,20
0.742029655143445,0.763167835769083,0.704961775218427,1074,217,38,32,14,12,24,20
0.742585214696769,0.771139737972546,0.75905017921147,1088,203,36,31,19,18,17,13
0.748760722444933,0.774901725279678,0.720959167514987,1046,245,37,28,22,16,15,12
0.766022140587768,0.792023219961765,0.687599364069952,1070,221,32,33,14,11,18,22
0.778509119746233,0.812486206776724,0.738236849061591,1091,200,30,30,16,15,14,15
0.782847481833074,0.805147085423482,0.74805793439094,1065,226,38,34,17,15,21,19
0.770971134209163,0.790919310683169,0.676145889067237,1065,226,53,45,29,20,24,25
0.740188953488372,0.763057318243636,0.642255504352278,1056,235,43,31,22,12,21,19
0.718081019731098,0.749183915103306,0.681464990396368,1063,228,46,46,24,21,22,25
0.706818288174458,0.724602358456573,0.629915514592934,1081,210,34,31,12,8,22,23
0.834260731319555,0.848698547225607,0.764151852387147,1046,245,33,33,22,18,11,15
0.762233796782459,0.774736676911735,0.621415770609319,1072,219,38,31,16,10,22,21
0.760716458421077,0.796166479904057,0.724205373965757,1061,230,34,39,16,16,18,23
0.790655564366905,0.804860771520965,0.772674245432883,1063,228,30,32,14,17,16,15
0.730020690547006,0.762387387137593,0.688936262465674,1064,227,37,33,21,17,16,16
0.803639672429481,0.819211627157196,0.665344658149656,1083,208,35,34,18,16,17,18
0.720440460380699,0.750773625543805,0.699237943585077,1062,229,36,35,18,16,18,19
0.712618155876583,0.744256293910425,0.700008192020972,1102,189,45,39,22,21,23,18
0.669684038105091,0.70379524452034,0.639331562638336,1105,186,37,36,17,13,20,23
0.75709399238811,0.767702986882378,0.745097286226318,1053,238,33,31,16,16,17,15
0.695864773629865,0.721364219339198,0.674805972112602,1068,223,32,24,12,9,20,15
0.759427795655672,0.79877093719573,0.734993909354391,1047,244,48,38,26,19,22,19
0.749399519615693,0.768673374248296,0.645935796256052,1055,236,42,42,20,17,22,25
0.775830854778223,0.807401308018671,0.67137548499918,1088,203,37,29,17,10,20,19
0.688294281175536,0.719528577382669,0.668835304822566,1080,211,32,35,13,13,19,22
0.723885872638842,0.756815270576871,0.642558815754692,1072,219,28,30,15,11,13,19
0.709849490925188,0.738616213427009,0.634049323786794,1072,219,36,34,15,11,21,23
0.753556553886471,0.791711533247862,0.727899022016669,1072,219,34,33,15,14,19,19
0.72841801990571,0.750595852237218,0.678934218071598,1063,228,46,39,21,16,25,23
0.799409457304194,0.812469660230865,0.76408809207614,1064,227,37,36,19,16,18,20
0.742895086321381,0.779144659766398,0.69633637807784,1051,240,36,32,20,17,16,15
0.732510021983706,0.74977029249415,0.68065194819389,1057,234,37,29,17,11,20,18
0.762286536934075,0.787346775876402,0.73874561701165,1059,232,32,28,19,15,13,13
0.61905022132357,0.64666829640785,0.60857784826857,1038,253,29,30,12,12,17,18
0.710482411491913,0.728989047151436,0.648043880518107,1089,202,28,30,10,12,18,18
0.670009290125143,0.707281827717538,0.607238376080099,1104,187,29,23,14,9,15,14
0.778945281522601,0.812108501933156,0.759197324414716,1068,223,30,26,16,13,14,13
0.759189670954377,0.797777518543779,0.678120174083954,1065,226,33,34,19,16,14,18
0.691319779896669,0.717654821767157,0.680108379592916,1048,243,38,30,15,10,23,20
0.667179114490161,0.695112648746972,0.660321742605915,1048,243,43,40,18,16,25,24
0.791017347838871,0.800287115914229,0.68361782835467,1087,204,38,37,21,19,17,18
0.763800984528833,0.822156146462313,0.668578199052133,1071,220,27,25,16,11,11,14
0.780600243625824,0.806606806624637,0.704551182425337,1090,201,38,38,22,18,16,20
0.770099209134728,0.80385471823299,0.731269468276955,1075,216,34,29,20,16,14,13
0.798091526778577,0.823155164814562,0.772772931535818,1063,228,40,30,25,18,15,12
0.747047286520971,0.805222490111259,0.721138068448195,1072,219,37,27,22,14,15,13
0.758300290774518,0.775470705901515,0.726344086021505,1072,219,30,31,13,12,17,19
0.721790615316512,0.757952126003035,0.715073041168659,1082,209,36,36,17,17,19,19
0.74085123309467,0.76907113431053,0.716891356066614,1080,211,34,30,18,14,16,16
0.676605671794124,0.694060689069795,0.688673010837959,1063,228,44,30,17,11,27,19
0.727821522309711,0.763712866406658,0.716112420354369,1100,191,21,18,7,6,14,12
0.783015499642962,0.816567086955939,0.733615463799611,1053,238,38,42,21,20,17,22
0.783412635474491,0.822508198269745,0.778884159318942,1084,207,30,26,17,13,13,13
0.711341016238868,0.72495295798833,0.691658536585366,1069,222,46,41,14,13,32,28
0.758758092609024,0.78951661645093,0.797736578707916,1067,224,49,35,28,21,21,14
0.73766801406553,0.750696604489337,0.739648780487805,1054,237,49,41,23,16,26,25
0.760556425163983,0.802264777288862,0.764167719593804,1066,225,43,34,23,17,20,17
0.789862225395892,0.800969926568894,0.721381056393964,1064,227,38,32,19,14,19,18
0.712625113739763,0.737863479743318,0.706515616999488,1070,221,35,31,15,14,20,17
0.764859075061956,0.777003486773857,0.751680419695065,1082,209,38,29,15,11,23,18
0.753087600415323,0.784197337212851,0.681408681408681,1072,219,29,33,10,9,19,24
0.723244147157191,0.761058015260724,0.73306477093207,1066,225,26,25,12,11,14,14
0.684369409660107,0.708753819437705,0.695773524720893,1082,209,43,37,17,14,26,23
0.71887032030802,0.751028556940526,0.711853558627752,1083,208,39,31,21,15,18,16
0.762597525755421,0.792316121978929,0.699169699727024,1040,251,37,35,15,12,22,23
0.77701961322178,0.814631864890719,0.721292624900872,1073,218,23,30,12,13,11,17
0.717834849295523,0.739168424394005,0.745073950956304,1047,244,45,33,21,20,24,13
0.726434047052604,0.745184745529351,0.690913619315518,1084,207,30,27,10,8,20,19
0.747651878497202,0.782169084044292,0.695635700827394,1072,219,40,39,19,15,21,24
0.701500823841249,0.749090210351696,0.573859158965542,1070,221,22,22,11,6,11,16
0.58817076394396,0.610351570490381,0.606905281969817,1053,238,30,32,9,9,21,23
0.78542137493621,0.800872156281431,0.736001551791025,1052,239,44,37,24,17,20,20
0.750126013357416,0.777876866733492,0.702355540111199,1050,241,38,32,22,15,16,17
0.744222328898642,0.797702668722268,0.696792338096686,1086,205,23,26,8,11,15,15
0.726980965028774,0.754423458662238,0.695259430553548,1072,219,36,33,16,14,20,19
0.651946918107211,0.683684405662699,0.663053658536585,1066,225,46,41,17,12,29,29
0.768202764976958,0.806002100494136,0.72480997263606,1079,212,31,26,17,13,14,13
0.748631802979629,0.777779461547552,0.737503288608261,1087,204,26,24,11,8,15,16
0.7318708756911,0.754299541525777,0.716830466830467,1071,220,45,33,25,15,20,18
0.848131080389145,0.861106112925873,0.797717416783873,1039,252,31,27,20,17,11,10
0.700625568698817,0.718913533779724,0.647766323024055,1055,236,35,30,11,8,24,22
0.831277303415409,0.857532077403149,0.780782447792757,1066,225,32,30,21,17,11,13
0.793834392374901,0.820168187546994,0.738556067588326,1064,227,32,31,20,16,12,15
0.806655586067351,0.825415875725173,0.754849498327759,1051,240,33,26,18,14,15,12
0.755273613500451,0.797756912279931,0.73283331178068,1036,255,39,37,22,22,17,15
0.754527074542897,0.812928516192016,0.690157977883096,1051,240,27,25,13,9,14,16
0.670187152501986,0.705479183503551,0.652489575059571,1074,217,32,32,14,11,18,21
0.686325543916197,0.708938588276111,0.712716064553125,1082,209,50,39,20,16,30,23
0.769101372288623,0.792789174877088,0.745641838351823,1049,242,36,29,18,13,18,16
0.773943729826083,0.810960419133351,0.716013851841453,1059,232,33,34,18,15,15,19
0.702654028436019,0.725324184965295,0.709534692920769,1081,210,25,27,10,11,15,16
0.708048053093628,0.736633426515269,0.653008192524322,1057,234,38,31,14,10,24,21
0.662242975342017,0.683537459487093,0.661011191047162,1061,230,39,40,16,15,23,25
0.785284758294726,0.805635823100096,0.728139252052296,1069,222,34,26,20,14,14,12
0.699319107117788,0.74100283209464,0.70673339399454,1078,213,34,35,14,12,20,23
0.698702062418616,0.722313720211225,0.666537761601456,1069,222,38,35,17,13,21,22
0.751972067761541,0.784294108719161,0.744989642048466,1064,227,37,33,20,17,17,16
0.6561199645861,0.677537130710126,0.59596762537939,1065,226,36,33,12,11,24,22
0.711921755220724,0.75301432157476,0.709167514986992,1067,224,30,28,12,11,18,17
0.785094720040324,0.801093477612093,0.767753047164812,1068,223,38,33,22,19,16,14
0.787077280872317,0.80855458052812,0.723274076215253,1060,231,42,33,26,17,16,16
0.811282984531392,0.836789183961765,0.781401990725031,1099,192,35,28,23,15,12,13
0.733378056052475,0.748657734781322,0.749698262856158,1051,240,43,37,20,20,23,17
0.674368065881277,0.69824855276738,0.675904145839459,1081,210,42,38,17,13,25,25
0.710175955823857,0.753466050548529,0.713394977943671,1071,220,34,28,16,12,18,16
0.749337572866985,0.772520396219117,0.729630034428111,1084,207,33,29,15,12,18,17
0.768945469125902,0.790151905934302,0.732395440161653,1051,240,44,42,27,26,17,16
0.767979124542325,0.793192621939037,0.684037378392217,1068,223,29,31,14,12,15,19
0.819495109701295,0.848687880874478,0.719260615334171,1083,208,30,29,18,10,12,19
0.751728617106315,0.770143342004582,0.719395232553127,1071,220,40,37,20,15,20,22
0.755944698173153,0.77069717805686,0.759372096835893,1068,223,32,29,17,17,15,12
0.700524496015002,0.739618390260317,0.679636650868878,1095,196,27,25,9,8,18,17
0.734229747675963,0.759436822680533,0.674879498338715,1059,232,36,34,15,12,21,22
0.76879598917229,0.793008581020566,0.733684641579378,1078,213,42,37,23,20,19,17
0.773103357123976,0.784899866197766,0.75698269079465,1087,204,30,20,11,5,19,15
0.731169994879672,0.754202563850602,0.766872037914692,1063,228,31,25,13,11,18,14
0.735920651664323,0.757490288406114,0.612404630360431,1067,224,27,24,12,8,15,16
0.762394864984506,0.78468096266792,0.733355012766778,1044,247,36,33,19,16,17,17
0.694143187239117,0.720627355649564,0.653541226215645,1054,237,43,44,16,12,27,32
0.728830683594495,0.755984957248939,0.721219512195122,1058,233,42,41,19,18,23,23
0.754265241128298,0.779017641338926,0.734989938696242,1054,237,35,34,16,14,19,20
0.775129163691351,0.798654931297183,0.802493553680263,1066,225,38,27,19,12,19,15
0.747043010752688,0.770518841337361,0.612685216604457,1071,220,31,28,15,10,16,18
0.692333939945405,0.710579709075655,0.671470509741126,1092,199,35,42,12,15,23,27
0.741986687147978,0.762820885885943,0.671577144559174,1063,228,31,32,15,13,16,19
0.768113159242191,0.804557492138351,0.694726407613006,1074,217,31,30,14,12,17,18
0.7551296633303,0.765837991088803,0.694847100873709,1065,226,35,32,13,10,22,22
0.767571884984026,0.795394303580561,0.720386654597181,1066,225,39,37,21,18,18,19
0.773828435266084,0.807735577252598,0.671107586571504,1065,226,32,30,17,12,15,18
0.746392885691447,0.778117771137027,0.70013730307848,1067,224,40,33,20,14,20,19
0.683513189448441,0.712700117568315,0.673601119104716,1071,220,40,40,18,16,22,24
0.737384319888248,0.754909883001471,0.719774895646989,1076,215,46,43,21,20,25,23
0.668028311000966,0.695169194224961,0.653407962668785,1048,243,38,32,17,14,21,18
0.757974211062097,0.777607523953697,0.684485407066052,1094,197,28,31,16,13,12,18
0.718192128365607,0.749980879787553,0.657258933574723,1094,197,38,37,16,10,22,27
0.689536706276883,0.710091529784588,0.662945614930378,1064,227,44,44,18,16,26,28
0.772678834909011,0.802505024182884,0.695598120115853,1054,237,29,29,17,13,12,16
0.776626478616925,0.819874851105941,0.694278033794163,1077,214,35,31,18,14,17,17
0.718094289508632,0.736835245922711,0.737914736300248,1093,198,36,34,14,16,22,18
0.764475431606906,0.78732526103926,0.71880119292645,1084,207,36,38,17,15,19,23
0.740256299079828,0.769956547326791,0.734369881604193,1051,240,33,34,15,16,18,18
0.757609756097561,0.782394693031421,0.669060419866871,1055,236,41,31,23,10,18,21
0.761221023181455,0.782520837465112,0.679560964513194,1093,198,40,35,21,14,19,21
0.752312979117103,0.780742695716125,0.658763148965049,1081,210,30,28,13,10,17,18
0.74020168515765,0.77304818676527,0.686982878676169,1066,225,42,39,22,20,20,19
0.722521808088818,0.762283301922261,0.766217287866772,1084,207,30,30,14,16,16,14
0.785151049667179,0.801899280588566,0.755751680419695,1065,226,31,29,14,10,17,19
0.751960881652105,0.773084009171391,0.651494023904383,1057,234,32,36,16,15,16,21
0.731131592421915,0.75117071161769,0.67766323024055,1077,214,31,30,14,12,17,18
0.774495152001166,0.792829630767595,0.713746341463415,1068,223,44,41,25,19,19,22
0.805547935811274,0.831147143346771,0.805071090047393,1066,225,23,25,14,17,9,8
0.730439024390244,0.759591814396175,0.726574500768049,1058,233,41,31,21,13,20,18
0.765974440894569,0.807264160308158,0.76543448589627,1069,222,39,35,21,16,18,19
0.687450514647664,0.711170437697661,0.686308462487999,1067,224,28,23,10,6,18,17
0.739750913596841,0.774276543977149,0.663216560509554,1061,230,38,35,19,13,19,22
0.716086900297427,0.734960163331126,0.717231075697211,1052,239,37,36,16,14,21,22
0.722957969865186,0.750604910820094,0.703724536333232,1049,242,30,26,14,13,16,13
0.730876494023904,0.750461539553598,0.67780410742496,1050,241,36,25,16,9,20,16
0.715668292682927,0.743298720762879,0.682397003745318,1074,217,41,45,17,17,24,28
0.720350969093766,0.751692357447095,0.714171974522293,1046,245,46,35,28,19,18,16
0.767947691486523,0.801186396094352,0.794994675186368,1073,218,42,39,22,22,20,17
0.768493383101459,0.80353855034869,0.715263127051102,1074,217,28,27,14,12,14,15
0.764719023034154,0.794001317817135,0.609680920783157,1086,205,32,39,14,13,18,26
0.672420115243583,0.684522086126593,0.631915055854207,1078,213,46,42,16,15,30,27
0.69448734147597,0.728699767487804,0.676206314535346,1093,198,34,32,13,13,21,19
0.715553789083201,0.753160289162405,0.654493787998943,1066,225,33,30,12,10,21,20
0.702630437924556,0.724375185693466,0.621054718477399,1070,221,33,30,14,8,19,22
0.775234174822531,0.795757797928236,0.74763998448209,1054,237,38,37,20,17,18,20
0.804104591061113,0.812958397593158,0.756930652101953,1086,205,26,19,12,8,14,11
0.67646319388576,0.701349886644065,0.609762190247802,1069,222,48,40,20,11,28,29
